junction_length	tpos	cond_pos	cond_all	cond_neg	test_pos	fpos	norm_mini	size_threshold	para_pp	para_pw	ram	sample
12	0	0	0	0	0	0	0.6	1000	10.07	14.005	1.0	M3-1
24	19	19	528	509	20	1	0.6	1000	10.07	14.005	1.0	M3-1
27	1012	1012	3403	2391	1012	0	0.6	1000	10.07	14.005	1.0	M3-1
30	2244	2244	20706	18462	2266	22	0.6	1000	10.07	14.005	1.0	M3-1
33	14453	14843	188191	173348	14453	0	0.6	1000	10.07	14.005	1.0	M3-1
36	7238877	7242680	9894576	2651896	7238881	4	0.6	1000	10.07	14.005	1.0	M3-1
39	263400	263445	2729616	2466171	263400	0	0.6	1000	10.07	14.005	1.0	M3-1
42	35711	35878	2158003	2122125	35836	125	0.6	1000	10.07	14.005	1.0	M3-1
45	53125	56285	3736011	3679726	53126	1	0.6	1000	10.07	14.005	1.0	M3-1
48	727753	728177	10776403	10048226	727763	10	0.6	1000	10.07	14.005	1.0	M3-1
51	439964	443478	10131751	9688273	439968	4	0.6	1000	10.07	14.005	1.0	M3-1
54	101705	102378	5519503	5417125	101709	4	0.6	1000	10.07	14.005	1.0	M3-1
57	99428	99788	4837605	4737817	99719	291	0.6	1000	10.07	14.005	1.0	M3-1
59	0	0	0	0	0	0	0.6	1000	10.07	14.005	1.0	M3-1
60	220906	221616	3573801	3352185	220945	39	0.6	1000	10.07	14.005	1.0	M3-1
62	0	0	0	0	0	0	0.6	1000	10.07	14.005	1.0	M3-1
63	575533	576491	9748320	9171829	575533	0	0.6	1000	10.07	14.005	1.0	M3-1
64	0	0	0	0	0	0	0.6	1000	10.07	14.005	1.0	M3-1
66	293041	293128	2492028	2198900	293041	0	0.6	1000	10.07	14.005	1.0	M3-1
68	10	10	15	5	10	0	0.6	1000	10.07	14.005	1.0	M3-1
69	359715	359725	4045590	3685865	359726	11	0.6	1000	10.07	14.005	1.0	M3-1
72	72649	75317	1553203	1477886	72649	0	0.6	1000	10.07	14.005	1.0	M3-1
75	18352	18352	328455	310103	18354	2	0.6	1000	10.07	14.005	1.0	M3-1
76	0	0	0	0	0	0	0.6	1000	10.07	14.005	1.0	M3-1
78	132571	132572	773146	640574	132571	0	0.6	1000	10.07	14.005	1.0	M3-1
81	5138	5138	36585	31447	5138	0	0.6	1000	10.07	14.005	1.0	M3-1
84	623	623	9730	9107	623	0	0.6	1000	10.07	14.005	1.0	M3-1
87	478	478	6670	6192	478	0	0.6	1000	10.07	14.005	1.0	M3-1
90	294	305	2278	1973	294	0	0.6	1000	10.07	14.005	1.0	M3-1
24	270561	270561	301476	30915	270561	0	0.6	1000	10.172	12.533	0.3	M3-9
27	21	21	741	720	21	0	0.6	1000	10.172	12.533	0.3	M3-9
30	90534	90534	299151	208617	90534	0	0.6	1000	10.172	12.533	0.3	M3-9
33	11401	11432	196251	184819	11423	22	0.6	1000	10.172	12.533	0.3	M3-9
36	2021	2039	138601	136562	2023	2	0.6	1000	10.172	12.533	0.3	M3-9
37	0	0	0	0	0	0	0.6	1000	10.172	12.533	0.3	M3-9
39	14523	14524	634501	619977	14523	0	0.6	1000	10.172	12.533	0.3	M3-9
42	541717	543515	9367956	8824441	541720	3	0.6	1000	10.172	12.533	0.3	M3-9
45	598259	603363	7123425	6520062	598273	14	0.6	1000	10.172	12.533	0.3	M3-9
48	6280151	7681394	38935900	31254506	6280152	1	0.6	1000	10.172	12.533	0.3	M3-9
51	118785	119469	5602878	5483409	118788	3	0.6	1000	10.172	12.533	0.3	M3-9
52	0	0	0	0	0	0	0.6	1000	10.172	12.533	0.3	M3-9
53	0	0	0	0	0	0	0.6	1000	10.172	12.533	0.3	M3-9
54	121700	151345	4890628	4739283	121720	20	0.6	1000	10.172	12.533	0.3	M3-9
55	55	55	78	23	55	0	0.6	1000	10.172	12.533	0.3	M3-9
56	703	703	703	0	703	0	0.6	1000	10.172	12.533	0.3	M3-9
57	316987	318804	7130976	6812172	316987	0	0.6	1000	10.172	12.533	0.3	M3-9
60	52446	52568	3560446	3507878	52446	0	0.6	1000	10.172	12.533	0.3	M3-9
63	73096	73188	3298596	3225408	73244	148	0.6	1000	10.172	12.533	0.3	M3-9
66	94917	95155	2701650	2606495	94917	0	0.6	1000	10.172	12.533	0.3	M3-9
69	45642	45645	1381953	1336308	45642	0	0.6	1000	10.172	12.533	0.3	M3-9
72	142021	142046	1332528	1190482	142021	0	0.6	1000	10.172	12.533	0.3	M3-9
75	83432	83432	579426	495994	83433	1	0.6	1000	10.172	12.533	0.3	M3-9
78	24514	24583	165600	141017	24514	0	0.6	1000	10.172	12.533	0.3	M3-9
81	380483	380486	658378	277892	380483	0	0.6	1000	10.172	12.533	0.3	M3-9
84	2041	2043	12246	10203	2041	0	0.6	1000	10.172	12.533	0.3	M3-9
87	1044	1048	8778	7730	1044	0	0.6	1000	10.172	12.533	0.3	M3-9
90	2501	2501	5253	2752	2501	0	0.6	1000	10.172	12.533	0.3	M3-9
9	0	0	0	0	0	0	0.6	1000	10.583	12.22	0.5	M3-2
24	71	71	903	832	71	0	0.6	1000	10.583	12.22	0.5	M3-2
27	135	138	2016	1878	135	0	0.6	1000	10.583	12.22	0.5	M3-2
30	30	30	2775	2745	30	0	0.6	1000	10.583	12.22	0.5	M3-2
33	16245	16245	177310	161065	16245	0	0.6	1000	10.583	12.22	0.5	M3-2
36	5334	5335	147153	141818	5352	18	0.6	1000	10.583	12.22	0.5	M3-2
39	101417	101962	1546161	1444199	101418	1	0.6	1000	10.583	12.22	0.5	M3-2
42	879784	885326	12120426	11235100	879784	0	0.6	1000	10.583	12.22	0.5	M3-2
45	38674	38684	2463090	2424406	38676	2	0.6	1000	10.583	12.22	0.5	M3-2
47	0	0	0	0	0	0	0.6	1000	10.583	12.22	0.5	M3-2
48	394513	395976	12338028	11942052	394515	2	0.6	1000	10.583	12.22	0.5	M3-2
50	0	0	0	0	0	0	0.6	1000	10.583	12.22	0.5	M3-2
51	56861	57346	4134250	4076904	56861	0	0.6	1000	10.583	12.22	0.5	M3-2
54	464654	465607	8759205	8293598	464655	1	0.6	1000	10.583	12.22	0.5	M3-2
57	439173	439803	8042055	7602252	439196	23	0.6	1000	10.583	12.22	0.5	M3-2
60	458740	459534	7842780	7383246	458756	16	0.6	1000	10.583	12.22	0.5	M3-2
61	0	0	0	0	0	0	0.6	1000	10.583	12.22	0.5	M3-2
63	645945	646083	8876791	8230708	645945	0	0.6	1000	10.583	12.22	0.5	M3-2
66	294090	294164	5328480	5034316	294090	0	0.6	1000	10.583	12.22	0.5	M3-2
69	26824	27174	1054878	1027704	26824	0	0.6	1000	10.583	12.22	0.5	M3-2
72	44173	44186	565516	521330	44186	13	0.6	1000	10.583	12.22	0.5	M3-2
74	0	0	0	0	0	0	0.6	1000	10.583	12.22	0.5	M3-2
75	10165	10173	222111	211938	10165	0	0.6	1000	10.583	12.22	0.5	M3-2
78	45204	45206	226128	180922	45204	0	0.6	1000	10.583	12.22	0.5	M3-2
81	25848	26035	183315	157280	25848	0	0.6	1000	10.583	12.22	0.5	M3-2
84	2141	2141	28203	26062	2141	0	0.6	1000	10.583	12.22	0.5	M3-2
87	32	32	630	598	32	0	0.6	1000	10.583	12.22	0.5	M3-2
90	3402	3402	10440	7038	3402	0	0.6	1000	10.583	12.22	0.5	M3-2
9	0	0	0	0	0	0	0.6	1000	10.814	15.243	0.3	M3-3
24	144	144	1176	1032	144	0	0.6	1000	10.814	15.243	0.3	M3-3
27	872	914	5151	4237	872	0	0.6	1000	10.814	15.243	0.3	M3-3
30	3659	3659	20706	17047	3659	0	0.6	1000	10.814	15.243	0.3	M3-3
33	240575	240634	578350	337716	240575	0	0.6	1000	10.814	15.243	0.3	M3-3
36	42091	42123	409060	366937	42091	0	0.6	1000	10.814	15.243	0.3	M3-3
39	3886256	7485958	21855966	14370008	3886256	0	0.6	1000	10.814	15.243	0.3	M3-3
42	393481	394519	5795310	5400791	393585	104	0.6	1000	10.814	15.243	0.3	M3-3
45	263371	263631	6474601	6210970	263371	0	0.6	1000	10.814	15.243	0.3	M3-3
48	87139	87551	4686391	4598840	87139	0	0.6	1000	10.814	15.243	0.3	M3-3
51	594374	595313	10799628	10204315	594374	0	0.6	1000	10.814	15.243	0.3	M3-3
54	432569	433368	9939111	9505743	432569	0	0.6	1000	10.814	15.243	0.3	M3-3
55	0	0	0	0	0	0	0.6	1000	10.814	15.243	0.3	M3-3
57	565892	569739	9859020	9289281	565894	2	0.6	1000	10.814	15.243	0.3	M3-3
60	155591	155747	3319176	3163429	155595	4	0.6	1000	10.814	15.243	0.3	M3-3
63	278531	279069	4723201	4444132	278531	0	0.6	1000	10.814	15.243	0.3	M3-3
64	0	0	0	0	0	0	0.6	1000	10.814	15.243	0.3	M3-3
66	188521	190118	3738745	3548627	188521	0	0.6	1000	10.814	15.243	0.3	M3-3
69	83935	83935	1853775	1769840	83935	0	0.6	1000	10.814	15.243	0.3	M3-3
70	0	0	0	0	0	0	0.6	1000	10.814	15.243	0.3	M3-3
72	164925	164925	1330896	1165971	164928	3	0.6	1000	10.814	15.243	0.3	M3-3
75	7553	7592	208981	201389	7553	0	0.6	1000	10.814	15.243	0.3	M3-3
77	0	0	0	0	0	0	0.6	1000	10.814	15.243	0.3	M3-3
78	9239	9240	172578	163338	9239	0	0.6	1000	10.814	15.243	0.3	M3-3
81	692	695	17020	16325	692	0	0.6	1000	10.814	15.243	0.3	M3-3
84	549	549	9591	9042	549	0	0.6	1000	10.814	15.243	0.3	M3-3
87	23709	24101	66430	42329	23709	0	0.6	1000	10.814	15.243	0.3	M3-3
90	20	20	351	331	20	0	0.6	1000	10.814	15.243	0.3	M3-3
9	0	0	0	0	0	0	0.6	1000	11.029	14.119	1.0	M3-3
24	144	144	1176	1032	144	0	0.6	1000	11.029	14.119	1.0	M3-3
27	872	914	5151	4237	872	0	0.6	1000	11.029	14.119	1.0	M3-3
30	3659	3659	20706	17047	3659	0	0.6	1000	11.029	14.119	1.0	M3-3
33	240575	240634	578350	337716	240575	0	0.6	1000	11.029	14.119	1.0	M3-3
36	42091	42123	409060	366937	42091	0	0.6	1000	11.029	14.119	1.0	M3-3
39	3661575	7485958	21855966	14370008	3661575	0	0.6	1000	11.029	14.119	1.0	M3-3
42	392665	394519	5795310	5400791	392769	104	0.6	1000	11.029	14.119	1.0	M3-3
45	259570	263631	6474601	6210970	259575	5	0.6	1000	11.029	14.119	1.0	M3-3
48	85171	87551	4686391	4598840	85171	0	0.6	1000	11.029	14.119	1.0	M3-3
51	595129	595313	10799628	10204315	595129	0	0.6	1000	11.029	14.119	1.0	M3-3
54	432622	433368	9939111	9505743	432622	0	0.6	1000	11.029	14.119	1.0	M3-3
55	0	0	0	0	0	0	0.6	1000	11.029	14.119	1.0	M3-3
57	565382	569739	9859020	9289281	565383	1	0.6	1000	11.029	14.119	1.0	M3-3
60	155697	155747	3319176	3163429	155701	4	0.6	1000	11.029	14.119	1.0	M3-3
63	278250	279069	4723201	4444132	278250	0	0.6	1000	11.029	14.119	1.0	M3-3
64	0	0	0	0	0	0	0.6	1000	11.029	14.119	1.0	M3-3
66	188484	190118	3738745	3548627	188484	0	0.6	1000	11.029	14.119	1.0	M3-3
69	83935	83935	1853775	1769840	83935	0	0.6	1000	11.029	14.119	1.0	M3-3
70	0	0	0	0	0	0	0.6	1000	11.029	14.119	1.0	M3-3
72	164925	164925	1330896	1165971	164928	3	0.6	1000	11.029	14.119	1.0	M3-3
75	7553	7592	208981	201389	7553	0	0.6	1000	11.029	14.119	1.0	M3-3
77	0	0	0	0	0	0	0.6	1000	11.029	14.119	1.0	M3-3
78	9239	9240	172578	163338	9239	0	0.6	1000	11.029	14.119	1.0	M3-3
81	692	695	17020	16325	692	0	0.6	1000	11.029	14.119	1.0	M3-3
84	549	549	9591	9042	549	0	0.6	1000	11.029	14.119	1.0	M3-3
87	23709	24101	66430	42329	23709	0	0.6	1000	11.029	14.119	1.0	M3-3
90	20	20	351	331	20	0	0.6	1000	11.029	14.119	1.0	M3-3
9	0	0	0	0	0	0	0.6	1000	11.338	13.578	1.0	M3-2
24	71	71	903	832	71	0	0.6	1000	11.338	13.578	1.0	M3-2
27	135	138	2016	1878	135	0	0.6	1000	11.338	13.578	1.0	M3-2
30	30	30	2775	2745	30	0	0.6	1000	11.338	13.578	1.0	M3-2
33	16245	16245	177310	161065	16245	0	0.6	1000	11.338	13.578	1.0	M3-2
36	5334	5335	147153	141818	5352	18	0.6	1000	11.338	13.578	1.0	M3-2
39	101417	101962	1546161	1444199	101418	1	0.6	1000	11.338	13.578	1.0	M3-2
42	883725	885326	12120426	11235100	883725	0	0.6	1000	11.338	13.578	1.0	M3-2
45	38674	38684	2463090	2424406	38676	2	0.6	1000	11.338	13.578	1.0	M3-2
47	0	0	0	0	0	0	0.6	1000	11.338	13.578	1.0	M3-2
48	393915	395976	12338028	11942052	393917	2	0.6	1000	11.338	13.578	1.0	M3-2
50	0	0	0	0	0	0	0.6	1000	11.338	13.578	1.0	M3-2
51	56800	57346	4134250	4076904	56800	0	0.6	1000	11.338	13.578	1.0	M3-2
54	464726	465607	8759205	8293598	464727	1	0.6	1000	11.338	13.578	1.0	M3-2
57	439342	439803	8042055	7602252	439372	30	0.6	1000	11.338	13.578	1.0	M3-2
60	458789	459534	7842780	7383246	458809	20	0.6	1000	11.338	13.578	1.0	M3-2
61	0	0	0	0	0	0	0.6	1000	11.338	13.578	1.0	M3-2
63	645999	646083	8876791	8230708	645999	0	0.6	1000	11.338	13.578	1.0	M3-2
66	294086	294164	5328480	5034316	294086	0	0.6	1000	11.338	13.578	1.0	M3-2
69	26824	27174	1054878	1027704	26824	0	0.6	1000	11.338	13.578	1.0	M3-2
72	44173	44186	565516	521330	44186	13	0.6	1000	11.338	13.578	1.0	M3-2
74	0	0	0	0	0	0	0.6	1000	11.338	13.578	1.0	M3-2
75	10165	10173	222111	211938	10165	0	0.6	1000	11.338	13.578	1.0	M3-2
78	45204	45206	226128	180922	45204	0	0.6	1000	11.338	13.578	1.0	M3-2
81	25848	26035	183315	157280	25848	0	0.6	1000	11.338	13.578	1.0	M3-2
84	2141	2141	28203	26062	2141	0	0.6	1000	11.338	13.578	1.0	M3-2
87	32	32	630	598	32	0	0.6	1000	11.338	13.578	1.0	M3-2
90	3402	3402	10440	7038	3402	0	0.6	1000	11.338	13.578	1.0	M3-2
12	0	0	0	0	0	0	0.6	1000	12.904	20.536	0.3	M3-1
24	19	19	528	509	20	1	0.6	1000	12.904	20.536	0.3	M3-1
27	1012	1012	3403	2391	1012	0	0.6	1000	12.904	20.536	0.3	M3-1
30	2244	2244	20706	18462	2266	22	0.6	1000	12.904	20.536	0.3	M3-1
33	14453	14843	188191	173348	14453	0	0.6	1000	12.904	20.536	0.3	M3-1
36	7238877	7242680	9894576	2651896	7238881	4	0.6	1000	12.904	20.536	0.3	M3-1
39	263400	263445	2729616	2466171	263400	0	0.6	1000	12.904	20.536	0.3	M3-1
42	35711	35878	2158003	2122125	35836	125	0.6	1000	12.904	20.536	0.3	M3-1
45	53714	56285	3736011	3679726	53715	1	0.6	1000	12.904	20.536	0.3	M3-1
48	727785	728177	10776403	10048226	727795	10	0.6	1000	12.904	20.536	0.3	M3-1
51	441618	443478	10131751	9688273	441623	5	0.6	1000	12.904	20.536	0.3	M3-1
54	101673	102378	5519503	5417125	101677	4	0.6	1000	12.904	20.536	0.3	M3-1
57	99377	99788	4837605	4737817	99668	291	0.6	1000	12.904	20.536	0.3	M3-1
59	0	0	0	0	0	0	0.6	1000	12.904	20.536	0.3	M3-1
60	221474	221616	3573801	3352185	221513	39	0.6	1000	12.904	20.536	0.3	M3-1
62	0	0	0	0	0	0	0.6	1000	12.904	20.536	0.3	M3-1
63	575135	576491	9748320	9171829	575135	0	0.6	1000	12.904	20.536	0.3	M3-1
64	0	0	0	0	0	0	0.6	1000	12.904	20.536	0.3	M3-1
66	293041	293128	2492028	2198900	293041	0	0.6	1000	12.904	20.536	0.3	M3-1
68	10	10	15	5	10	0	0.6	1000	12.904	20.536	0.3	M3-1
69	359605	359725	4045590	3685865	359616	11	0.6	1000	12.904	20.536	0.3	M3-1
72	72649	75317	1553203	1477886	72649	0	0.6	1000	12.904	20.536	0.3	M3-1
75	18352	18352	328455	310103	18354	2	0.6	1000	12.904	20.536	0.3	M3-1
76	0	0	0	0	0	0	0.6	1000	12.904	20.536	0.3	M3-1
78	132571	132572	773146	640574	132571	0	0.6	1000	12.904	20.536	0.3	M3-1
81	5138	5138	36585	31447	5138	0	0.6	1000	12.904	20.536	0.3	M3-1
84	623	623	9730	9107	623	0	0.6	1000	12.904	20.536	0.3	M3-1
87	478	478	6670	6192	478	0	0.6	1000	12.904	20.536	0.3	M3-1
90	294	305	2278	1973	294	0	0.6	1000	12.904	20.536	0.3	M3-1
6	0	0	0	0	0	0	0.6	1000	13.274	22.414	0.3	M4-4
9	0	0	0	0	0	0	0.6	1000	13.274	22.414	0.3	M4-4
24	1018	1043	10296	9253	1018	0	0.6	1000	13.274	22.414	0.3	M4-4
27	648	648	14196	13548	648	0	0.6	1000	13.274	22.414	0.3	M4-4
30	1241	1277	59685	58408	1268	27	0.6	1000	13.274	22.414	0.3	M4-4
33	4938	4954	217470	212516	4938	0	0.6	1000	13.274	22.414	0.3	M4-4
36	22300	22530	1118260	1095730	22302	2	0.6	1000	13.274	22.414	0.3	M4-4
39	115694	117765	5089645	4971880	115706	12	0.6	1000	13.274	22.414	0.3	M4-4
42	121271	121715	8154741	8033026	121292	21	0.6	1000	13.274	22.414	0.3	M4-4
45	200765	203168	18889731	18686563	200772	7	0.6	1000	13.274	22.414	0.3	M4-4
46	0	0	0	0	0	0	0.6	1000	13.274	22.414	0.3	M4-4
48	173803	175008	19829253	19654245	173889	86	0.6	1000	13.274	22.414	0.3	M4-4
51	247292	247933	25866028	25618095	247350	58	0.6	1000	13.274	22.414	0.3	M4-4
53	0	0	0	0	0	0	0.6	1000	13.274	22.414	0.3	M4-4
54	156932	157817	20075616	19917799	156935	3	0.6	1000	13.274	22.414	0.3	M4-4
56	0	0	0	0	0	0	0.6	1000	13.274	22.414	0.3	M4-4
57	314377	318553	26941470	26622917	314569	192	0.6	1000	13.274	22.414	0.3	M4-4
60	203849	216266	16453716	16237450	203870	21	0.6	1000	13.274	22.414	0.3	M4-4
61	0	0	3	3	0	0	0.6	1000	13.274	22.414	0.3	M4-4
63	123444	124499	13915450	13790951	123452	8	0.6	1000	13.274	22.414	0.3	M4-4
64	0	0	0	0	0	0	0.6	1000	13.274	22.414	0.3	M4-4
65	0	0	1	1	0	0	0.6	1000	13.274	22.414	0.3	M4-4
66	1394172	1396024	18141276	16745252	1394172	0	0.6	1000	13.274	22.414	0.3	M4-4
67	0	0	0	0	0	0	0.6	1000	13.274	22.414	0.3	M4-4
68	0	0	0	0	0	0	0.6	1000	13.274	22.414	0.3	M4-4
69	78379	105881	5446650	5340769	78382	3	0.6	1000	13.274	22.414	0.3	M4-4
71	0	0	0	0	0	0	0.6	1000	13.274	22.414	0.3	M4-4
72	82348	83274	3544453	3461179	82349	1	0.6	1000	13.274	22.414	0.3	M4-4
74	0	0	0	0	0	0	0.6	1000	13.274	22.414	0.3	M4-4
75	34567	34801	1154440	1119639	34567	0	0.6	1000	13.274	22.414	0.3	M4-4
78	47170	47170	676866	629696	47176	6	0.6	1000	13.274	22.414	0.3	M4-4
81	20811	20825	243253	222428	20811	0	0.6	1000	13.274	22.414	0.3	M4-4
82	0	0	0	0	0	0	0.6	1000	13.274	22.414	0.3	M4-4
84	13240	13300	167331	154031	13240	0	0.6	1000	13.274	22.414	0.3	M4-4
87	47704	48628	110685	62057	47704	0	0.6	1000	13.274	22.414	0.3	M4-4
90	1089	1097	18528	17431	1089	0	0.6	1000	13.274	22.414	0.3	M4-4
6	0	0	0	0	0	0	0.6	1000	13.46	24.272	0.1	M4-4
9	0	0	0	0	0	0	0.6	1000	13.46	24.272	0.1	M4-4
24	1018	1043	10296	9253	1018	0	0.6	1000	13.46	24.272	0.1	M4-4
27	648	648	14196	13548	648	0	0.6	1000	13.46	24.272	0.1	M4-4
30	1241	1277	59685	58408	1268	27	0.6	1000	13.46	24.272	0.1	M4-4
33	4938	4954	217470	212516	4938	0	0.6	1000	13.46	24.272	0.1	M4-4
36	22300	22530	1118260	1095730	22302	2	0.6	1000	13.46	24.272	0.1	M4-4
39	115148	117765	5089645	4971880	115160	12	0.6	1000	13.46	24.272	0.1	M4-4
42	120808	121715	8154741	8033026	120842	34	0.6	1000	13.46	24.272	0.1	M4-4
45	200481	203168	18889731	18686563	200488	7	0.6	1000	13.46	24.272	0.1	M4-4
46	0	0	0	0	0	0	0.6	1000	13.46	24.272	0.1	M4-4
48	172828	175008	19829253	19654245	172914	86	0.6	1000	13.46	24.272	0.1	M4-4
51	246802	247933	25866028	25618095	246858	56	0.6	1000	13.46	24.272	0.1	M4-4
53	0	0	0	0	0	0	0.6	1000	13.46	24.272	0.1	M4-4
54	154047	157817	20075616	19917799	154049	2	0.6	1000	13.46	24.272	0.1	M4-4
56	0	0	0	0	0	0	0.6	1000	13.46	24.272	0.1	M4-4
57	313170	318553	26941470	26622917	313359	189	0.6	1000	13.46	24.272	0.1	M4-4
60	203213	216266	16453716	16237450	203233	20	0.6	1000	13.46	24.272	0.1	M4-4
61	0	0	3	3	0	0	0.6	1000	13.46	24.272	0.1	M4-4
63	123102	124499	13915450	13790951	123112	10	0.6	1000	13.46	24.272	0.1	M4-4
64	0	0	0	0	0	0	0.6	1000	13.46	24.272	0.1	M4-4
65	0	0	1	1	0	0	0.6	1000	13.46	24.272	0.1	M4-4
66	1393751	1396024	18141276	16745252	1393751	0	0.6	1000	13.46	24.272	0.1	M4-4
67	0	0	0	0	0	0	0.6	1000	13.46	24.272	0.1	M4-4
68	0	0	0	0	0	0	0.6	1000	13.46	24.272	0.1	M4-4
69	78403	105881	5446650	5340769	78405	2	0.6	1000	13.46	24.272	0.1	M4-4
71	0	0	0	0	0	0	0.6	1000	13.46	24.272	0.1	M4-4
72	81638	83274	3544453	3461179	81638	0	0.6	1000	13.46	24.272	0.1	M4-4
74	0	0	0	0	0	0	0.6	1000	13.46	24.272	0.1	M4-4
75	34567	34801	1154440	1119639	34567	0	0.6	1000	13.46	24.272	0.1	M4-4
78	47170	47170	676866	629696	47176	6	0.6	1000	13.46	24.272	0.1	M4-4
81	20811	20825	243253	222428	20811	0	0.6	1000	13.46	24.272	0.1	M4-4
82	0	0	0	0	0	0	0.6	1000	13.46	24.272	0.1	M4-4
84	13240	13300	167331	154031	13240	0	0.6	1000	13.46	24.272	0.1	M4-4
87	47704	48628	110685	62057	47704	0	0.6	1000	13.46	24.272	0.1	M4-4
90	1089	1097	18528	17431	1089	0	0.6	1000	13.46	24.272	0.1	M4-4
6	0	0	0	0	0	0	0.6	1000	13.701	22.045	0.5	M4-4
9	0	0	0	0	0	0	0.6	1000	13.701	22.045	0.5	M4-4
24	1018	1043	10296	9253	1018	0	0.6	1000	13.701	22.045	0.5	M4-4
27	648	648	14196	13548	648	0	0.6	1000	13.701	22.045	0.5	M4-4
30	1241	1277	59685	58408	1268	27	0.6	1000	13.701	22.045	0.5	M4-4
33	4938	4954	217470	212516	4938	0	0.6	1000	13.701	22.045	0.5	M4-4
36	22300	22530	1118260	1095730	22302	2	0.6	1000	13.701	22.045	0.5	M4-4
39	115732	117765	5089645	4971880	115752	20	0.6	1000	13.701	22.045	0.5	M4-4
42	121421	121715	8154741	8033026	121441	20	0.6	1000	13.701	22.045	0.5	M4-4
45	201032	203168	18889731	18686563	201039	7	0.6	1000	13.701	22.045	0.5	M4-4
46	0	0	0	0	0	0	0.6	1000	13.701	22.045	0.5	M4-4
48	173830	175008	19829253	19654245	173915	85	0.6	1000	13.701	22.045	0.5	M4-4
51	213389	247933	25866028	25618095	213445	56	0.6	1000	13.701	22.045	0.5	M4-4
53	0	0	0	0	0	0	0.6	1000	13.701	22.045	0.5	M4-4
54	157007	157817	20075616	19917799	157010	3	0.6	1000	13.701	22.045	0.5	M4-4
56	0	0	0	0	0	0	0.6	1000	13.701	22.045	0.5	M4-4
57	314473	318553	26941470	26622917	314665	192	0.6	1000	13.701	22.045	0.5	M4-4
60	203911	216266	16453716	16237450	203951	40	0.6	1000	13.701	22.045	0.5	M4-4
61	0	0	3	3	0	0	0.6	1000	13.701	22.045	0.5	M4-4
63	123658	124499	13915450	13790951	123668	10	0.6	1000	13.701	22.045	0.5	M4-4
64	0	0	0	0	0	0	0.6	1000	13.701	22.045	0.5	M4-4
65	0	0	1	1	0	0	0.6	1000	13.701	22.045	0.5	M4-4
66	1394233	1396024	18141276	16745252	1394233	0	0.6	1000	13.701	22.045	0.5	M4-4
67	0	0	0	0	0	0	0.6	1000	13.701	22.045	0.5	M4-4
68	0	0	0	0	0	0	0.6	1000	13.701	22.045	0.5	M4-4
69	78851	105881	5446650	5340769	78851	0	0.6	1000	13.701	22.045	0.5	M4-4
71	0	0	0	0	0	0	0.6	1000	13.701	22.045	0.5	M4-4
72	81423	83274	3544453	3461179	81424	1	0.6	1000	13.701	22.045	0.5	M4-4
74	0	0	0	0	0	0	0.6	1000	13.701	22.045	0.5	M4-4
75	34567	34801	1154440	1119639	34567	0	0.6	1000	13.701	22.045	0.5	M4-4
78	47170	47170	676866	629696	47176	6	0.6	1000	13.701	22.045	0.5	M4-4
81	20811	20825	243253	222428	20811	0	0.6	1000	13.701	22.045	0.5	M4-4
82	0	0	0	0	0	0	0.6	1000	13.701	22.045	0.5	M4-4
84	13240	13300	167331	154031	13240	0	0.6	1000	13.701	22.045	0.5	M4-4
87	47704	48628	110685	62057	47704	0	0.6	1000	13.701	22.045	0.5	M4-4
90	1089	1097	18528	17431	1089	0	0.6	1000	13.701	22.045	0.5	M4-4
24	270561	270561	301476	30915	270561	0	0.6	1000	14.207	13.667	1.0	M3-9
27	21	21	741	720	21	0	0.6	1000	14.207	13.667	1.0	M3-9
30	90534	90534	299151	208617	90534	0	0.6	1000	14.207	13.667	1.0	M3-9
33	11401	11432	196251	184819	11423	22	0.6	1000	14.207	13.667	1.0	M3-9
36	2021	2039	138601	136562	2023	2	0.6	1000	14.207	13.667	1.0	M3-9
37	0	0	0	0	0	0	0.6	1000	14.207	13.667	1.0	M3-9
39	14523	14524	634501	619977	14523	0	0.6	1000	14.207	13.667	1.0	M3-9
42	541551	543515	9367956	8824441	541554	3	0.6	1000	14.207	13.667	1.0	M3-9
45	598633	603363	7123425	6520062	598633	0	0.6	1000	14.207	13.667	1.0	M3-9
48	6281011	7681394	38935900	31254506	6281012	1	0.6	1000	14.207	13.667	1.0	M3-9
51	118698	119469	5602878	5483409	118705	7	0.6	1000	14.207	13.667	1.0	M3-9
52	0	0	0	0	0	0	0.6	1000	14.207	13.667	1.0	M3-9
53	0	0	0	0	0	0	0.6	1000	14.207	13.667	1.0	M3-9
54	120936	151345	4890628	4739283	120957	21	0.6	1000	14.207	13.667	1.0	M3-9
55	55	55	78	23	55	0	0.6	1000	14.207	13.667	1.0	M3-9
56	703	703	703	0	703	0	0.6	1000	14.207	13.667	1.0	M3-9
57	315974	318804	7130976	6812172	315974	0	0.6	1000	14.207	13.667	1.0	M3-9
60	52463	52568	3560446	3507878	52463	0	0.6	1000	14.207	13.667	1.0	M3-9
63	73162	73188	3298596	3225408	73310	148	0.6	1000	14.207	13.667	1.0	M3-9
66	94980	95155	2701650	2606495	94980	0	0.6	1000	14.207	13.667	1.0	M3-9
69	45642	45645	1381953	1336308	45642	0	0.6	1000	14.207	13.667	1.0	M3-9
72	142021	142046	1332528	1190482	142021	0	0.6	1000	14.207	13.667	1.0	M3-9
75	83432	83432	579426	495994	83433	1	0.6	1000	14.207	13.667	1.0	M3-9
78	24514	24583	165600	141017	24514	0	0.6	1000	14.207	13.667	1.0	M3-9
81	380483	380486	658378	277892	380483	0	0.6	1000	14.207	13.667	1.0	M3-9
84	2041	2043	12246	10203	2041	0	0.6	1000	14.207	13.667	1.0	M3-9
87	1044	1048	8778	7730	1044	0	0.6	1000	14.207	13.667	1.0	M3-9
90	2501	2501	5253	2752	2501	0	0.6	1000	14.207	13.667	1.0	M3-9
18	0	0	0	0	0	0	0.6	1000	14.219	22.835	0.1	M4-2
24	66	66	2415	2349	67	1	0.6	1000	14.219	22.835	0.1	M4-2
27	7849	7849	32385	24536	7977	128	0.6	1000	14.219	22.835	0.1	M4-2
30	1754	1755	45451	43696	1755	1	0.6	1000	14.219	22.835	0.1	M4-2
33	6752	6766	464166	457400	6752	0	0.6	1000	14.219	22.835	0.1	M4-2
36	19722	19751	1104841	1085090	19726	4	0.6	1000	14.219	22.835	0.1	M4-2
37	0	0	0	0	0	0	0.6	1000	14.219	22.835	0.1	M4-2
39	37900	38833	3635556	3596723	37949	49	0.6	1000	14.219	22.835	0.1	M4-2
42	60044	60938	9537528	9476590	60239	195	0.6	1000	14.219	22.835	0.1	M4-2
45	288451	295941	22361328	22065387	288464	13	0.6	1000	14.219	22.835	0.1	M4-2
46	0	0	0	0	0	0	0.6	1000	14.219	22.835	0.1	M4-2
48	190646	191571	22181130	21989559	190660	14	0.6	1000	14.219	22.835	0.1	M4-2
49	0	0	0	0	0	0	0.6	1000	14.219	22.835	0.1	M4-2
51	156380	157856	24238203	24080347	156714	334	0.6	1000	14.219	22.835	0.1	M4-2
52	0	0	0	0	0	0	0.6	1000	14.219	22.835	0.1	M4-2
53	0	0	1	1	0	0	0.6	1000	14.219	22.835	0.1	M4-2
54	133935	135783	21056805	20921022	133940	5	0.6	1000	14.219	22.835	0.1	M4-2
57	188352	189527	21232386	21042859	188799	447	0.6	1000	14.219	22.835	0.1	M4-2
58	0	0	3	3	0	0	0.6	1000	14.219	22.835	0.1	M4-2
59	0	0	0	0	0	0	0.6	1000	14.219	22.835	0.1	M4-2
60	137903	138967	17811496	17672529	137915	12	0.6	1000	14.219	22.835	0.1	M4-2
63	154753	157052	11217216	11060164	154756	3	0.6	1000	14.219	22.835	0.1	M4-2
66	421895	423380	15343030	14919650	421898	3	0.6	1000	14.219	22.835	0.1	M4-2
67	6	6	6	0	6	0	0.6	1000	14.219	22.835	0.1	M4-2
69	209015	209804	6453028	6243224	209026	11	0.6	1000	14.219	22.835	0.1	M4-2
71	10	10	10	0	10	0	0.6	1000	14.219	22.835	0.1	M4-2
72	176977	179392	4183278	4003886	176984	7	0.6	1000	14.219	22.835	0.1	M4-2
75	39003	39078	1065070	1025992	39003	0	0.6	1000	14.219	22.835	0.1	M4-2
76	0	0	0	0	0	0	0.6	1000	14.219	22.835	0.1	M4-2
78	1259024	1259093	3166386	1907293	1259024	0	0.6	1000	14.219	22.835	0.1	M4-2
81	10255	10259	306936	296677	10255	0	0.6	1000	14.219	22.835	0.1	M4-2
84	7599	7599	109746	102147	7599	0	0.6	1000	14.219	22.835	0.1	M4-2
87	1035	1045	17766	16721	1035	0	0.6	1000	14.219	22.835	0.1	M4-2
88	0	0	0	0	0	0	0.6	1000	14.219	22.835	0.1	M4-2
90	198	198	3321	3123	198	0	0.6	1000	14.219	22.835	0.1	M4-2
9	0	0	0	0	0	0	0.6	1000	14.318	21.859	0.1	M4-8
24	346	347	6555	6208	365	19	0.6	1000	14.318	21.859	0.1	M4-8
27	569	569	14535	13966	569	0	0.6	1000	14.318	21.859	0.1	M4-8
29	0	0	0	0	0	0	0.6	1000	14.318	21.859	0.1	M4-8
30	74901	74901	230860	155959	74901	0	0.6	1000	14.318	21.859	0.1	M4-8
33	3113	3198	222778	219580	3168	55	0.6	1000	14.318	21.859	0.1	M4-8
36	96886	97366	2333880	2236514	96890	4	0.6	1000	14.318	21.859	0.1	M4-8
38	0	0	0	0	0	0	0.6	1000	14.318	21.859	0.1	M4-8
39	36234	37115	4157286	4120171	36337	103	0.6	1000	14.318	21.859	0.1	M4-8
42	171584	172280	8460441	8288161	171602	18	0.6	1000	14.318	21.859	0.1	M4-8
45	302688	305407	21704166	21398759	302750	62	0.6	1000	14.318	21.859	0.1	M4-8
48	384678	402907	35418736	35015829	385111	433	0.6	1000	14.318	21.859	0.1	M4-8
49	0	0	0	0	0	0	0.6	1000	14.318	21.859	0.1	M4-8
50	0	0	1	1	0	0	0.6	1000	14.318	21.859	0.1	M4-8
51	83217	84579	18994366	18909787	83321	104	0.6	1000	14.318	21.859	0.1	M4-8
52	78	78	120	42	78	0	0.6	1000	14.318	21.859	0.1	M4-8
54	1467899	1471430	38759610	37288180	1467917	18	0.6	1000	14.318	21.859	0.1	M4-8
55	1	1	3	2	1	0	0.6	1000	14.318	21.859	0.1	M4-8
56	12720	12880	13203	323	12720	0	0.6	1000	14.318	21.859	0.1	M4-8
57	331873	334108	29518086	29183978	339009	7136	0.6	1000	14.318	21.859	0.1	M4-8
58	276	276	276	0	276	0	0.6	1000	14.318	21.859	0.1	M4-8
59	0	0	0	0	0	0	0.6	1000	14.318	21.859	0.1	M4-8
60	55999	56888	11841411	11784523	56031	32	0.6	1000	14.318	21.859	0.1	M4-8
63	74066	75315	10001628	9926313	74072	6	0.6	1000	14.318	21.859	0.1	M4-8
66	49761	50377	7108335	7057958	49761	0	0.6	1000	14.318	21.859	0.1	M4-8
67	0	0	0	0	0	0	0.6	1000	14.318	21.859	0.1	M4-8
69	117079	117895	3643650	3525755	117085	6	0.6	1000	14.318	21.859	0.1	M4-8
70	0	0	0	0	0	0	0.6	1000	14.318	21.859	0.1	M4-8
72	176288	184108	5286126	5102018	176306	18	0.6	1000	14.318	21.859	0.1	M4-8
75	35509	35512	1110795	1075283	35509	0	0.6	1000	14.318	21.859	0.1	M4-8
78	4414	4441	296835	292394	4415	1	0.6	1000	14.318	21.859	0.1	M4-8
81	63885	63908	385881	321973	63885	0	0.6	1000	14.318	21.859	0.1	M4-8
84	14535	28419	126756	98337	14535	0	0.6	1000	14.318	21.859	0.1	M4-8
87	225	227	6670	6443	225	0	0.6	1000	14.318	21.859	0.1	M4-8
88	0	0	0	0	0	0	0.6	1000	14.318	21.859	0.1	M4-8
90	123	123	2556	2433	123	0	0.6	1000	14.318	21.859	0.1	M4-8
3	0	0	0	0	0	0	0.6	1000	14.418	21.277	0.1	M4-1
6	0	0	0	0	0	0	0.6	1000	14.418	21.277	0.1	M4-1
24	73	75	3570	3495	73	0	0.6	1000	14.418	21.277	0.1	M4-1
27	6507	6507	43071	36564	6513	6	0.6	1000	14.418	21.277	0.1	M4-1
30	709	716	40755	40039	714	5	0.6	1000	14.418	21.277	0.1	M4-1
33	33957	33984	424581	390597	33957	0	0.6	1000	14.418	21.277	0.1	M4-1
36	4978	4979	458403	453424	4984	6	0.6	1000	14.418	21.277	0.1	M4-1
39	215997	234607	6813586	6578979	216012	15	0.6	1000	14.418	21.277	0.1	M4-1
41	0	0	0	0	0	0	0.6	1000	14.418	21.277	0.1	M4-1
42	67153	74965	8559453	8484488	68291	1138	0.6	1000	14.418	21.277	0.1	M4-1
45	272315	274902	18638565	18363663	272334	19	0.6	1000	14.418	21.277	0.1	M4-1
47	0	0	0	0	0	0	0.6	1000	14.418	21.277	0.1	M4-1
48	208886	212334	24981846	24769512	209287	401	0.6	1000	14.418	21.277	0.1	M4-1
49	0	0	0	0	0	0	0.6	1000	14.418	21.277	0.1	M4-1
50	10	10	15	5	10	0	0.6	1000	14.418	21.277	0.1	M4-1
51	259311	270020	34283340	34013320	259444	133	0.6	1000	14.418	21.277	0.1	M4-1
52	0	0	0	0	0	0	0.6	1000	14.418	21.277	0.1	M4-1
53	0	0	1	1	0	0	0.6	1000	14.418	21.277	0.1	M4-1
54	248780	257003	26335653	26078650	248798	18	0.6	1000	14.418	21.277	0.1	M4-1
56	55	55	55	0	55	0	0.6	1000	14.418	21.277	0.1	M4-1
57	91602	92998	17307786	17214788	91627	25	0.6	1000	14.418	21.277	0.1	M4-1
58	0	0	0	0	0	0	0.6	1000	14.418	21.277	0.1	M4-1
60	172260	174264	15354111	15179847	172260	0	0.6	1000	14.418	21.277	0.1	M4-1
63	88817	90130	11987856	11897726	88866	49	0.6	1000	14.418	21.277	0.1	M4-1
65	0	0	0	0	0	0	0.6	1000	14.418	21.277	0.1	M4-1
66	188582	189660	8704878	8515218	188582	0	0.6	1000	14.418	21.277	0.1	M4-1
67	0	0	0	0	0	0	0.6	1000	14.418	21.277	0.1	M4-1
69	148266	148774	7634278	7485504	148268	2	0.6	1000	14.418	21.277	0.1	M4-1
72	1447364	1449473	11493615	10044142	1447365	1	0.6	1000	14.418	21.277	0.1	M4-1
73	1	1	1	0	1	0	0.6	1000	14.418	21.277	0.1	M4-1
75	18218	18309	962578	944269	18218	0	0.6	1000	14.418	21.277	0.1	M4-1
78	12180	12247	451725	439478	12180	0	0.6	1000	14.418	21.277	0.1	M4-1
81	1988	2002	126756	124754	1988	0	0.6	1000	14.418	21.277	0.1	M4-1
84	5572	5573	52650	47077	5572	0	0.6	1000	14.418	21.277	0.1	M4-1
87	620	621	12403	11782	620	0	0.6	1000	14.418	21.277	0.1	M4-1
90	218	233	4753	4520	218	0	0.6	1000	14.418	21.277	0.1	M4-1
18	0	0	0	0	0	0	0.6	1000	14.423	22.873	0.3	M4-2
24	66	66	2415	2349	67	1	0.6	1000	14.423	22.873	0.3	M4-2
27	7849	7849	32385	24536	7977	128	0.6	1000	14.423	22.873	0.3	M4-2
30	1754	1755	45451	43696	1755	1	0.6	1000	14.423	22.873	0.3	M4-2
33	6752	6766	464166	457400	6752	0	0.6	1000	14.423	22.873	0.3	M4-2
36	19722	19751	1104841	1085090	19726	4	0.6	1000	14.423	22.873	0.3	M4-2
37	0	0	0	0	0	0	0.6	1000	14.423	22.873	0.3	M4-2
39	38059	38833	3635556	3596723	38099	40	0.6	1000	14.423	22.873	0.3	M4-2
42	60211	60938	9537528	9476590	60410	199	0.6	1000	14.423	22.873	0.3	M4-2
45	291513	295941	22361328	22065387	291540	27	0.6	1000	14.423	22.873	0.3	M4-2
46	0	0	0	0	0	0	0.6	1000	14.423	22.873	0.3	M4-2
48	191021	191571	22181130	21989559	191036	15	0.6	1000	14.423	22.873	0.3	M4-2
49	0	0	0	0	0	0	0.6	1000	14.423	22.873	0.3	M4-2
51	156828	157856	24238203	24080347	157150	322	0.6	1000	14.423	22.873	0.3	M4-2
52	0	0	0	0	0	0	0.6	1000	14.423	22.873	0.3	M4-2
53	0	0	1	1	0	0	0.6	1000	14.423	22.873	0.3	M4-2
54	134828	135783	21056805	20921022	134832	4	0.6	1000	14.423	22.873	0.3	M4-2
57	187977	189527	21232386	21042859	188424	447	0.6	1000	14.423	22.873	0.3	M4-2
58	0	0	3	3	0	0	0.6	1000	14.423	22.873	0.3	M4-2
59	0	0	0	0	0	0	0.6	1000	14.423	22.873	0.3	M4-2
60	138263	138967	17811496	17672529	138270	7	0.6	1000	14.423	22.873	0.3	M4-2
63	155778	157052	11217216	11060164	155782	4	0.6	1000	14.423	22.873	0.3	M4-2
66	361283	423380	15343030	14919650	361286	3	0.6	1000	14.423	22.873	0.3	M4-2
67	6	6	6	0	6	0	0.6	1000	14.423	22.873	0.3	M4-2
69	209271	209804	6453028	6243224	209282	11	0.6	1000	14.423	22.873	0.3	M4-2
71	10	10	10	0	10	0	0.6	1000	14.423	22.873	0.3	M4-2
72	177100	179392	4183278	4003886	177106	6	0.6	1000	14.423	22.873	0.3	M4-2
75	39003	39078	1065070	1025992	39003	0	0.6	1000	14.423	22.873	0.3	M4-2
76	0	0	0	0	0	0	0.6	1000	14.423	22.873	0.3	M4-2
78	1259024	1259093	3166386	1907293	1259024	0	0.6	1000	14.423	22.873	0.3	M4-2
81	10255	10259	306936	296677	10255	0	0.6	1000	14.423	22.873	0.3	M4-2
84	7599	7599	109746	102147	7599	0	0.6	1000	14.423	22.873	0.3	M4-2
87	1035	1045	17766	16721	1035	0	0.6	1000	14.423	22.873	0.3	M4-2
88	0	0	0	0	0	0	0.6	1000	14.423	22.873	0.3	M4-2
90	198	198	3321	3123	198	0	0.6	1000	14.423	22.873	0.3	M4-2
18	0	0	0	0	0	0	0.6	1000	14.614	22.87	0.5	M4-2
24	66	66	2415	2349	67	1	0.6	1000	14.614	22.87	0.5	M4-2
27	7849	7849	32385	24536	7977	128	0.6	1000	14.614	22.87	0.5	M4-2
30	1754	1755	45451	43696	1755	1	0.6	1000	14.614	22.87	0.5	M4-2
33	6752	6766	464166	457400	6752	0	0.6	1000	14.614	22.87	0.5	M4-2
36	19722	19751	1104841	1085090	19726	4	0.6	1000	14.614	22.87	0.5	M4-2
37	0	0	0	0	0	0	0.6	1000	14.614	22.87	0.5	M4-2
39	38213	38833	3635556	3596723	38252	39	0.6	1000	14.614	22.87	0.5	M4-2
42	59787	60938	9537528	9476590	59987	200	0.6	1000	14.614	22.87	0.5	M4-2
45	288250	295941	22361328	22065387	288280	30	0.6	1000	14.614	22.87	0.5	M4-2
46	0	0	0	0	0	0	0.6	1000	14.614	22.87	0.5	M4-2
48	191212	191571	22181130	21989559	191232	20	0.6	1000	14.614	22.87	0.5	M4-2
49	0	0	0	0	0	0	0.6	1000	14.614	22.87	0.5	M4-2
51	157279	157856	24238203	24080347	157603	324	0.6	1000	14.614	22.87	0.5	M4-2
52	0	0	0	0	0	0	0.6	1000	14.614	22.87	0.5	M4-2
53	0	0	1	1	0	0	0.6	1000	14.614	22.87	0.5	M4-2
54	135042	135783	21056805	20921022	135050	8	0.6	1000	14.614	22.87	0.5	M4-2
57	188538	189527	21232386	21042859	189113	575	0.6	1000	14.614	22.87	0.5	M4-2
58	0	0	3	3	0	0	0.6	1000	14.614	22.87	0.5	M4-2
59	0	0	0	0	0	0	0.6	1000	14.614	22.87	0.5	M4-2
60	138170	138967	17811496	17672529	138177	7	0.6	1000	14.614	22.87	0.5	M4-2
63	155802	157052	11217216	11060164	155806	4	0.6	1000	14.614	22.87	0.5	M4-2
66	422314	423380	15343030	14919650	422317	3	0.6	1000	14.614	22.87	0.5	M4-2
67	6	6	6	0	6	0	0.6	1000	14.614	22.87	0.5	M4-2
69	209400	209804	6453028	6243224	209411	11	0.6	1000	14.614	22.87	0.5	M4-2
71	10	10	10	0	10	0	0.6	1000	14.614	22.87	0.5	M4-2
72	177097	179392	4183278	4003886	177101	4	0.6	1000	14.614	22.87	0.5	M4-2
75	39003	39078	1065070	1025992	39003	0	0.6	1000	14.614	22.87	0.5	M4-2
76	0	0	0	0	0	0	0.6	1000	14.614	22.87	0.5	M4-2
78	1259024	1259093	3166386	1907293	1259024	0	0.6	1000	14.614	22.87	0.5	M4-2
81	10255	10259	306936	296677	10255	0	0.6	1000	14.614	22.87	0.5	M4-2
84	7599	7599	109746	102147	7599	0	0.6	1000	14.614	22.87	0.5	M4-2
87	1035	1045	17766	16721	1035	0	0.6	1000	14.614	22.87	0.5	M4-2
88	0	0	0	0	0	0	0.6	1000	14.614	22.87	0.5	M4-2
90	198	198	3321	3123	198	0	0.6	1000	14.614	22.87	0.5	M4-2
6	0	0	0	0	0	0	0.6	1000	14.632	21.996	0.3	M4-7
9	0	0	0	0	0	0	0.6	1000	14.632	21.996	0.3	M4-7
24	73	73	3321	3248	91	18	0.6	1000	14.632	21.996	0.3	M4-7
27	1224	1224	14365	13141	1224	0	0.6	1000	14.632	21.996	0.3	M4-7
30	73556	73576	260281	186705	73563	7	0.6	1000	14.632	21.996	0.3	M4-7
33	38435	38468	425503	387035	38441	6	0.6	1000	14.632	21.996	0.3	M4-7
36	17869	17948	1225395	1207447	17912	43	0.6	1000	14.632	21.996	0.3	M4-7
39	116881	127039	6695970	6568931	116883	2	0.6	1000	14.632	21.996	0.3	M4-7
42	31577	31874	6762003	6730129	31728	151	0.6	1000	14.632	21.996	0.3	M4-7
44	0	0	0	0	0	0	0.6	1000	14.632	21.996	0.3	M4-7
45	205938	209107	15677200	15468093	206007	69	0.6	1000	14.632	21.996	0.3	M4-7
48	1335160	1337343	31224753	29887410	1335178	18	0.6	1000	14.632	21.996	0.3	M4-7
51	273506	295282	32679570	32384288	273603	97	0.6	1000	14.632	21.996	0.3	M4-7
54	259434	261903	21245421	20983518	259438	4	0.6	1000	14.632	21.996	0.3	M4-7
56	15	15	15	0	15	0	0.6	1000	14.632	21.996	0.3	M4-7
57	97607	98365	19917516	19819151	98020	413	0.6	1000	14.632	21.996	0.3	M4-7
59	10	10	10	0	10	0	0.6	1000	14.632	21.996	0.3	M4-7
60	159250	161179	18638565	18477386	159392	142	0.6	1000	14.632	21.996	0.3	M4-7
63	45842	46621	8952796	8906175	45870	28	0.6	1000	14.632	21.996	0.3	M4-7
66	202485	222015	12012351	11790336	202644	159	0.6	1000	14.632	21.996	0.3	M4-7
69	108207	120943	5089645	4968702	108207	0	0.6	1000	14.632	21.996	0.3	M4-7
72	174745	175964	3073960	2897996	174758	13	0.6	1000	14.632	21.996	0.3	M4-7
74	21	21	21	0	21	0	0.6	1000	14.632	21.996	0.3	M4-7
75	15289	15480	1097421	1081941	15289	0	0.6	1000	14.632	21.996	0.3	M4-7
76	1	1	1	0	1	0	0.6	1000	14.632	21.996	0.3	M4-7
78	166902	166912	1269621	1102709	166919	17	0.6	1000	14.632	21.996	0.3	M4-7
81	55999	56000	546535	490535	55999	0	0.6	1000	14.632	21.996	0.3	M4-7
84	107561	107563	424581	317018	107561	0	0.6	1000	14.632	21.996	0.3	M4-7
87	6585	6671	54946	48275	6585	0	0.6	1000	14.632	21.996	0.3	M4-7
90	814	814	14028	13214	814	0	0.6	1000	14.632	21.996	0.3	M4-7
3	0	0	0	0	0	0	0.6	1000	14.642	21.583	0.1	M4-3
24	262	262	8128	7866	262	0	0.6	1000	14.642	21.583	0.1	M4-3
27	699	700	8385	7685	699	0	0.6	1000	14.642	21.583	0.1	M4-3
30	443	444	23653	23209	443	0	0.6	1000	14.642	21.583	0.1	M4-3
33	3833	3835	248865	245030	3833	0	0.6	1000	14.642	21.583	0.1	M4-3
36	17332	17437	980700	963263	17353	21	0.6	1000	14.642	21.583	0.1	M4-3
39	46527	48397	4474536	4426139	46529	2	0.6	1000	14.642	21.583	0.1	M4-3
40	0	0	0	0	0	0	0.6	1000	14.642	21.583	0.1	M4-3
41	0	0	0	0	0	0	0.6	1000	14.642	21.583	0.1	M4-3
42	204861	206665	11546415	11339750	204886	25	0.6	1000	14.642	21.583	0.1	M4-3
45	216354	218294	17787630	17569336	216975	621	0.6	1000	14.642	21.583	0.1	M4-3
46	0	0	0	0	0	0	0.6	1000	14.642	21.583	0.1	M4-3
48	172099	181346	20611410	20430064	172107	8	0.6	1000	14.642	21.583	0.1	M4-3
51	171018	172152	21206328	21034176	171058	40	0.6	1000	14.642	21.583	0.1	M4-3
52	0	0	0	0	0	0	0.6	1000	14.642	21.583	0.1	M4-3
54	241297	276217	26357430	26081213	241363	66	0.6	1000	14.642	21.583	0.1	M4-3
55	0	0	0	0	0	0	0.6	1000	14.642	21.583	0.1	M4-3
56	36	36	36	0	36	0	0.6	1000	14.642	21.583	0.1	M4-3
57	1397930	1400547	29548828	28148281	1398112	182	0.6	1000	14.642	21.583	0.1	M4-3
60	192747	196584	18370891	18174307	192793	46	0.6	1000	14.642	21.583	0.1	M4-3
62	0	0	0	0	0	0	0.6	1000	14.642	21.583	0.1	M4-3
63	233587	236297	16213665	15977368	233590	3	0.6	1000	14.642	21.583	0.1	M4-3
64	0	0	0	0	0	0	0.6	1000	14.642	21.583	0.1	M4-3
66	46601	47900	6984453	6936553	46601	0	0.6	1000	14.642	21.583	0.1	M4-3
67	0	0	0	0	0	0	0.6	1000	14.642	21.583	0.1	M4-3
69	72440	73144	5867025	5793881	72447	7	0.6	1000	14.642	21.583	0.1	M4-3
72	121723	124708	4145760	4021052	121815	92	0.6	1000	14.642	21.583	0.1	M4-3
75	97994	98608	2518890	2420282	97994	0	0.6	1000	14.642	21.583	0.1	M4-3
77	3	3	3	0	3	0	0.6	1000	14.642	21.583	0.1	M4-3
78	73167	73171	764466	691295	73167	0	0.6	1000	14.642	21.583	0.1	M4-3
81	1965	2008	103740	101732	1965	0	0.6	1000	14.642	21.583	0.1	M4-3
84	6131	6134	107880	101746	6131	0	0.6	1000	14.642	21.583	0.1	M4-3
87	2453	2453	16110	13657	2453	0	0.6	1000	14.642	21.583	0.1	M4-3
90	148378	148922	230860	81938	148378	0	0.6	1000	14.642	21.583	0.1	M4-3
3	0	0	0	0	0	0	0.6	1000	14.67	23.264	0.1	M4-9
24	343	355	8646	8291	343	0	0.6	1000	14.67	23.264	0.1	M4-9
27	9263	9263	49770	40507	9265	2	0.6	1000	14.67	23.264	0.1	M4-9
30	18430	18430	109278	90848	18435	5	0.6	1000	14.67	23.264	0.1	M4-9
33	9325	9472	441330	431858	9327	2	0.6	1000	14.67	23.264	0.1	M4-9
35	21	21	21	0	21	0	0.6	1000	14.67	23.264	0.1	M4-9
36	270094	281690	5416986	5135296	270106	12	0.6	1000	14.67	23.264	0.1	M4-9
39	83989	84531	3873936	3789405	83989	0	0.6	1000	14.67	23.264	0.1	M4-9
41	0	0	0	0	0	0	0.6	1000	14.67	23.264	0.1	M4-9
42	79279	80311	7622560	7542249	79441	162	0.6	1000	14.67	23.264	0.1	M4-9
45	122346	123831	16287778	16163947	122511	165	0.6	1000	14.67	23.264	0.1	M4-9
46	0	0	1	1	0	0	0.6	1000	14.67	23.264	0.1	M4-9
47	0	0	0	0	0	0	0.6	1000	14.67	23.264	0.1	M4-9
48	102675	104033	20979003	20874970	102691	16	0.6	1000	14.67	23.264	0.1	M4-9
51	215896	220997	23471526	23250529	215921	25	0.6	1000	14.67	23.264	0.1	M4-9
54	413583	417226	34283340	33866114	413805	222	0.6	1000	14.67	23.264	0.1	M4-9
55	0	0	1	1	0	0	0.6	1000	14.67	23.264	0.1	M4-9
57	34859	39052	12323130	12284078	35420	561	0.6	1000	14.67	23.264	0.1	M4-9
58	0	0	0	0	0	0	0.6	1000	14.67	23.264	0.1	M4-9
59	0	0	0	0	0	0	0.6	1000	14.67	23.264	0.1	M4-9
60	1387229	1436109	31327570	29891461	1387241	12	0.6	1000	14.67	23.264	0.1	M4-9
61	0	0	0	0	0	0	0.6	1000	14.67	23.264	0.1	M4-9
63	122331	123350	12357906	12234556	122340	9	0.6	1000	14.67	23.264	0.1	M4-9
66	221826	223273	9642636	9419363	221826	0	0.6	1000	14.67	23.264	0.1	M4-9
69	49570	50344	5410405	5360061	49570	0	0.6	1000	14.67	23.264	0.1	M4-9
72	83085	112731	2951235	2838504	83085	0	0.6	1000	14.67	23.264	0.1	M4-9
75	7296	7356	625521	618165	7296	0	0.6	1000	14.67	23.264	0.1	M4-9
78	58145	65284	1084128	1018844	58145	0	0.6	1000	14.67	23.264	0.1	M4-9
81	104907	104907	518671	413764	104907	0	0.6	1000	14.67	23.264	0.1	M4-9
84	76457	76760	299151	222391	76457	0	0.6	1000	14.67	23.264	0.1	M4-9
87	8887	8887	39621	30734	8888	1	0.6	1000	14.67	23.264	0.1	M4-9
90	956	956	7626	6670	956	0	0.6	1000	14.67	23.264	0.1	M4-9
6	0	0	0	0	0	0	0.6	1000	14.802	22.17	0.1	M4-7
9	0	0	0	0	0	0	0.6	1000	14.802	22.17	0.1	M4-7
24	73	73	3321	3248	91	18	0.6	1000	14.802	22.17	0.1	M4-7
27	1224	1224	14365	13141	1224	0	0.6	1000	14.802	22.17	0.1	M4-7
30	73556	73576	260281	186705	73563	7	0.6	1000	14.802	22.17	0.1	M4-7
33	38435	38468	425503	387035	38441	6	0.6	1000	14.802	22.17	0.1	M4-7
36	17869	17948	1225395	1207447	17912	43	0.6	1000	14.802	22.17	0.1	M4-7
39	116291	127039	6695970	6568931	116291	0	0.6	1000	14.802	22.17	0.1	M4-7
42	31055	31874	6762003	6730129	31131	76	0.6	1000	14.802	22.17	0.1	M4-7
44	0	0	0	0	0	0	0.6	1000	14.802	22.17	0.1	M4-7
45	207837	209107	15677200	15468093	207856	19	0.6	1000	14.802	22.17	0.1	M4-7
48	1335073	1337343	31224753	29887410	1335091	18	0.6	1000	14.802	22.17	0.1	M4-7
51	273614	295282	32679570	32384288	273705	91	0.6	1000	14.802	22.17	0.1	M4-7
54	259218	261903	21245421	20983518	259220	2	0.6	1000	14.802	22.17	0.1	M4-7
56	15	15	15	0	15	0	0.6	1000	14.802	22.17	0.1	M4-7
57	96909	98365	19917516	19819151	97301	392	0.6	1000	14.802	22.17	0.1	M4-7
59	10	10	10	0	10	0	0.6	1000	14.802	22.17	0.1	M4-7
60	159049	161179	18638565	18477386	159179	130	0.6	1000	14.802	22.17	0.1	M4-7
63	46031	46621	8952796	8906175	46059	28	0.6	1000	14.802	22.17	0.1	M4-7
66	201820	222015	12012351	11790336	201979	159	0.6	1000	14.802	22.17	0.1	M4-7
69	107750	120943	5089645	4968702	107750	0	0.6	1000	14.802	22.17	0.1	M4-7
72	174555	175964	3073960	2897996	174568	13	0.6	1000	14.802	22.17	0.1	M4-7
74	21	21	21	0	21	0	0.6	1000	14.802	22.17	0.1	M4-7
75	15289	15480	1097421	1081941	15289	0	0.6	1000	14.802	22.17	0.1	M4-7
76	1	1	1	0	1	0	0.6	1000	14.802	22.17	0.1	M4-7
78	166902	166912	1269621	1102709	166919	17	0.6	1000	14.802	22.17	0.1	M4-7
81	55999	56000	546535	490535	55999	0	0.6	1000	14.802	22.17	0.1	M4-7
84	107561	107563	424581	317018	107561	0	0.6	1000	14.802	22.17	0.1	M4-7
87	6585	6671	54946	48275	6585	0	0.6	1000	14.802	22.17	0.1	M4-7
90	814	814	14028	13214	814	0	0.6	1000	14.802	22.17	0.1	M4-7
3	0	0	0	0	0	0	0.6	1000	14.826	20.814	0.3	M4-3
24	262	262	8128	7866	262	0	0.6	1000	14.826	20.814	0.3	M4-3
27	699	700	8385	7685	699	0	0.6	1000	14.826	20.814	0.3	M4-3
30	443	444	23653	23209	443	0	0.6	1000	14.826	20.814	0.3	M4-3
33	3833	3835	248865	245030	3833	0	0.6	1000	14.826	20.814	0.3	M4-3
36	17332	17437	980700	963263	17353	21	0.6	1000	14.826	20.814	0.3	M4-3
39	46513	48397	4474536	4426139	46537	24	0.6	1000	14.826	20.814	0.3	M4-3
40	0	0	0	0	0	0	0.6	1000	14.826	20.814	0.3	M4-3
41	0	0	0	0	0	0	0.6	1000	14.826	20.814	0.3	M4-3
42	205828	206665	11546415	11339750	205856	28	0.6	1000	14.826	20.814	0.3	M4-3
45	216370	218294	17787630	17569336	216499	129	0.6	1000	14.826	20.814	0.3	M4-3
46	0	0	0	0	0	0	0.6	1000	14.826	20.814	0.3	M4-3
48	171357	181346	20611410	20430064	171366	9	0.6	1000	14.826	20.814	0.3	M4-3
51	170999	172152	21206328	21034176	171030	31	0.6	1000	14.826	20.814	0.3	M4-3
52	0	0	0	0	0	0	0.6	1000	14.826	20.814	0.3	M4-3
54	252914	276217	26357430	26081213	252979	65	0.6	1000	14.826	20.814	0.3	M4-3
55	0	0	0	0	0	0	0.6	1000	14.826	20.814	0.3	M4-3
56	36	36	36	0	36	0	0.6	1000	14.826	20.814	0.3	M4-3
57	1398826	1400547	29548828	28148281	1399016	190	0.6	1000	14.826	20.814	0.3	M4-3
60	193466	196584	18370891	18174307	193500	34	0.6	1000	14.826	20.814	0.3	M4-3
62	0	0	0	0	0	0	0.6	1000	14.826	20.814	0.3	M4-3
63	234035	236297	16213665	15977368	234038	3	0.6	1000	14.826	20.814	0.3	M4-3
64	0	0	0	0	0	0	0.6	1000	14.826	20.814	0.3	M4-3
66	39337	47900	6984453	6936553	39337	0	0.6	1000	14.826	20.814	0.3	M4-3
67	0	0	0	0	0	0	0.6	1000	14.826	20.814	0.3	M4-3
69	72635	73144	5867025	5793881	72641	6	0.6	1000	14.826	20.814	0.3	M4-3
72	122713	124708	4145760	4021052	122805	92	0.6	1000	14.826	20.814	0.3	M4-3
75	98158	98608	2518890	2420282	98158	0	0.6	1000	14.826	20.814	0.3	M4-3
77	3	3	3	0	3	0	0.6	1000	14.826	20.814	0.3	M4-3
78	73167	73171	764466	691295	73167	0	0.6	1000	14.826	20.814	0.3	M4-3
81	1965	2008	103740	101732	1965	0	0.6	1000	14.826	20.814	0.3	M4-3
84	6131	6134	107880	101746	6131	0	0.6	1000	14.826	20.814	0.3	M4-3
87	2453	2453	16110	13657	2453	0	0.6	1000	14.826	20.814	0.3	M4-3
90	148378	148922	230860	81938	148378	0	0.6	1000	14.826	20.814	0.3	M4-3
6	0	0	0	0	0	0	0.6	1000	15.007	21.916	1.0	M4-4
9	0	0	0	0	0	0	0.6	1000	15.007	21.916	1.0	M4-4
24	1018	1043	10296	9253	1018	0	0.6	1000	15.007	21.916	1.0	M4-4
27	648	648	14196	13548	648	0	0.6	1000	15.007	21.916	1.0	M4-4
30	1241	1277	59685	58408	1268	27	0.6	1000	15.007	21.916	1.0	M4-4
33	4938	4954	217470	212516	4938	0	0.6	1000	15.007	21.916	1.0	M4-4
36	22300	22530	1118260	1095730	22302	2	0.6	1000	15.007	21.916	1.0	M4-4
39	116199	117765	5089645	4971880	116211	12	0.6	1000	15.007	21.916	1.0	M4-4
42	121330	121715	8154741	8033026	121366	36	0.6	1000	15.007	21.916	1.0	M4-4
45	201393	203168	18889731	18686563	201398	5	0.6	1000	15.007	21.916	1.0	M4-4
46	0	0	0	0	0	0	0.6	1000	15.007	21.916	1.0	M4-4
48	173868	175008	19829253	19654245	173953	85	0.6	1000	15.007	21.916	1.0	M4-4
51	247258	247933	25866028	25618095	247315	57	0.6	1000	15.007	21.916	1.0	M4-4
53	0	0	0	0	0	0	0.6	1000	15.007	21.916	1.0	M4-4
54	157036	157817	20075616	19917799	157039	3	0.6	1000	15.007	21.916	1.0	M4-4
56	0	0	0	0	0	0	0.6	1000	15.007	21.916	1.0	M4-4
57	314713	318553	26941470	26622917	314899	186	0.6	1000	15.007	21.916	1.0	M4-4
60	203962	216266	16453716	16237450	203983	21	0.6	1000	15.007	21.916	1.0	M4-4
61	0	0	3	3	0	0	0.6	1000	15.007	21.916	1.0	M4-4
63	123596	124499	13915450	13790951	123606	10	0.6	1000	15.007	21.916	1.0	M4-4
64	0	0	0	0	0	0	0.6	1000	15.007	21.916	1.0	M4-4
65	0	0	1	1	0	0	0.6	1000	15.007	21.916	1.0	M4-4
66	1394257	1396024	18141276	16745252	1394257	0	0.6	1000	15.007	21.916	1.0	M4-4
67	0	0	0	0	0	0	0.6	1000	15.007	21.916	1.0	M4-4
68	0	0	0	0	0	0	0.6	1000	15.007	21.916	1.0	M4-4
69	78684	105881	5446650	5340769	78684	0	0.6	1000	15.007	21.916	1.0	M4-4
71	0	0	0	0	0	0	0.6	1000	15.007	21.916	1.0	M4-4
72	82364	83274	3544453	3461179	82365	1	0.6	1000	15.007	21.916	1.0	M4-4
74	0	0	0	0	0	0	0.6	1000	15.007	21.916	1.0	M4-4
75	34567	34801	1154440	1119639	34567	0	0.6	1000	15.007	21.916	1.0	M4-4
78	47170	47170	676866	629696	47176	6	0.6	1000	15.007	21.916	1.0	M4-4
81	20811	20825	243253	222428	20811	0	0.6	1000	15.007	21.916	1.0	M4-4
82	0	0	0	0	0	0	0.6	1000	15.007	21.916	1.0	M4-4
84	13240	13300	167331	154031	13240	0	0.6	1000	15.007	21.916	1.0	M4-4
87	47704	48628	110685	62057	47704	0	0.6	1000	15.007	21.916	1.0	M4-4
90	1089	1097	18528	17431	1089	0	0.6	1000	15.007	21.916	1.0	M4-4
3	0	0	0	0	0	0	0.6	1000	15.052	21.306	0.5	M4-1
6	0	0	0	0	0	0	0.6	1000	15.052	21.306	0.5	M4-1
24	73	75	3570	3495	73	0	0.6	1000	15.052	21.306	0.5	M4-1
27	6507	6507	43071	36564	6513	6	0.6	1000	15.052	21.306	0.5	M4-1
30	709	716	40755	40039	714	5	0.6	1000	15.052	21.306	0.5	M4-1
33	33957	33984	424581	390597	33957	0	0.6	1000	15.052	21.306	0.5	M4-1
36	4978	4979	458403	453424	4984	6	0.6	1000	15.052	21.306	0.5	M4-1
39	221503	234607	6813586	6578979	221518	15	0.6	1000	15.052	21.306	0.5	M4-1
41	0	0	0	0	0	0	0.6	1000	15.052	21.306	0.5	M4-1
42	69864	74965	8559453	8484488	71002	1138	0.6	1000	15.052	21.306	0.5	M4-1
45	271938	274902	18638565	18363663	271957	19	0.6	1000	15.052	21.306	0.5	M4-1
47	0	0	0	0	0	0	0.6	1000	15.052	21.306	0.5	M4-1
48	210252	212334	24981846	24769512	210659	407	0.6	1000	15.052	21.306	0.5	M4-1
49	0	0	0	0	0	0	0.6	1000	15.052	21.306	0.5	M4-1
50	10	10	15	5	10	0	0.6	1000	15.052	21.306	0.5	M4-1
51	268120	270020	34283340	34013320	268134	14	0.6	1000	15.052	21.306	0.5	M4-1
52	0	0	0	0	0	0	0.6	1000	15.052	21.306	0.5	M4-1
53	0	0	1	1	0	0	0.6	1000	15.052	21.306	0.5	M4-1
54	249339	257003	26335653	26078650	249357	18	0.6	1000	15.052	21.306	0.5	M4-1
56	55	55	55	0	55	0	0.6	1000	15.052	21.306	0.5	M4-1
57	91928	92998	17307786	17214788	91938	10	0.6	1000	15.052	21.306	0.5	M4-1
58	0	0	0	0	0	0	0.6	1000	15.052	21.306	0.5	M4-1
60	172654	174264	15354111	15179847	172655	1	0.6	1000	15.052	21.306	0.5	M4-1
63	89326	90130	11987856	11897726	89376	50	0.6	1000	15.052	21.306	0.5	M4-1
65	0	0	0	0	0	0	0.6	1000	15.052	21.306	0.5	M4-1
66	188942	189660	8704878	8515218	188942	0	0.6	1000	15.052	21.306	0.5	M4-1
67	0	0	0	0	0	0	0.6	1000	15.052	21.306	0.5	M4-1
69	148615	148774	7634278	7485504	148621	6	0.6	1000	15.052	21.306	0.5	M4-1
72	1445460	1449473	11493615	10044142	1445465	5	0.6	1000	15.052	21.306	0.5	M4-1
73	1	1	1	0	1	0	0.6	1000	15.052	21.306	0.5	M4-1
75	18218	18309	962578	944269	18218	0	0.6	1000	15.052	21.306	0.5	M4-1
78	12180	12247	451725	439478	12180	0	0.6	1000	15.052	21.306	0.5	M4-1
81	1988	2002	126756	124754	1988	0	0.6	1000	15.052	21.306	0.5	M4-1
84	5572	5573	52650	47077	5572	0	0.6	1000	15.052	21.306	0.5	M4-1
87	620	621	12403	11782	620	0	0.6	1000	15.052	21.306	0.5	M4-1
90	218	233	4753	4520	218	0	0.6	1000	15.052	21.306	0.5	M4-1
9	0	0	0	0	0	0	0.6	1000	15.174	21.779	0.3	M4-8
24	346	347	6555	6208	365	19	0.6	1000	15.174	21.779	0.3	M4-8
27	569	569	14535	13966	569	0	0.6	1000	15.174	21.779	0.3	M4-8
29	0	0	0	0	0	0	0.6	1000	15.174	21.779	0.3	M4-8
30	74901	74901	230860	155959	74901	0	0.6	1000	15.174	21.779	0.3	M4-8
33	3113	3198	222778	219580	3168	55	0.6	1000	15.174	21.779	0.3	M4-8
36	96886	97366	2333880	2236514	96890	4	0.6	1000	15.174	21.779	0.3	M4-8
38	0	0	0	0	0	0	0.6	1000	15.174	21.779	0.3	M4-8
39	36383	37115	4157286	4120171	36485	102	0.6	1000	15.174	21.779	0.3	M4-8
42	171765	172280	8460441	8288161	171786	21	0.6	1000	15.174	21.779	0.3	M4-8
45	302949	305407	21704166	21398759	302977	28	0.6	1000	15.174	21.779	0.3	M4-8
48	384574	402907	35418736	35015829	385011	437	0.6	1000	15.174	21.779	0.3	M4-8
49	0	0	0	0	0	0	0.6	1000	15.174	21.779	0.3	M4-8
50	0	0	1	1	0	0	0.6	1000	15.174	21.779	0.3	M4-8
51	82971	84579	18994366	18909787	83081	110	0.6	1000	15.174	21.779	0.3	M4-8
52	78	78	120	42	78	0	0.6	1000	15.174	21.779	0.3	M4-8
54	1470415	1471430	38759610	37288180	1470433	18	0.6	1000	15.174	21.779	0.3	M4-8
55	1	1	3	2	1	0	0.6	1000	15.174	21.779	0.3	M4-8
56	12720	12880	13203	323	12720	0	0.6	1000	15.174	21.779	0.3	M4-8
57	329178	334108	29518086	29183978	336314	7136	0.6	1000	15.174	21.779	0.3	M4-8
58	276	276	276	0	276	0	0.6	1000	15.174	21.779	0.3	M4-8
59	0	0	0	0	0	0	0.6	1000	15.174	21.779	0.3	M4-8
60	56220	56888	11841411	11784523	56252	32	0.6	1000	15.174	21.779	0.3	M4-8
63	74281	75315	10001628	9926313	74287	6	0.6	1000	15.174	21.779	0.3	M4-8
66	47022	50377	7108335	7057958	47022	0	0.6	1000	15.174	21.779	0.3	M4-8
67	0	0	0	0	0	0	0.6	1000	15.174	21.779	0.3	M4-8
69	117242	117895	3643650	3525755	117248	6	0.6	1000	15.174	21.779	0.3	M4-8
70	0	0	0	0	0	0	0.6	1000	15.174	21.779	0.3	M4-8
72	176437	184108	5286126	5102018	176455	18	0.6	1000	15.174	21.779	0.3	M4-8
75	35509	35512	1110795	1075283	35509	0	0.6	1000	15.174	21.779	0.3	M4-8
78	4414	4441	296835	292394	4415	1	0.6	1000	15.174	21.779	0.3	M4-8
81	63885	63908	385881	321973	63885	0	0.6	1000	15.174	21.779	0.3	M4-8
84	14535	28419	126756	98337	14535	0	0.6	1000	15.174	21.779	0.3	M4-8
87	225	227	6670	6443	225	0	0.6	1000	15.174	21.779	0.3	M4-8
88	0	0	0	0	0	0	0.6	1000	15.174	21.779	0.3	M4-8
90	123	123	2556	2433	123	0	0.6	1000	15.174	21.779	0.3	M4-8
3	0	0	0	0	0	0	0.6	1000	15.183	23.262	0.5	M4-9
24	343	355	8646	8291	343	0	0.6	1000	15.183	23.262	0.5	M4-9
27	9263	9263	49770	40507	9265	2	0.6	1000	15.183	23.262	0.5	M4-9
30	18430	18430	109278	90848	18435	5	0.6	1000	15.183	23.262	0.5	M4-9
33	9325	9472	441330	431858	9327	2	0.6	1000	15.183	23.262	0.5	M4-9
35	21	21	21	0	21	0	0.6	1000	15.183	23.262	0.5	M4-9
36	270094	281690	5416986	5135296	270106	12	0.6	1000	15.183	23.262	0.5	M4-9
39	84242	84531	3873936	3789405	84246	4	0.6	1000	15.183	23.262	0.5	M4-9
41	0	0	0	0	0	0	0.6	1000	15.183	23.262	0.5	M4-9
42	79036	80311	7622560	7542249	79193	157	0.6	1000	15.183	23.262	0.5	M4-9
45	123182	123831	16287778	16163947	123235	53	0.6	1000	15.183	23.262	0.5	M4-9
46	0	0	1	1	0	0	0.6	1000	15.183	23.262	0.5	M4-9
47	0	0	0	0	0	0	0.6	1000	15.183	23.262	0.5	M4-9
48	102764	104033	20979003	20874970	102795	31	0.6	1000	15.183	23.262	0.5	M4-9
51	217605	220997	23471526	23250529	217630	25	0.6	1000	15.183	23.262	0.5	M4-9
54	413555	417226	34283340	33866114	413782	227	0.6	1000	15.183	23.262	0.5	M4-9
55	0	0	1	1	0	0	0.6	1000	15.183	23.262	0.5	M4-9
57	35438	39052	12323130	12284078	35997	559	0.6	1000	15.183	23.262	0.5	M4-9
58	0	0	0	0	0	0	0.6	1000	15.183	23.262	0.5	M4-9
59	0	0	0	0	0	0	0.6	1000	15.183	23.262	0.5	M4-9
60	1337333	1436109	31327570	29891461	1337346	13	0.6	1000	15.183	23.262	0.5	M4-9
61	0	0	0	0	0	0	0.6	1000	15.183	23.262	0.5	M4-9
63	123093	123350	12357906	12234556	123102	9	0.6	1000	15.183	23.262	0.5	M4-9
66	222275	223273	9642636	9419363	222275	0	0.6	1000	15.183	23.262	0.5	M4-9
69	49919	50344	5410405	5360061	49919	0	0.6	1000	15.183	23.262	0.5	M4-9
72	82738	112731	2951235	2838504	82738	0	0.6	1000	15.183	23.262	0.5	M4-9
75	7296	7356	625521	618165	7296	0	0.6	1000	15.183	23.262	0.5	M4-9
78	58145	65284	1084128	1018844	58145	0	0.6	1000	15.183	23.262	0.5	M4-9
81	104907	104907	518671	413764	104907	0	0.6	1000	15.183	23.262	0.5	M4-9
84	76457	76760	299151	222391	76457	0	0.6	1000	15.183	23.262	0.5	M4-9
87	8887	8887	39621	30734	8888	1	0.6	1000	15.183	23.262	0.5	M4-9
90	956	956	7626	6670	956	0	0.6	1000	15.183	23.262	0.5	M4-9
3	0	0	0	0	0	0	0.6	1000	15.34	21.744	0.3	M4-1
6	0	0	0	0	0	0	0.6	1000	15.34	21.744	0.3	M4-1
24	73	75	3570	3495	73	0	0.6	1000	15.34	21.744	0.3	M4-1
27	6507	6507	43071	36564	6513	6	0.6	1000	15.34	21.744	0.3	M4-1
30	709	716	40755	40039	714	5	0.6	1000	15.34	21.744	0.3	M4-1
33	33957	33984	424581	390597	33957	0	0.6	1000	15.34	21.744	0.3	M4-1
36	4978	4979	458403	453424	4984	6	0.6	1000	15.34	21.744	0.3	M4-1
39	220850	234607	6813586	6578979	220869	19	0.6	1000	15.34	21.744	0.3	M4-1
41	0	0	0	0	0	0	0.6	1000	15.34	21.744	0.3	M4-1
42	72178	74965	8559453	8484488	73316	1138	0.6	1000	15.34	21.744	0.3	M4-1
45	272269	274902	18638565	18363663	272283	14	0.6	1000	15.34	21.744	0.3	M4-1
47	0	0	0	0	0	0	0.6	1000	15.34	21.744	0.3	M4-1
48	210300	212334	24981846	24769512	210707	407	0.6	1000	15.34	21.744	0.3	M4-1
49	0	0	0	0	0	0	0.6	1000	15.34	21.744	0.3	M4-1
50	10	10	15	5	10	0	0.6	1000	15.34	21.744	0.3	M4-1
51	268028	270020	34283340	34013320	268156	128	0.6	1000	15.34	21.744	0.3	M4-1
52	0	0	0	0	0	0	0.6	1000	15.34	21.744	0.3	M4-1
53	0	0	1	1	0	0	0.6	1000	15.34	21.744	0.3	M4-1
54	249211	257003	26335653	26078650	249231	20	0.6	1000	15.34	21.744	0.3	M4-1
56	55	55	55	0	55	0	0.6	1000	15.34	21.744	0.3	M4-1
57	91870	92998	17307786	17214788	91896	26	0.6	1000	15.34	21.744	0.3	M4-1
58	0	0	0	0	0	0	0.6	1000	15.34	21.744	0.3	M4-1
60	172564	174264	15354111	15179847	172565	1	0.6	1000	15.34	21.744	0.3	M4-1
63	89331	90130	11987856	11897726	89381	50	0.6	1000	15.34	21.744	0.3	M4-1
65	0	0	0	0	0	0	0.6	1000	15.34	21.744	0.3	M4-1
66	188813	189660	8704878	8515218	188815	2	0.6	1000	15.34	21.744	0.3	M4-1
67	0	0	0	0	0	0	0.6	1000	15.34	21.744	0.3	M4-1
69	148513	148774	7634278	7485504	148519	6	0.6	1000	15.34	21.744	0.3	M4-1
72	1445882	1449473	11493615	10044142	1445887	5	0.6	1000	15.34	21.744	0.3	M4-1
73	1	1	1	0	1	0	0.6	1000	15.34	21.744	0.3	M4-1
75	18218	18309	962578	944269	18218	0	0.6	1000	15.34	21.744	0.3	M4-1
78	12180	12247	451725	439478	12180	0	0.6	1000	15.34	21.744	0.3	M4-1
81	1988	2002	126756	124754	1988	0	0.6	1000	15.34	21.744	0.3	M4-1
84	5572	5573	52650	47077	5572	0	0.6	1000	15.34	21.744	0.3	M4-1
87	620	621	12403	11782	620	0	0.6	1000	15.34	21.744	0.3	M4-1
90	218	233	4753	4520	218	0	0.6	1000	15.34	21.744	0.3	M4-1
6	0	0	0	0	0	0	0.6	1000	15.423	22.201	0.1	M4-5
16	0	0	0	0	0	0	0.6	1000	15.423	22.201	0.1	M4-5
24	267	267	4371	4104	268	1	0.6	1000	15.423	22.201	0.1	M4-5
27	67835	67835	130816	62981	67835	0	0.6	1000	15.423	22.201	0.1	M4-5
30	3236	3266	66795	63529	3237	1	0.6	1000	15.423	22.201	0.1	M4-5
31	0	0	0	0	0	0	0.6	1000	15.423	22.201	0.1	M4-5
33	5462	5488	426426	420938	5466	4	0.6	1000	15.423	22.201	0.1	M4-5
35	0	0	0	0	0	0	0.6	1000	15.423	22.201	0.1	M4-5
36	90635	90672	1734453	1643781	90641	6	0.6	1000	15.423	22.201	0.1	M4-5
39	127043	128696	6659425	6530729	127046	3	0.6	1000	15.423	22.201	0.1	M4-5
41	0	0	1	1	0	0	0.6	1000	15.423	22.201	0.1	M4-5
42	1280762	1296587	14690910	13394323	1280881	119	0.6	1000	15.423	22.201	0.1	M4-5
43	0	0	0	0	0	0	0.6	1000	15.423	22.201	0.1	M4-5
45	131664	133059	14372841	14239782	131680	16	0.6	1000	15.423	22.201	0.1	M4-5
46	0	0	1	1	0	0	0.6	1000	15.423	22.201	0.1	M4-5
48	273724	277428	25479091	25201663	273737	13	0.6	1000	15.423	22.201	0.1	M4-5
49	0	0	0	0	0	0	0.6	1000	15.423	22.201	0.1	M4-5
50	0	0	1	1	0	0	0.6	1000	15.423	22.201	0.1	M4-5
51	210737	221173	29594971	29373798	210906	169	0.6	1000	15.423	22.201	0.1	M4-5
53	0	0	0	0	0	0	0.6	1000	15.423	22.201	0.1	M4-5
54	230688	232988	21539766	21306778	230708	20	0.6	1000	15.423	22.201	0.1	M4-5
55	0	0	0	0	0	0	0.6	1000	15.423	22.201	0.1	M4-5
56	1	1	1	0	1	0	0.6	1000	15.423	22.201	0.1	M4-5
57	115519	116789	15997996	15881207	115577	58	0.6	1000	15.423	22.201	0.1	M4-5
60	304283	312328	21677820	21365492	304303	20	0.6	1000	15.423	22.201	0.1	M4-5
63	71726	73672	12081070	12007398	71726	0	0.6	1000	15.423	22.201	0.1	M4-5
66	84472	89976	7842780	7752804	84478	6	0.6	1000	15.423	22.201	0.1	M4-5
67	0	0	0	0	0	0	0.6	1000	15.423	22.201	0.1	M4-5
69	161826	163587	6130251	5966664	161831	5	0.6	1000	15.423	22.201	0.1	M4-5
72	22516	22854	2235555	2212701	22516	0	0.6	1000	15.423	22.201	0.1	M4-5
75	364667	368727	4956526	4587799	364673	6	0.6	1000	15.423	22.201	0.1	M4-5
78	5672	5676	410871	405195	5672	0	0.6	1000	15.423	22.201	0.1	M4-5
81	4777	4812	164451	159639	4777	0	0.6	1000	15.423	22.201	0.1	M4-5
84	5900	5900	90525	84625	5918	18	0.6	1000	15.423	22.201	0.1	M4-5
87	1279	1279	20100	18821	1279	0	0.6	1000	15.423	22.201	0.1	M4-5
90	295	295	3916	3621	295	0	0.6	1000	15.423	22.201	0.1	M4-5
9	0	0	0	0	0	0	0.6	1000	15.461	22.443	0.5	M4-8
24	346	347	6555	6208	365	19	0.6	1000	15.461	22.443	0.5	M4-8
27	569	569	14535	13966	569	0	0.6	1000	15.461	22.443	0.5	M4-8
29	0	0	0	0	0	0	0.6	1000	15.461	22.443	0.5	M4-8
30	74901	74901	230860	155959	74901	0	0.6	1000	15.461	22.443	0.5	M4-8
33	3113	3198	222778	219580	3168	55	0.6	1000	15.461	22.443	0.5	M4-8
36	96886	97366	2333880	2236514	96890	4	0.6	1000	15.461	22.443	0.5	M4-8
38	0	0	0	0	0	0	0.6	1000	15.461	22.443	0.5	M4-8
39	36527	37115	4157286	4120171	36634	107	0.6	1000	15.461	22.443	0.5	M4-8
42	171882	172280	8460441	8288161	171903	21	0.6	1000	15.461	22.443	0.5	M4-8
45	302443	305407	21704166	21398759	302502	59	0.6	1000	15.461	22.443	0.5	M4-8
48	384719	402907	35418736	35015829	385158	439	0.6	1000	15.461	22.443	0.5	M4-8
49	0	0	0	0	0	0	0.6	1000	15.461	22.443	0.5	M4-8
50	0	0	1	1	0	0	0.6	1000	15.461	22.443	0.5	M4-8
51	83056	84579	18994366	18909787	83170	114	0.6	1000	15.461	22.443	0.5	M4-8
52	78	78	120	42	78	0	0.6	1000	15.461	22.443	0.5	M4-8
54	1471069	1471430	38759610	37288180	1471085	16	0.6	1000	15.461	22.443	0.5	M4-8
55	1	1	3	2	1	0	0.6	1000	15.461	22.443	0.5	M4-8
56	12720	12880	13203	323	12720	0	0.6	1000	15.461	22.443	0.5	M4-8
57	328752	334108	29518086	29183978	335888	7136	0.6	1000	15.461	22.443	0.5	M4-8
58	276	276	276	0	276	0	0.6	1000	15.461	22.443	0.5	M4-8
59	0	0	0	0	0	0	0.6	1000	15.461	22.443	0.5	M4-8
60	56564	56888	11841411	11784523	56602	38	0.6	1000	15.461	22.443	0.5	M4-8
63	74172	75315	10001628	9926313	74178	6	0.6	1000	15.461	22.443	0.5	M4-8
66	47087	50377	7108335	7057958	47087	0	0.6	1000	15.461	22.443	0.5	M4-8
67	0	0	0	0	0	0	0.6	1000	15.461	22.443	0.5	M4-8
69	117237	117895	3643650	3525755	117243	6	0.6	1000	15.461	22.443	0.5	M4-8
70	0	0	0	0	0	0	0.6	1000	15.461	22.443	0.5	M4-8
72	176459	184108	5286126	5102018	176477	18	0.6	1000	15.461	22.443	0.5	M4-8
75	35509	35512	1110795	1075283	35509	0	0.6	1000	15.461	22.443	0.5	M4-8
78	4414	4441	296835	292394	4415	1	0.6	1000	15.461	22.443	0.5	M4-8
81	63885	63908	385881	321973	63885	0	0.6	1000	15.461	22.443	0.5	M4-8
84	14535	28419	126756	98337	14535	0	0.6	1000	15.461	22.443	0.5	M4-8
87	225	227	6670	6443	225	0	0.6	1000	15.461	22.443	0.5	M4-8
88	0	0	0	0	0	0	0.6	1000	15.461	22.443	0.5	M4-8
90	123	123	2556	2433	123	0	0.6	1000	15.461	22.443	0.5	M4-8
6	0	0	0	0	0	0	0.6	1000	15.499	21.405	0.3	M4-5
16	0	0	0	0	0	0	0.6	1000	15.499	21.405	0.3	M4-5
24	267	267	4371	4104	268	1	0.6	1000	15.499	21.405	0.3	M4-5
27	67835	67835	130816	62981	67835	0	0.6	1000	15.499	21.405	0.3	M4-5
30	3236	3266	66795	63529	3237	1	0.6	1000	15.499	21.405	0.3	M4-5
31	0	0	0	0	0	0	0.6	1000	15.499	21.405	0.3	M4-5
33	5462	5488	426426	420938	5466	4	0.6	1000	15.499	21.405	0.3	M4-5
35	0	0	0	0	0	0	0.6	1000	15.499	21.405	0.3	M4-5
36	90635	90672	1734453	1643781	90641	6	0.6	1000	15.499	21.405	0.3	M4-5
39	125771	128696	6659425	6530729	125777	6	0.6	1000	15.499	21.405	0.3	M4-5
41	0	0	1	1	0	0	0.6	1000	15.499	21.405	0.3	M4-5
42	1279264	1296587	14690910	13394323	1279369	105	0.6	1000	15.499	21.405	0.3	M4-5
43	0	0	0	0	0	0	0.6	1000	15.499	21.405	0.3	M4-5
45	130487	133059	14372841	14239782	130518	31	0.6	1000	15.499	21.405	0.3	M4-5
46	0	0	1	1	0	0	0.6	1000	15.499	21.405	0.3	M4-5
48	272651	277428	25479091	25201663	272659	8	0.6	1000	15.499	21.405	0.3	M4-5
49	0	0	0	0	0	0	0.6	1000	15.499	21.405	0.3	M4-5
50	0	0	1	1	0	0	0.6	1000	15.499	21.405	0.3	M4-5
51	211624	221173	29594971	29373798	211729	105	0.6	1000	15.499	21.405	0.3	M4-5
53	0	0	0	0	0	0	0.6	1000	15.499	21.405	0.3	M4-5
54	231116	232988	21539766	21306778	231160	44	0.6	1000	15.499	21.405	0.3	M4-5
55	0	0	0	0	0	0	0.6	1000	15.499	21.405	0.3	M4-5
56	1	1	1	0	1	0	0.6	1000	15.499	21.405	0.3	M4-5
57	115959	116789	15997996	15881207	116072	113	0.6	1000	15.499	21.405	0.3	M4-5
60	304683	312328	21677820	21365492	304697	14	0.6	1000	15.499	21.405	0.3	M4-5
63	72206	73672	12081070	12007398	72206	0	0.6	1000	15.499	21.405	0.3	M4-5
66	83947	89976	7842780	7752804	83963	16	0.6	1000	15.499	21.405	0.3	M4-5
67	0	0	0	0	0	0	0.6	1000	15.499	21.405	0.3	M4-5
69	161632	163587	6130251	5966664	161636	4	0.6	1000	15.499	21.405	0.3	M4-5
72	22704	22854	2235555	2212701	22704	0	0.6	1000	15.499	21.405	0.3	M4-5
75	362975	368727	4956526	4587799	362981	6	0.6	1000	15.499	21.405	0.3	M4-5
78	5672	5676	410871	405195	5672	0	0.6	1000	15.499	21.405	0.3	M4-5
81	4777	4812	164451	159639	4777	0	0.6	1000	15.499	21.405	0.3	M4-5
84	5900	5900	90525	84625	5918	18	0.6	1000	15.499	21.405	0.3	M4-5
87	1279	1279	20100	18821	1279	0	0.6	1000	15.499	21.405	0.3	M4-5
90	295	295	3916	3621	295	0	0.6	1000	15.499	21.405	0.3	M4-5
6	1	1	1	0	1	0	0.6	1000	15.562	21.709	0.1	M4-10
9	1	1	1	0	1	0	0.6	1000	15.562	21.709	0.1	M4-10
24	2702	2702	19900	17198	2702	0	0.6	1000	15.562	21.709	0.1	M4-10
26	0	0	0	0	0	0	0.6	1000	15.562	21.709	0.1	M4-10
27	133	133	5886	5753	134	1	0.6	1000	15.562	21.709	0.1	M4-10
30	6895	6906	120295	113389	6895	0	0.6	1000	15.562	21.709	0.1	M4-10
33	8645	8705	421821	413116	8645	0	0.6	1000	15.562	21.709	0.1	M4-10
36	185027	185694	3096316	2910622	185073	46	0.6	1000	15.562	21.709	0.1	M4-10
38	0	0	0	0	0	0	0.6	1000	15.562	21.709	0.1	M4-10
39	103037	105276	5000703	4895427	103075	38	0.6	1000	15.562	21.709	0.1	M4-10
42	282264	288092	11710380	11422288	282337	73	0.6	1000	15.562	21.709	0.1	M4-10
45	301184	304182	20158075	19853893	301199	15	0.6	1000	15.562	21.709	0.1	M4-10
46	0	0	0	0	0	0	0.6	1000	15.562	21.709	0.1	M4-10
47	0	0	1	1	0	0	0.6	1000	15.562	21.709	0.1	M4-10
48	116497	119044	17449278	17330234	116507	10	0.6	1000	15.562	21.709	0.1	M4-10
51	153243	155250	22461753	22306503	153258	15	0.6	1000	15.562	21.709	0.1	M4-10
52	66	66	78	12	66	0	0.6	1000	15.562	21.709	0.1	M4-10
54	212117	214176	23905155	23690979	212120	3	0.6	1000	15.562	21.709	0.1	M4-10
56	0	0	0	0	0	0	0.6	1000	15.562	21.709	0.1	M4-10
57	95115	97008	16591680	16494672	95159	44	0.6	1000	15.562	21.709	0.1	M4-10
60	286961	287898	22061403	21773505	287044	83	0.6	1000	15.562	21.709	0.1	M4-10
63	215894	216374	15986685	15770311	215898	4	0.6	1000	15.562	21.709	0.1	M4-10
64	1	1	6	5	1	0	0.6	1000	15.562	21.709	0.1	M4-10
66	94919	95707	9359301	9263594	94921	2	0.6	1000	15.562	21.709	0.1	M4-10
68	0	0	0	0	0	0	0.6	1000	15.562	21.709	0.1	M4-10
69	1351675	1352601	10540936	9188335	1351675	0	0.6	1000	15.562	21.709	0.1	M4-10
70	0	0	0	0	0	0	0.6	1000	15.562	21.709	0.1	M4-10
72	23998	24755	2229216	2204461	24000	2	0.6	1000	15.562	21.709	0.1	M4-10
75	139754	140475	1910035	1769560	139778	24	0.6	1000	15.562	21.709	0.1	M4-10
76	0	0	0	0	0	0	0.6	1000	15.562	21.709	0.1	M4-10
77	0	0	0	0	0	0	0.6	1000	15.562	21.709	0.1	M4-10
78	12071	12133	649230	637097	12071	0	0.6	1000	15.562	21.709	0.1	M4-10
81	2016	2056	113050	110994	2016	0	0.6	1000	15.562	21.709	0.1	M4-10
84	6455	6774	114481	107707	6455	0	0.6	1000	15.562	21.709	0.1	M4-10
87	1597	1597	25425	23828	1597	0	0.6	1000	15.562	21.709	0.1	M4-10
90	1003	1003	2701	1698	1003	0	0.6	1000	15.562	21.709	0.1	M4-10
3	0	0	0	0	0	0	0.6	1000	15.644	21.294	0.3	M4-6
24	241	241	6216	5975	241	0	0.6	1000	15.644	21.294	0.3	M4-6
27	9599	9599	36046	26447	9599	0	0.6	1000	15.644	21.294	0.3	M4-6
30	33061	33088	166176	133088	33061	0	0.6	1000	15.644	21.294	0.3	M4-6
33	6547	6584	313236	306652	6548	1	0.6	1000	15.644	21.294	0.3	M4-6
36	14069	14077	970921	956844	14071	2	0.6	1000	15.644	21.294	0.3	M4-6
39	27917	29710	3901821	3872111	27917	0	0.6	1000	15.644	21.294	0.3	M4-6
42	47351	47811	7168791	7120980	47423	72	0.6	1000	15.644	21.294	0.3	M4-6
45	80726	82090	11807370	11725280	80765	39	0.6	1000	15.644	21.294	0.3	M4-6
48	149120	181652	19471920	19290268	149185	65	0.6	1000	15.644	21.294	0.3	M4-6
50	0	0	0	0	0	0	0.6	1000	15.644	21.294	0.3	M4-6
51	294226	295443	25715206	25419763	294238	12	0.6	1000	15.644	21.294	0.3	M4-6
52	0	0	0	0	0	0	0.6	1000	15.644	21.294	0.3	M4-6
54	377290	378068	29142795	28764727	377341	51	0.6	1000	15.644	21.294	0.3	M4-6
55	0	0	0	0	0	0	0.6	1000	15.644	21.294	0.3	M4-6
56	0	0	0	0	0	0	0.6	1000	15.644	21.294	0.3	M4-6
57	310802	316820	26284875	25968055	311007	205	0.6	1000	15.644	21.294	0.3	M4-6
59	0	0	0	0	0	0	0.6	1000	15.644	21.294	0.3	M4-6
60	179381	198153	18304275	18106122	179400	19	0.6	1000	15.644	21.294	0.3	M4-6
61	0	0	0	0	0	0	0.6	1000	15.644	21.294	0.3	M4-6
62	0	0	1	1	0	0	0.6	1000	15.644	21.294	0.3	M4-6
63	112925	113334	10646805	10533471	112937	12	0.6	1000	15.644	21.294	0.3	M4-6
64	89	163	276	113	89	0	0.6	1000	15.644	21.294	0.3	M4-6
66	108687	109852	10453878	10344026	108688	1	0.6	1000	15.644	21.294	0.3	M4-6
69	113097	114464	6906186	6791722	113109	12	0.6	1000	15.644	21.294	0.3	M4-6
72	143609	144781	5476395	5331614	143631	22	0.6	1000	15.644	21.294	0.3	M4-6
73	3	3	3	0	3	0	0.6	1000	15.644	21.294	0.3	M4-6
75	142075	142280	2816751	2674471	142080	5	0.6	1000	15.644	21.294	0.3	M4-6
78	110657	112413	1365378	1252965	110657	0	0.6	1000	15.644	21.294	0.3	M4-6
81	1129	1132	74691	73559	1130	1	0.6	1000	15.644	21.294	0.3	M4-6
82	0	0	0	0	0	0	0.6	1000	15.644	21.294	0.3	M4-6
84	1242472	1242636	2089990	847354	1242472	0	0.6	1000	15.644	21.294	0.3	M4-6
87	172	175	11935	11760	172	0	0.6	1000	15.644	21.294	0.3	M4-6
90	269	270	7260	6990	269	0	0.6	1000	15.644	21.294	0.3	M4-6
18	0	0	0	0	0	0	0.6	1000	15.65	22.974	1.0	M4-2
24	66	66	2415	2349	67	1	0.6	1000	15.65	22.974	1.0	M4-2
27	7849	7849	32385	24536	7977	128	0.6	1000	15.65	22.974	1.0	M4-2
30	1754	1755	45451	43696	1755	1	0.6	1000	15.65	22.974	1.0	M4-2
33	6752	6766	464166	457400	6752	0	0.6	1000	15.65	22.974	1.0	M4-2
36	19722	19751	1104841	1085090	19726	4	0.6	1000	15.65	22.974	1.0	M4-2
37	0	0	0	0	0	0	0.6	1000	15.65	22.974	1.0	M4-2
39	38066	38833	3635556	3596723	38118	52	0.6	1000	15.65	22.974	1.0	M4-2
42	60331	60938	9537528	9476590	60530	199	0.6	1000	15.65	22.974	1.0	M4-2
45	287607	295941	22361328	22065387	287635	28	0.6	1000	15.65	22.974	1.0	M4-2
46	0	0	0	0	0	0	0.6	1000	15.65	22.974	1.0	M4-2
48	190984	191571	22181130	21989559	191004	20	0.6	1000	15.65	22.974	1.0	M4-2
49	0	0	0	0	0	0	0.6	1000	15.65	22.974	1.0	M4-2
51	157338	157856	24238203	24080347	157511	173	0.6	1000	15.65	22.974	1.0	M4-2
52	0	0	0	0	0	0	0.6	1000	15.65	22.974	1.0	M4-2
53	0	0	1	1	0	0	0.6	1000	15.65	22.974	1.0	M4-2
54	134958	135783	21056805	20921022	134967	9	0.6	1000	15.65	22.974	1.0	M4-2
57	186188	189527	21232386	21042859	186763	575	0.6	1000	15.65	22.974	1.0	M4-2
58	0	0	3	3	0	0	0.6	1000	15.65	22.974	1.0	M4-2
59	0	0	0	0	0	0	0.6	1000	15.65	22.974	1.0	M4-2
60	138682	138967	17811496	17672529	138689	7	0.6	1000	15.65	22.974	1.0	M4-2
63	155690	157052	11217216	11060164	155694	4	0.6	1000	15.65	22.974	1.0	M4-2
66	361369	423380	15343030	14919650	361372	3	0.6	1000	15.65	22.974	1.0	M4-2
67	6	6	6	0	6	0	0.6	1000	15.65	22.974	1.0	M4-2
69	209526	209804	6453028	6243224	209537	11	0.6	1000	15.65	22.974	1.0	M4-2
71	10	10	10	0	10	0	0.6	1000	15.65	22.974	1.0	M4-2
72	177100	179392	4183278	4003886	177109	9	0.6	1000	15.65	22.974	1.0	M4-2
75	39003	39078	1065070	1025992	39003	0	0.6	1000	15.65	22.974	1.0	M4-2
76	0	0	0	0	0	0	0.6	1000	15.65	22.974	1.0	M4-2
78	1259024	1259093	3166386	1907293	1259024	0	0.6	1000	15.65	22.974	1.0	M4-2
81	10255	10259	306936	296677	10255	0	0.6	1000	15.65	22.974	1.0	M4-2
84	7599	7599	109746	102147	7599	0	0.6	1000	15.65	22.974	1.0	M4-2
87	1035	1045	17766	16721	1035	0	0.6	1000	15.65	22.974	1.0	M4-2
88	0	0	0	0	0	0	0.6	1000	15.65	22.974	1.0	M4-2
90	198	198	3321	3123	198	0	0.6	1000	15.65	22.974	1.0	M4-2
3	0	0	0	0	0	0	0.6	1000	15.897	21.627	0.5	M4-3
24	262	262	8128	7866	262	0	0.6	1000	15.897	21.627	0.5	M4-3
27	699	700	8385	7685	699	0	0.6	1000	15.897	21.627	0.5	M4-3
30	443	444	23653	23209	443	0	0.6	1000	15.897	21.627	0.5	M4-3
33	3833	3835	248865	245030	3833	0	0.6	1000	15.897	21.627	0.5	M4-3
36	17332	17437	980700	963263	17353	21	0.6	1000	15.897	21.627	0.5	M4-3
39	46640	48397	4474536	4426139	46664	24	0.6	1000	15.897	21.627	0.5	M4-3
40	0	0	0	0	0	0	0.6	1000	15.897	21.627	0.5	M4-3
41	0	0	0	0	0	0	0.6	1000	15.897	21.627	0.5	M4-3
42	204549	206665	11546415	11339750	204585	36	0.6	1000	15.897	21.627	0.5	M4-3
45	213962	218294	17787630	17569336	214121	159	0.6	1000	15.897	21.627	0.5	M4-3
46	0	0	0	0	0	0	0.6	1000	15.897	21.627	0.5	M4-3
48	174344	181346	20611410	20430064	174352	8	0.6	1000	15.897	21.627	0.5	M4-3
51	171122	172152	21206328	21034176	171163	41	0.6	1000	15.897	21.627	0.5	M4-3
52	0	0	0	0	0	0	0.6	1000	15.897	21.627	0.5	M4-3
54	242687	276217	26357430	26081213	242752	65	0.6	1000	15.897	21.627	0.5	M4-3
55	0	0	0	0	0	0	0.6	1000	15.897	21.627	0.5	M4-3
56	36	36	36	0	36	0	0.6	1000	15.897	21.627	0.5	M4-3
57	1398853	1400547	29548828	28148281	1398994	141	0.6	1000	15.897	21.627	0.5	M4-3
60	193780	196584	18370891	18174307	193810	30	0.6	1000	15.897	21.627	0.5	M4-3
62	0	0	0	0	0	0	0.6	1000	15.897	21.627	0.5	M4-3
63	234108	236297	16213665	15977368	234113	5	0.6	1000	15.897	21.627	0.5	M4-3
64	0	0	0	0	0	0	0.6	1000	15.897	21.627	0.5	M4-3
66	47181	47900	6984453	6936553	47181	0	0.6	1000	15.897	21.627	0.5	M4-3
67	0	0	0	0	0	0	0.6	1000	15.897	21.627	0.5	M4-3
69	72684	73144	5867025	5793881	72695	11	0.6	1000	15.897	21.627	0.5	M4-3
72	109409	124708	4145760	4021052	109492	83	0.6	1000	15.897	21.627	0.5	M4-3
75	98076	98608	2518890	2420282	98076	0	0.6	1000	15.897	21.627	0.5	M4-3
77	3	3	3	0	3	0	0.6	1000	15.897	21.627	0.5	M4-3
78	73167	73171	764466	691295	73167	0	0.6	1000	15.897	21.627	0.5	M4-3
81	1965	2008	103740	101732	1965	0	0.6	1000	15.897	21.627	0.5	M4-3
84	6131	6134	107880	101746	6131	0	0.6	1000	15.897	21.627	0.5	M4-3
87	2453	2453	16110	13657	2453	0	0.6	1000	15.897	21.627	0.5	M4-3
90	148378	148922	230860	81938	148378	0	0.6	1000	15.897	21.627	0.5	M4-3
6	1	1	1	0	1	0	0.6	1000	15.921	21.845	0.5	M4-10
9	1	1	1	0	1	0	0.6	1000	15.921	21.845	0.5	M4-10
24	2702	2702	19900	17198	2702	0	0.6	1000	15.921	21.845	0.5	M4-10
26	0	0	0	0	0	0	0.6	1000	15.921	21.845	0.5	M4-10
27	133	133	5886	5753	134	1	0.6	1000	15.921	21.845	0.5	M4-10
30	6895	6906	120295	113389	6895	0	0.6	1000	15.921	21.845	0.5	M4-10
33	8645	8705	421821	413116	8645	0	0.6	1000	15.921	21.845	0.5	M4-10
36	185027	185694	3096316	2910622	185073	46	0.6	1000	15.921	21.845	0.5	M4-10
38	0	0	0	0	0	0	0.6	1000	15.921	21.845	0.5	M4-10
39	102860	105276	5000703	4895427	102906	46	0.6	1000	15.921	21.845	0.5	M4-10
42	230153	288092	11710380	11422288	230227	74	0.6	1000	15.921	21.845	0.5	M4-10
45	300797	304182	20158075	19853893	300810	13	0.6	1000	15.921	21.845	0.5	M4-10
46	0	0	0	0	0	0	0.6	1000	15.921	21.845	0.5	M4-10
47	0	0	1	1	0	0	0.6	1000	15.921	21.845	0.5	M4-10
48	117155	119044	17449278	17330234	117165	10	0.6	1000	15.921	21.845	0.5	M4-10
51	154310	155250	22461753	22306503	154327	17	0.6	1000	15.921	21.845	0.5	M4-10
52	66	66	78	12	66	0	0.6	1000	15.921	21.845	0.5	M4-10
54	213214	214176	23905155	23690979	213257	43	0.6	1000	15.921	21.845	0.5	M4-10
56	0	0	0	0	0	0	0.6	1000	15.921	21.845	0.5	M4-10
57	95708	97008	16591680	16494672	95972	264	0.6	1000	15.921	21.845	0.5	M4-10
60	285968	287898	22061403	21773505	286111	143	0.6	1000	15.921	21.845	0.5	M4-10
63	216091	216374	15986685	15770311	216095	4	0.6	1000	15.921	21.845	0.5	M4-10
64	1	1	6	5	1	0	0.6	1000	15.921	21.845	0.5	M4-10
66	95392	95707	9359301	9263594	95394	2	0.6	1000	15.921	21.845	0.5	M4-10
68	0	0	0	0	0	0	0.6	1000	15.921	21.845	0.5	M4-10
69	1350435	1352601	10540936	9188335	1350435	0	0.6	1000	15.921	21.845	0.5	M4-10
70	0	0	0	0	0	0	0.6	1000	15.921	21.845	0.5	M4-10
72	24275	24755	2229216	2204461	24277	2	0.6	1000	15.921	21.845	0.5	M4-10
75	139754	140475	1910035	1769560	139778	24	0.6	1000	15.921	21.845	0.5	M4-10
76	0	0	0	0	0	0	0.6	1000	15.921	21.845	0.5	M4-10
77	0	0	0	0	0	0	0.6	1000	15.921	21.845	0.5	M4-10
78	12071	12133	649230	637097	12071	0	0.6	1000	15.921	21.845	0.5	M4-10
81	2016	2056	113050	110994	2016	0	0.6	1000	15.921	21.845	0.5	M4-10
84	6455	6774	114481	107707	6455	0	0.6	1000	15.921	21.845	0.5	M4-10
87	1597	1597	25425	23828	1597	0	0.6	1000	15.921	21.845	0.5	M4-10
90	1003	1003	2701	1698	1003	0	0.6	1000	15.921	21.845	0.5	M4-10
6	0	0	0	0	0	0	0.6	1000	16.018	21.154	0.5	M4-5
16	0	0	0	0	0	0	0.6	1000	16.018	21.154	0.5	M4-5
24	267	267	4371	4104	268	1	0.6	1000	16.018	21.154	0.5	M4-5
27	67835	67835	130816	62981	67835	0	0.6	1000	16.018	21.154	0.5	M4-5
30	3236	3266	66795	63529	3237	1	0.6	1000	16.018	21.154	0.5	M4-5
31	0	0	0	0	0	0	0.6	1000	16.018	21.154	0.5	M4-5
33	5462	5488	426426	420938	5466	4	0.6	1000	16.018	21.154	0.5	M4-5
35	0	0	0	0	0	0	0.6	1000	16.018	21.154	0.5	M4-5
36	90635	90672	1734453	1643781	90641	6	0.6	1000	16.018	21.154	0.5	M4-5
39	124999	128696	6659425	6530729	125005	6	0.6	1000	16.018	21.154	0.5	M4-5
41	0	0	1	1	0	0	0.6	1000	16.018	21.154	0.5	M4-5
42	1217642	1296587	14690910	13394323	1217767	125	0.6	1000	16.018	21.154	0.5	M4-5
43	0	0	0	0	0	0	0.6	1000	16.018	21.154	0.5	M4-5
45	127878	133059	14372841	14239782	127908	30	0.6	1000	16.018	21.154	0.5	M4-5
46	0	0	1	1	0	0	0.6	1000	16.018	21.154	0.5	M4-5
48	274078	277428	25479091	25201663	274097	19	0.6	1000	16.018	21.154	0.5	M4-5
49	0	0	0	0	0	0	0.6	1000	16.018	21.154	0.5	M4-5
50	0	0	1	1	0	0	0.6	1000	16.018	21.154	0.5	M4-5
51	211107	221173	29594971	29373798	211205	98	0.6	1000	16.018	21.154	0.5	M4-5
53	0	0	0	0	0	0	0.6	1000	16.018	21.154	0.5	M4-5
54	231207	232988	21539766	21306778	231242	35	0.6	1000	16.018	21.154	0.5	M4-5
55	0	0	0	0	0	0	0.6	1000	16.018	21.154	0.5	M4-5
56	1	1	1	0	1	0	0.6	1000	16.018	21.154	0.5	M4-5
57	116035	116789	15997996	15881207	116148	113	0.6	1000	16.018	21.154	0.5	M4-5
60	304535	312328	21677820	21365492	304551	16	0.6	1000	16.018	21.154	0.5	M4-5
63	72671	73672	12081070	12007398	72671	0	0.6	1000	16.018	21.154	0.5	M4-5
66	83982	89976	7842780	7752804	83998	16	0.6	1000	16.018	21.154	0.5	M4-5
67	0	0	0	0	0	0	0.6	1000	16.018	21.154	0.5	M4-5
69	161649	163587	6130251	5966664	161654	5	0.6	1000	16.018	21.154	0.5	M4-5
72	22638	22854	2235555	2212701	22638	0	0.6	1000	16.018	21.154	0.5	M4-5
75	338855	368727	4956526	4587799	338861	6	0.6	1000	16.018	21.154	0.5	M4-5
78	5672	5676	410871	405195	5672	0	0.6	1000	16.018	21.154	0.5	M4-5
81	4777	4812	164451	159639	4777	0	0.6	1000	16.018	21.154	0.5	M4-5
84	5900	5900	90525	84625	5918	18	0.6	1000	16.018	21.154	0.5	M4-5
87	1279	1279	20100	18821	1279	0	0.6	1000	16.018	21.154	0.5	M4-5
90	295	295	3916	3621	295	0	0.6	1000	16.018	21.154	0.5	M4-5
6	0	0	0	0	0	0	0.6	1000	16.048	21.867	0.5	M4-7
9	0	0	0	0	0	0	0.6	1000	16.048	21.867	0.5	M4-7
24	73	73	3321	3248	91	18	0.6	1000	16.048	21.867	0.5	M4-7
27	1224	1224	14365	13141	1224	0	0.6	1000	16.048	21.867	0.5	M4-7
30	73556	73576	260281	186705	73563	7	0.6	1000	16.048	21.867	0.5	M4-7
33	38435	38468	425503	387035	38441	6	0.6	1000	16.048	21.867	0.5	M4-7
36	17869	17948	1225395	1207447	17912	43	0.6	1000	16.048	21.867	0.5	M4-7
39	116303	127039	6695970	6568931	116305	2	0.6	1000	16.048	21.867	0.5	M4-7
42	31642	31874	6762003	6730129	31744	102	0.6	1000	16.048	21.867	0.5	M4-7
44	0	0	0	0	0	0	0.6	1000	16.048	21.867	0.5	M4-7
45	207628	209107	15677200	15468093	207700	72	0.6	1000	16.048	21.867	0.5	M4-7
48	1334391	1337343	31224753	29887410	1334410	19	0.6	1000	16.048	21.867	0.5	M4-7
51	276000	295282	32679570	32384288	276102	102	0.6	1000	16.048	21.867	0.5	M4-7
54	259501	261903	21245421	20983518	259505	4	0.6	1000	16.048	21.867	0.5	M4-7
56	15	15	15	0	15	0	0.6	1000	16.048	21.867	0.5	M4-7
57	97565	98365	19917516	19819151	97982	417	0.6	1000	16.048	21.867	0.5	M4-7
59	10	10	10	0	10	0	0.6	1000	16.048	21.867	0.5	M4-7
60	159836	161179	18638565	18477386	159963	127	0.6	1000	16.048	21.867	0.5	M4-7
63	45719	46621	8952796	8906175	45747	28	0.6	1000	16.048	21.867	0.5	M4-7
66	202131	222015	12012351	11790336	202290	159	0.6	1000	16.048	21.867	0.5	M4-7
69	108144	120943	5089645	4968702	108144	0	0.6	1000	16.048	21.867	0.5	M4-7
72	174704	175964	3073960	2897996	174706	2	0.6	1000	16.048	21.867	0.5	M4-7
74	21	21	21	0	21	0	0.6	1000	16.048	21.867	0.5	M4-7
75	15289	15480	1097421	1081941	15289	0	0.6	1000	16.048	21.867	0.5	M4-7
76	1	1	1	0	1	0	0.6	1000	16.048	21.867	0.5	M4-7
78	166902	166912	1269621	1102709	166919	17	0.6	1000	16.048	21.867	0.5	M4-7
81	55999	56000	546535	490535	55999	0	0.6	1000	16.048	21.867	0.5	M4-7
84	107561	107563	424581	317018	107561	0	0.6	1000	16.048	21.867	0.5	M4-7
87	6585	6671	54946	48275	6585	0	0.6	1000	16.048	21.867	0.5	M4-7
90	814	814	14028	13214	814	0	0.6	1000	16.048	21.867	0.5	M4-7
3	0	0	0	0	0	0	0.6	1000	16.1	22.967	1.0	M4-9
24	343	355	8646	8291	343	0	0.6	1000	16.1	22.967	1.0	M4-9
27	9263	9263	49770	40507	9265	2	0.6	1000	16.1	22.967	1.0	M4-9
30	18430	18430	109278	90848	18435	5	0.6	1000	16.1	22.967	1.0	M4-9
33	9325	9472	441330	431858	9327	2	0.6	1000	16.1	22.967	1.0	M4-9
35	21	21	21	0	21	0	0.6	1000	16.1	22.967	1.0	M4-9
36	270094	281690	5416986	5135296	270106	12	0.6	1000	16.1	22.967	1.0	M4-9
39	83864	84531	3873936	3789405	83864	0	0.6	1000	16.1	22.967	1.0	M4-9
41	0	0	0	0	0	0	0.6	1000	16.1	22.967	1.0	M4-9
42	79035	80311	7622560	7542249	79192	157	0.6	1000	16.1	22.967	1.0	M4-9
45	123216	123831	16287778	16163947	123259	43	0.6	1000	16.1	22.967	1.0	M4-9
46	0	0	1	1	0	0	0.6	1000	16.1	22.967	1.0	M4-9
47	0	0	0	0	0	0	0.6	1000	16.1	22.967	1.0	M4-9
48	103211	104033	20979003	20874970	103231	20	0.6	1000	16.1	22.967	1.0	M4-9
51	217707	220997	23471526	23250529	217732	25	0.6	1000	16.1	22.967	1.0	M4-9
54	415822	417226	34283340	33866114	416042	220	0.6	1000	16.1	22.967	1.0	M4-9
55	0	0	1	1	0	0	0.6	1000	16.1	22.967	1.0	M4-9
57	35503	39052	12323130	12284078	36064	561	0.6	1000	16.1	22.967	1.0	M4-9
58	0	0	0	0	0	0	0.6	1000	16.1	22.967	1.0	M4-9
59	0	0	0	0	0	0	0.6	1000	16.1	22.967	1.0	M4-9
60	1335578	1436109	31327570	29891461	1335591	13	0.6	1000	16.1	22.967	1.0	M4-9
61	0	0	0	0	0	0	0.6	1000	16.1	22.967	1.0	M4-9
63	123155	123350	12357906	12234556	123164	9	0.6	1000	16.1	22.967	1.0	M4-9
66	222312	223273	9642636	9419363	222312	0	0.6	1000	16.1	22.967	1.0	M4-9
69	49971	50344	5410405	5360061	49971	0	0.6	1000	16.1	22.967	1.0	M4-9
72	82997	112731	2951235	2838504	82997	0	0.6	1000	16.1	22.967	1.0	M4-9
75	7296	7356	625521	618165	7296	0	0.6	1000	16.1	22.967	1.0	M4-9
78	58145	65284	1084128	1018844	58145	0	0.6	1000	16.1	22.967	1.0	M4-9
81	104907	104907	518671	413764	104907	0	0.6	1000	16.1	22.967	1.0	M4-9
84	76457	76760	299151	222391	76457	0	0.6	1000	16.1	22.967	1.0	M4-9
87	8887	8887	39621	30734	8888	1	0.6	1000	16.1	22.967	1.0	M4-9
90	956	956	7626	6670	956	0	0.6	1000	16.1	22.967	1.0	M4-9
3	0	0	0	0	0	0	0.6	1000	16.213	22.748	0.1	M4-6
24	241	241	6216	5975	241	0	0.6	1000	16.213	22.748	0.1	M4-6
27	9599	9599	36046	26447	9599	0	0.6	1000	16.213	22.748	0.1	M4-6
30	33061	33088	166176	133088	33061	0	0.6	1000	16.213	22.748	0.1	M4-6
33	6547	6584	313236	306652	6548	1	0.6	1000	16.213	22.748	0.1	M4-6
36	14069	14077	970921	956844	14071	2	0.6	1000	16.213	22.748	0.1	M4-6
39	28480	29710	3901821	3872111	28480	0	0.6	1000	16.213	22.748	0.1	M4-6
42	47000	47811	7168791	7120980	47068	68	0.6	1000	16.213	22.748	0.1	M4-6
45	80908	82090	11807370	11725280	80963	55	0.6	1000	16.213	22.748	0.1	M4-6
48	148333	181652	19471920	19290268	148377	44	0.6	1000	16.213	22.748	0.1	M4-6
50	0	0	0	0	0	0	0.6	1000	16.213	22.748	0.1	M4-6
51	293660	295443	25715206	25419763	293670	10	0.6	1000	16.213	22.748	0.1	M4-6
52	0	0	0	0	0	0	0.6	1000	16.213	22.748	0.1	M4-6
54	376889	378068	29142795	28764727	376948	59	0.6	1000	16.213	22.748	0.1	M4-6
55	0	0	0	0	0	0	0.6	1000	16.213	22.748	0.1	M4-6
56	0	0	0	0	0	0	0.6	1000	16.213	22.748	0.1	M4-6
57	309527	316820	26284875	25968055	309773	246	0.6	1000	16.213	22.748	0.1	M4-6
59	0	0	0	0	0	0	0.6	1000	16.213	22.748	0.1	M4-6
60	186236	198153	18304275	18106122	186238	2	0.6	1000	16.213	22.748	0.1	M4-6
61	0	0	0	0	0	0	0.6	1000	16.213	22.748	0.1	M4-6
62	0	0	1	1	0	0	0.6	1000	16.213	22.748	0.1	M4-6
63	112304	113334	10646805	10533471	112316	12	0.6	1000	16.213	22.748	0.1	M4-6
64	89	163	276	113	89	0	0.6	1000	16.213	22.748	0.1	M4-6
66	108235	109852	10453878	10344026	108235	0	0.6	1000	16.213	22.748	0.1	M4-6
69	112727	114464	6906186	6791722	112739	12	0.6	1000	16.213	22.748	0.1	M4-6
72	143848	144781	5476395	5331614	143869	21	0.6	1000	16.213	22.748	0.1	M4-6
73	3	3	3	0	3	0	0.6	1000	16.213	22.748	0.1	M4-6
75	141598	142280	2816751	2674471	141599	1	0.6	1000	16.213	22.748	0.1	M4-6
78	110657	112413	1365378	1252965	110657	0	0.6	1000	16.213	22.748	0.1	M4-6
81	1129	1132	74691	73559	1130	1	0.6	1000	16.213	22.748	0.1	M4-6
82	0	0	0	0	0	0	0.6	1000	16.213	22.748	0.1	M4-6
84	1242472	1242636	2089990	847354	1242472	0	0.6	1000	16.213	22.748	0.1	M4-6
87	172	175	11935	11760	172	0	0.6	1000	16.213	22.748	0.1	M4-6
90	269	270	7260	6990	269	0	0.6	1000	16.213	22.748	0.1	M4-6
3	0	0	0	0	0	0	0.6	1000	16.241	25.853	0.3	M4-9
24	343	355	8646	8291	343	0	0.6	1000	16.241	25.853	0.3	M4-9
27	9263	9263	49770	40507	9265	2	0.6	1000	16.241	25.853	0.3	M4-9
30	18430	18430	109278	90848	18435	5	0.6	1000	16.241	25.853	0.3	M4-9
33	9325	9472	441330	431858	9327	2	0.6	1000	16.241	25.853	0.3	M4-9
35	21	21	21	0	21	0	0.6	1000	16.241	25.853	0.3	M4-9
36	270094	281690	5416986	5135296	270106	12	0.6	1000	16.241	25.853	0.3	M4-9
39	84258	84531	3873936	3789405	84262	4	0.6	1000	16.241	25.853	0.3	M4-9
41	0	0	0	0	0	0	0.6	1000	16.241	25.853	0.3	M4-9
42	79558	80311	7622560	7542249	79720	162	0.6	1000	16.241	25.853	0.3	M4-9
45	123040	123831	16287778	16163947	123184	144	0.6	1000	16.241	25.853	0.3	M4-9
46	0	0	1	1	0	0	0.6	1000	16.241	25.853	0.3	M4-9
47	0	0	0	0	0	0	0.6	1000	16.241	25.853	0.3	M4-9
48	102696	104033	20979003	20874970	102721	25	0.6	1000	16.241	25.853	0.3	M4-9
51	217710	220997	23471526	23250529	217735	25	0.6	1000	16.241	25.853	0.3	M4-9
54	414046	417226	34283340	33866114	414273	227	0.6	1000	16.241	25.853	0.3	M4-9
55	0	0	1	1	0	0	0.6	1000	16.241	25.853	0.3	M4-9
57	35392	39052	12323130	12284078	35951	559	0.6	1000	16.241	25.853	0.3	M4-9
58	0	0	0	0	0	0	0.6	1000	16.241	25.853	0.3	M4-9
59	0	0	0	0	0	0	0.6	1000	16.241	25.853	0.3	M4-9
60	1385343	1436109	31327570	29891461	1385356	13	0.6	1000	16.241	25.853	0.3	M4-9
61	0	0	0	0	0	0	0.6	1000	16.241	25.853	0.3	M4-9
63	122986	123350	12357906	12234556	122995	9	0.6	1000	16.241	25.853	0.3	M4-9
66	222279	223273	9642636	9419363	222279	0	0.6	1000	16.241	25.853	0.3	M4-9
69	49882	50344	5410405	5360061	49882	0	0.6	1000	16.241	25.853	0.3	M4-9
72	82660	112731	2951235	2838504	82660	0	0.6	1000	16.241	25.853	0.3	M4-9
75	7296	7356	625521	618165	7296	0	0.6	1000	16.241	25.853	0.3	M4-9
78	58145	65284	1084128	1018844	58145	0	0.6	1000	16.241	25.853	0.3	M4-9
81	104907	104907	518671	413764	104907	0	0.6	1000	16.241	25.853	0.3	M4-9
84	76457	76760	299151	222391	76457	0	0.6	1000	16.241	25.853	0.3	M4-9
87	8887	8887	39621	30734	8888	1	0.6	1000	16.241	25.853	0.3	M4-9
90	956	956	7626	6670	956	0	0.6	1000	16.241	25.853	0.3	M4-9
3	0	0	0	0	0	0	0.6	1000	16.399	21.856	0.5	M4-6
24	241	241	6216	5975	241	0	0.6	1000	16.399	21.856	0.5	M4-6
27	9599	9599	36046	26447	9599	0	0.6	1000	16.399	21.856	0.5	M4-6
30	33061	33088	166176	133088	33061	0	0.6	1000	16.399	21.856	0.5	M4-6
33	6547	6584	313236	306652	6548	1	0.6	1000	16.399	21.856	0.5	M4-6
36	14069	14077	970921	956844	14071	2	0.6	1000	16.399	21.856	0.5	M4-6
39	28433	29710	3901821	3872111	28433	0	0.6	1000	16.399	21.856	0.5	M4-6
42	47507	47811	7168791	7120980	47581	74	0.6	1000	16.399	21.856	0.5	M4-6
45	81006	82090	11807370	11725280	81148	142	0.6	1000	16.399	21.856	0.5	M4-6
48	149201	181652	19471920	19290268	149263	62	0.6	1000	16.399	21.856	0.5	M4-6
50	0	0	0	0	0	0	0.6	1000	16.399	21.856	0.5	M4-6
51	293219	295443	25715206	25419763	293231	12	0.6	1000	16.399	21.856	0.5	M4-6
52	0	0	0	0	0	0	0.6	1000	16.399	21.856	0.5	M4-6
54	377398	378068	29142795	28764727	377466	68	0.6	1000	16.399	21.856	0.5	M4-6
55	0	0	0	0	0	0	0.6	1000	16.399	21.856	0.5	M4-6
56	0	0	0	0	0	0	0.6	1000	16.399	21.856	0.5	M4-6
57	300463	316820	26284875	25968055	300689	226	0.6	1000	16.399	21.856	0.5	M4-6
59	0	0	0	0	0	0	0.6	1000	16.399	21.856	0.5	M4-6
60	186532	198153	18304275	18106122	186550	18	0.6	1000	16.399	21.856	0.5	M4-6
61	0	0	0	0	0	0	0.6	1000	16.399	21.856	0.5	M4-6
62	0	0	1	1	0	0	0.6	1000	16.399	21.856	0.5	M4-6
63	112827	113334	10646805	10533471	112839	12	0.6	1000	16.399	21.856	0.5	M4-6
64	89	163	276	113	89	0	0.6	1000	16.399	21.856	0.5	M4-6
66	108816	109852	10453878	10344026	108817	1	0.6	1000	16.399	21.856	0.5	M4-6
69	113130	114464	6906186	6791722	113142	12	0.6	1000	16.399	21.856	0.5	M4-6
72	144096	144781	5476395	5331614	144118	22	0.6	1000	16.399	21.856	0.5	M4-6
73	3	3	3	0	3	0	0.6	1000	16.399	21.856	0.5	M4-6
75	141987	142280	2816751	2674471	141992	5	0.6	1000	16.399	21.856	0.5	M4-6
78	110657	112413	1365378	1252965	110657	0	0.6	1000	16.399	21.856	0.5	M4-6
81	1129	1132	74691	73559	1130	1	0.6	1000	16.399	21.856	0.5	M4-6
82	0	0	0	0	0	0	0.6	1000	16.399	21.856	0.5	M4-6
84	1242472	1242636	2089990	847354	1242472	0	0.6	1000	16.399	21.856	0.5	M4-6
87	172	175	11935	11760	172	0	0.6	1000	16.399	21.856	0.5	M4-6
90	269	270	7260	6990	269	0	0.6	1000	16.399	21.856	0.5	M4-6
3	0	0	0	0	0	0	0.6	1000	16.509	21.461	1.0	M4-1
6	0	0	0	0	0	0	0.6	1000	16.509	21.461	1.0	M4-1
24	73	75	3570	3495	73	0	0.6	1000	16.509	21.461	1.0	M4-1
27	6507	6507	43071	36564	6513	6	0.6	1000	16.509	21.461	1.0	M4-1
30	709	716	40755	40039	714	5	0.6	1000	16.509	21.461	1.0	M4-1
33	33957	33984	424581	390597	33957	0	0.6	1000	16.509	21.461	1.0	M4-1
36	4978	4979	458403	453424	4984	6	0.6	1000	16.509	21.461	1.0	M4-1
39	218354	234607	6813586	6578979	218373	19	0.6	1000	16.509	21.461	1.0	M4-1
41	0	0	0	0	0	0	0.6	1000	16.509	21.461	1.0	M4-1
42	70590	74965	8559453	8484488	71727	1137	0.6	1000	16.509	21.461	1.0	M4-1
45	266514	274902	18638565	18363663	266535	21	0.6	1000	16.509	21.461	1.0	M4-1
47	0	0	0	0	0	0	0.6	1000	16.509	21.461	1.0	M4-1
48	210917	212334	24981846	24769512	211324	407	0.6	1000	16.509	21.461	1.0	M4-1
49	0	0	0	0	0	0	0.6	1000	16.509	21.461	1.0	M4-1
50	10	10	15	5	10	0	0.6	1000	16.509	21.461	1.0	M4-1
51	268213	270020	34283340	34013320	268345	132	0.6	1000	16.509	21.461	1.0	M4-1
52	0	0	0	0	0	0	0.6	1000	16.509	21.461	1.0	M4-1
53	0	0	1	1	0	0	0.6	1000	16.509	21.461	1.0	M4-1
54	249358	257003	26335653	26078650	249378	20	0.6	1000	16.509	21.461	1.0	M4-1
56	55	55	55	0	55	0	0.6	1000	16.509	21.461	1.0	M4-1
57	91948	92998	17307786	17214788	91964	16	0.6	1000	16.509	21.461	1.0	M4-1
58	0	0	0	0	0	0	0.6	1000	16.509	21.461	1.0	M4-1
60	172821	174264	15354111	15179847	172822	1	0.6	1000	16.509	21.461	1.0	M4-1
63	89249	90130	11987856	11897726	89298	49	0.6	1000	16.509	21.461	1.0	M4-1
65	0	0	0	0	0	0	0.6	1000	16.509	21.461	1.0	M4-1
66	188994	189660	8704878	8515218	188994	0	0.6	1000	16.509	21.461	1.0	M4-1
67	0	0	0	0	0	0	0.6	1000	16.509	21.461	1.0	M4-1
69	148640	148774	7634278	7485504	148646	6	0.6	1000	16.509	21.461	1.0	M4-1
72	1444297	1449473	11493615	10044142	1444302	5	0.6	1000	16.509	21.461	1.0	M4-1
73	1	1	1	0	1	0	0.6	1000	16.509	21.461	1.0	M4-1
75	18218	18309	962578	944269	18218	0	0.6	1000	16.509	21.461	1.0	M4-1
78	12180	12247	451725	439478	12180	0	0.6	1000	16.509	21.461	1.0	M4-1
81	1988	2002	126756	124754	1988	0	0.6	1000	16.509	21.461	1.0	M4-1
84	5572	5573	52650	47077	5572	0	0.6	1000	16.509	21.461	1.0	M4-1
87	620	621	12403	11782	620	0	0.6	1000	16.509	21.461	1.0	M4-1
90	218	233	4753	4520	218	0	0.6	1000	16.509	21.461	1.0	M4-1
3	0	0	0	0	0	0	0.6	1000	16.624	20.829	1.0	M4-3
24	262	262	8128	7866	262	0	0.6	1000	16.624	20.829	1.0	M4-3
27	699	700	8385	7685	699	0	0.6	1000	16.624	20.829	1.0	M4-3
30	443	444	23653	23209	443	0	0.6	1000	16.624	20.829	1.0	M4-3
33	3833	3835	248865	245030	3833	0	0.6	1000	16.624	20.829	1.0	M4-3
36	17332	17437	980700	963263	17353	21	0.6	1000	16.624	20.829	1.0	M4-3
39	46740	48397	4474536	4426139	46742	2	0.6	1000	16.624	20.829	1.0	M4-3
40	0	0	0	0	0	0	0.6	1000	16.624	20.829	1.0	M4-3
41	0	0	0	0	0	0	0.6	1000	16.624	20.829	1.0	M4-3
42	204450	206665	11546415	11339750	204486	36	0.6	1000	16.624	20.829	1.0	M4-3
45	214896	218294	17787630	17569336	215075	179	0.6	1000	16.624	20.829	1.0	M4-3
46	0	0	0	0	0	0	0.6	1000	16.624	20.829	1.0	M4-3
48	175067	181346	20611410	20430064	175078	11	0.6	1000	16.624	20.829	1.0	M4-3
51	171342	172152	21206328	21034176	171380	38	0.6	1000	16.624	20.829	1.0	M4-3
52	0	0	0	0	0	0	0.6	1000	16.624	20.829	1.0	M4-3
54	242231	276217	26357430	26081213	242296	65	0.6	1000	16.624	20.829	1.0	M4-3
55	0	0	0	0	0	0	0.6	1000	16.624	20.829	1.0	M4-3
56	36	36	36	0	36	0	0.6	1000	16.624	20.829	1.0	M4-3
57	1399135	1400547	29548828	28148281	1399325	190	0.6	1000	16.624	20.829	1.0	M4-3
60	193859	196584	18370891	18174307	193902	43	0.6	1000	16.624	20.829	1.0	M4-3
62	0	0	0	0	0	0	0.6	1000	16.624	20.829	1.0	M4-3
63	234117	236297	16213665	15977368	234122	5	0.6	1000	16.624	20.829	1.0	M4-3
64	0	0	0	0	0	0	0.6	1000	16.624	20.829	1.0	M4-3
66	47246	47900	6984453	6936553	47246	0	0.6	1000	16.624	20.829	1.0	M4-3
67	0	0	0	0	0	0	0.6	1000	16.624	20.829	1.0	M4-3
69	72826	73144	5867025	5793881	72838	12	0.6	1000	16.624	20.829	1.0	M4-3
72	122657	124708	4145760	4021052	122749	92	0.6	1000	16.624	20.829	1.0	M4-3
75	98104	98608	2518890	2420282	98104	0	0.6	1000	16.624	20.829	1.0	M4-3
77	3	3	3	0	3	0	0.6	1000	16.624	20.829	1.0	M4-3
78	73167	73171	764466	691295	73167	0	0.6	1000	16.624	20.829	1.0	M4-3
81	1965	2008	103740	101732	1965	0	0.6	1000	16.624	20.829	1.0	M4-3
84	6131	6134	107880	101746	6131	0	0.6	1000	16.624	20.829	1.0	M4-3
87	2453	2453	16110	13657	2453	0	0.6	1000	16.624	20.829	1.0	M4-3
90	148378	148922	230860	81938	148378	0	0.6	1000	16.624	20.829	1.0	M4-3
6	0	0	0	0	0	0	0.6	1000	16.645	21.92	1.0	M4-7
9	0	0	0	0	0	0	0.6	1000	16.645	21.92	1.0	M4-7
24	73	73	3321	3248	91	18	0.6	1000	16.645	21.92	1.0	M4-7
27	1224	1224	14365	13141	1224	0	0.6	1000	16.645	21.92	1.0	M4-7
30	73556	73576	260281	186705	73563	7	0.6	1000	16.645	21.92	1.0	M4-7
33	38435	38468	425503	387035	38441	6	0.6	1000	16.645	21.92	1.0	M4-7
36	17869	17948	1225395	1207447	17912	43	0.6	1000	16.645	21.92	1.0	M4-7
39	117139	127039	6695970	6568931	117141	2	0.6	1000	16.645	21.92	1.0	M4-7
42	31786	31874	6762003	6730129	31921	135	0.6	1000	16.645	21.92	1.0	M4-7
44	0	0	0	0	0	0	0.6	1000	16.645	21.92	1.0	M4-7
45	208448	209107	15677200	15468093	208513	65	0.6	1000	16.645	21.92	1.0	M4-7
48	1335995	1337343	31224753	29887410	1336016	21	0.6	1000	16.645	21.92	1.0	M4-7
51	275223	295282	32679570	32384288	275306	83	0.6	1000	16.645	21.92	1.0	M4-7
54	261360	261903	21245421	20983518	261364	4	0.6	1000	16.645	21.92	1.0	M4-7
56	15	15	15	0	15	0	0.6	1000	16.645	21.92	1.0	M4-7
57	97804	98365	19917516	19819151	98221	417	0.6	1000	16.645	21.92	1.0	M4-7
59	10	10	10	0	10	0	0.6	1000	16.645	21.92	1.0	M4-7
60	159765	161179	18638565	18477386	159909	144	0.6	1000	16.645	21.92	1.0	M4-7
63	46461	46621	8952796	8906175	46489	28	0.6	1000	16.645	21.92	1.0	M4-7
66	202537	222015	12012351	11790336	202696	159	0.6	1000	16.645	21.92	1.0	M4-7
69	108062	120943	5089645	4968702	108062	0	0.6	1000	16.645	21.92	1.0	M4-7
72	174745	175964	3073960	2897996	174747	2	0.6	1000	16.645	21.92	1.0	M4-7
74	21	21	21	0	21	0	0.6	1000	16.645	21.92	1.0	M4-7
75	15289	15480	1097421	1081941	15289	0	0.6	1000	16.645	21.92	1.0	M4-7
76	1	1	1	0	1	0	0.6	1000	16.645	21.92	1.0	M4-7
78	166902	166912	1269621	1102709	166919	17	0.6	1000	16.645	21.92	1.0	M4-7
81	55999	56000	546535	490535	55999	0	0.6	1000	16.645	21.92	1.0	M4-7
84	107561	107563	424581	317018	107561	0	0.6	1000	16.645	21.92	1.0	M4-7
87	6585	6671	54946	48275	6585	0	0.6	1000	16.645	21.92	1.0	M4-7
90	814	814	14028	13214	814	0	0.6	1000	16.645	21.92	1.0	M4-7
6	0	0	0	0	0	0	0.6	1000	16.778	21.418	1.0	M4-5
16	0	0	0	0	0	0	0.6	1000	16.778	21.418	1.0	M4-5
24	267	267	4371	4104	268	1	0.6	1000	16.778	21.418	1.0	M4-5
27	67835	67835	130816	62981	67835	0	0.6	1000	16.778	21.418	1.0	M4-5
30	3236	3266	66795	63529	3237	1	0.6	1000	16.778	21.418	1.0	M4-5
31	0	0	0	0	0	0	0.6	1000	16.778	21.418	1.0	M4-5
33	5462	5488	426426	420938	5466	4	0.6	1000	16.778	21.418	1.0	M4-5
35	0	0	0	0	0	0	0.6	1000	16.778	21.418	1.0	M4-5
36	90635	90672	1734453	1643781	90641	6	0.6	1000	16.778	21.418	1.0	M4-5
39	127674	128696	6659425	6530729	127680	6	0.6	1000	16.778	21.418	1.0	M4-5
41	0	0	1	1	0	0	0.6	1000	16.778	21.418	1.0	M4-5
42	1148893	1296587	14690910	13394323	1149584	691	0.6	1000	16.778	21.418	1.0	M4-5
43	0	0	0	0	0	0	0.6	1000	16.778	21.418	1.0	M4-5
45	128035	133059	14372841	14239782	128055	20	0.6	1000	16.778	21.418	1.0	M4-5
46	0	0	1	1	0	0	0.6	1000	16.778	21.418	1.0	M4-5
48	274203	277428	25479091	25201663	274225	22	0.6	1000	16.778	21.418	1.0	M4-5
49	0	0	0	0	0	0	0.6	1000	16.778	21.418	1.0	M4-5
50	0	0	1	1	0	0	0.6	1000	16.778	21.418	1.0	M4-5
51	211166	221173	29594971	29373798	211249	83	0.6	1000	16.778	21.418	1.0	M4-5
53	0	0	0	0	0	0	0.6	1000	16.778	21.418	1.0	M4-5
54	189310	232988	21539766	21306778	189347	37	0.6	1000	16.778	21.418	1.0	M4-5
55	0	0	0	0	0	0	0.6	1000	16.778	21.418	1.0	M4-5
56	1	1	1	0	1	0	0.6	1000	16.778	21.418	1.0	M4-5
57	115644	116789	15997996	15881207	115769	125	0.6	1000	16.778	21.418	1.0	M4-5
60	304869	312328	21677820	21365492	304891	22	0.6	1000	16.778	21.418	1.0	M4-5
63	72234	73672	12081070	12007398	72234	0	0.6	1000	16.778	21.418	1.0	M4-5
66	84989	89976	7842780	7752804	85005	16	0.6	1000	16.778	21.418	1.0	M4-5
67	0	0	0	0	0	0	0.6	1000	16.778	21.418	1.0	M4-5
69	161696	163587	6130251	5966664	161701	5	0.6	1000	16.778	21.418	1.0	M4-5
72	22720	22854	2235555	2212701	22720	0	0.6	1000	16.778	21.418	1.0	M4-5
75	336138	368727	4956526	4587799	336144	6	0.6	1000	16.778	21.418	1.0	M4-5
78	5672	5676	410871	405195	5672	0	0.6	1000	16.778	21.418	1.0	M4-5
81	4777	4812	164451	159639	4777	0	0.6	1000	16.778	21.418	1.0	M4-5
84	5900	5900	90525	84625	5918	18	0.6	1000	16.778	21.418	1.0	M4-5
87	1279	1279	20100	18821	1279	0	0.6	1000	16.778	21.418	1.0	M4-5
90	295	295	3916	3621	295	0	0.6	1000	16.778	21.418	1.0	M4-5
9	0	0	0	0	0	0	0.6	1000	16.893	21.591	1.0	M4-8
24	346	347	6555	6208	365	19	0.6	1000	16.893	21.591	1.0	M4-8
27	569	569	14535	13966	569	0	0.6	1000	16.893	21.591	1.0	M4-8
29	0	0	0	0	0	0	0.6	1000	16.893	21.591	1.0	M4-8
30	74901	74901	230860	155959	74901	0	0.6	1000	16.893	21.591	1.0	M4-8
33	3113	3198	222778	219580	3168	55	0.6	1000	16.893	21.591	1.0	M4-8
36	96886	97366	2333880	2236514	96890	4	0.6	1000	16.893	21.591	1.0	M4-8
38	0	0	0	0	0	0	0.6	1000	16.893	21.591	1.0	M4-8
39	36603	37115	4157286	4120171	36710	107	0.6	1000	16.893	21.591	1.0	M4-8
42	171868	172280	8460441	8288161	171887	19	0.6	1000	16.893	21.591	1.0	M4-8
45	302778	305407	21704166	21398759	302846	68	0.6	1000	16.893	21.591	1.0	M4-8
48	378671	402907	35418736	35015829	379111	440	0.6	1000	16.893	21.591	1.0	M4-8
49	0	0	0	0	0	0	0.6	1000	16.893	21.591	1.0	M4-8
50	0	0	1	1	0	0	0.6	1000	16.893	21.591	1.0	M4-8
51	84140	84579	18994366	18909787	84251	111	0.6	1000	16.893	21.591	1.0	M4-8
52	78	78	120	42	78	0	0.6	1000	16.893	21.591	1.0	M4-8
54	1470409	1471430	38759610	37288180	1470427	18	0.6	1000	16.893	21.591	1.0	M4-8
55	1	1	3	2	1	0	0.6	1000	16.893	21.591	1.0	M4-8
56	12720	12880	13203	323	12720	0	0.6	1000	16.893	21.591	1.0	M4-8
57	332474	334108	29518086	29183978	339610	7136	0.6	1000	16.893	21.591	1.0	M4-8
58	276	276	276	0	276	0	0.6	1000	16.893	21.591	1.0	M4-8
59	0	0	0	0	0	0	0.6	1000	16.893	21.591	1.0	M4-8
60	56544	56888	11841411	11784523	56582	38	0.6	1000	16.893	21.591	1.0	M4-8
63	74300	75315	10001628	9926313	74306	6	0.6	1000	16.893	21.591	1.0	M4-8
66	47120	50377	7108335	7057958	47120	0	0.6	1000	16.893	21.591	1.0	M4-8
67	0	0	0	0	0	0	0.6	1000	16.893	21.591	1.0	M4-8
69	117273	117895	3643650	3525755	117279	6	0.6	1000	16.893	21.591	1.0	M4-8
70	0	0	0	0	0	0	0.6	1000	16.893	21.591	1.0	M4-8
72	176444	184108	5286126	5102018	176462	18	0.6	1000	16.893	21.591	1.0	M4-8
75	35509	35512	1110795	1075283	35509	0	0.6	1000	16.893	21.591	1.0	M4-8
78	4414	4441	296835	292394	4415	1	0.6	1000	16.893	21.591	1.0	M4-8
81	63885	63908	385881	321973	63885	0	0.6	1000	16.893	21.591	1.0	M4-8
84	14535	28419	126756	98337	14535	0	0.6	1000	16.893	21.591	1.0	M4-8
87	225	227	6670	6443	225	0	0.6	1000	16.893	21.591	1.0	M4-8
88	0	0	0	0	0	0	0.6	1000	16.893	21.591	1.0	M4-8
90	123	123	2556	2433	123	0	0.6	1000	16.893	21.591	1.0	M4-8
3	0	0	0	0	0	0	0.6	1000	17.084	21.594	1.0	M4-6
24	241	241	6216	5975	241	0	0.6	1000	17.084	21.594	1.0	M4-6
27	9599	9599	36046	26447	9599	0	0.6	1000	17.084	21.594	1.0	M4-6
30	33061	33088	166176	133088	33061	0	0.6	1000	17.084	21.594	1.0	M4-6
33	6547	6584	313236	306652	6548	1	0.6	1000	17.084	21.594	1.0	M4-6
36	14069	14077	970921	956844	14071	2	0.6	1000	17.084	21.594	1.0	M4-6
39	28581	29710	3901821	3872111	28581	0	0.6	1000	17.084	21.594	1.0	M4-6
42	47270	47811	7168791	7120980	47326	56	0.6	1000	17.084	21.594	1.0	M4-6
45	81142	82090	11807370	11725280	81181	39	0.6	1000	17.084	21.594	1.0	M4-6
48	149285	181652	19471920	19290268	149352	67	0.6	1000	17.084	21.594	1.0	M4-6
50	0	0	0	0	0	0	0.6	1000	17.084	21.594	1.0	M4-6
51	294042	295443	25715206	25419763	294052	10	0.6	1000	17.084	21.594	1.0	M4-6
52	0	0	0	0	0	0	0.6	1000	17.084	21.594	1.0	M4-6
54	377599	378068	29142795	28764727	377655	56	0.6	1000	17.084	21.594	1.0	M4-6
55	0	0	0	0	0	0	0.6	1000	17.084	21.594	1.0	M4-6
56	0	0	0	0	0	0	0.6	1000	17.084	21.594	1.0	M4-6
57	307314	316820	26284875	25968055	307493	179	0.6	1000	17.084	21.594	1.0	M4-6
59	0	0	0	0	0	0	0.6	1000	17.084	21.594	1.0	M4-6
60	185934	198153	18304275	18106122	185953	19	0.6	1000	17.084	21.594	1.0	M4-6
61	0	0	0	0	0	0	0.6	1000	17.084	21.594	1.0	M4-6
62	0	0	1	1	0	0	0.6	1000	17.084	21.594	1.0	M4-6
63	112903	113334	10646805	10533471	112915	12	0.6	1000	17.084	21.594	1.0	M4-6
64	89	163	276	113	89	0	0.6	1000	17.084	21.594	1.0	M4-6
66	108872	109852	10453878	10344026	108873	1	0.6	1000	17.084	21.594	1.0	M4-6
69	112930	114464	6906186	6791722	112942	12	0.6	1000	17.084	21.594	1.0	M4-6
72	143775	144781	5476395	5331614	143797	22	0.6	1000	17.084	21.594	1.0	M4-6
73	3	3	3	0	3	0	0.6	1000	17.084	21.594	1.0	M4-6
75	141678	142280	2816751	2674471	141682	4	0.6	1000	17.084	21.594	1.0	M4-6
78	110657	112413	1365378	1252965	110657	0	0.6	1000	17.084	21.594	1.0	M4-6
81	1129	1132	74691	73559	1130	1	0.6	1000	17.084	21.594	1.0	M4-6
82	0	0	0	0	0	0	0.6	1000	17.084	21.594	1.0	M4-6
84	1242472	1242636	2089990	847354	1242472	0	0.6	1000	17.084	21.594	1.0	M4-6
87	172	175	11935	11760	172	0	0.6	1000	17.084	21.594	1.0	M4-6
90	269	270	7260	6990	269	0	0.6	1000	17.084	21.594	1.0	M4-6
6	1	1	1	0	1	0	0.6	1000	17.37	24.226	0.3	M4-10
9	1	1	1	0	1	0	0.6	1000	17.37	24.226	0.3	M4-10
24	2702	2702	19900	17198	2702	0	0.6	1000	17.37	24.226	0.3	M4-10
26	0	0	0	0	0	0	0.6	1000	17.37	24.226	0.3	M4-10
27	133	133	5886	5753	134	1	0.6	1000	17.37	24.226	0.3	M4-10
30	6895	6906	120295	113389	6895	0	0.6	1000	17.37	24.226	0.3	M4-10
33	8645	8705	421821	413116	8645	0	0.6	1000	17.37	24.226	0.3	M4-10
36	185027	185694	3096316	2910622	185073	46	0.6	1000	17.37	24.226	0.3	M4-10
38	0	0	0	0	0	0	0.6	1000	17.37	24.226	0.3	M4-10
39	104054	105276	5000703	4895427	104092	38	0.6	1000	17.37	24.226	0.3	M4-10
42	229935	288092	11710380	11422288	230013	78	0.6	1000	17.37	24.226	0.3	M4-10
45	302177	304182	20158075	19853893	302191	14	0.6	1000	17.37	24.226	0.3	M4-10
46	0	0	0	0	0	0	0.6	1000	17.37	24.226	0.3	M4-10
47	0	0	1	1	0	0	0.6	1000	17.37	24.226	0.3	M4-10
48	112631	119044	17449278	17330234	112641	10	0.6	1000	17.37	24.226	0.3	M4-10
51	154090	155250	22461753	22306503	154103	13	0.6	1000	17.37	24.226	0.3	M4-10
52	66	66	78	12	66	0	0.6	1000	17.37	24.226	0.3	M4-10
54	213141	214176	23905155	23690979	213183	42	0.6	1000	17.37	24.226	0.3	M4-10
56	0	0	0	0	0	0	0.6	1000	17.37	24.226	0.3	M4-10
57	95535	97008	16591680	16494672	95797	262	0.6	1000	17.37	24.226	0.3	M4-10
60	286855	287898	22061403	21773505	286920	65	0.6	1000	17.37	24.226	0.3	M4-10
63	215979	216374	15986685	15770311	215983	4	0.6	1000	17.37	24.226	0.3	M4-10
64	1	1	6	5	1	0	0.6	1000	17.37	24.226	0.3	M4-10
66	95253	95707	9359301	9263594	95253	0	0.6	1000	17.37	24.226	0.3	M4-10
68	0	0	0	0	0	0	0.6	1000	17.37	24.226	0.3	M4-10
69	1350417	1352601	10540936	9188335	1350417	0	0.6	1000	17.37	24.226	0.3	M4-10
70	0	0	0	0	0	0	0.6	1000	17.37	24.226	0.3	M4-10
72	24248	24755	2229216	2204461	24250	2	0.6	1000	17.37	24.226	0.3	M4-10
75	139754	140475	1910035	1769560	139778	24	0.6	1000	17.37	24.226	0.3	M4-10
76	0	0	0	0	0	0	0.6	1000	17.37	24.226	0.3	M4-10
77	0	0	0	0	0	0	0.6	1000	17.37	24.226	0.3	M4-10
78	12071	12133	649230	637097	12071	0	0.6	1000	17.37	24.226	0.3	M4-10
81	2016	2056	113050	110994	2016	0	0.6	1000	17.37	24.226	0.3	M4-10
84	6455	6774	114481	107707	6455	0	0.6	1000	17.37	24.226	0.3	M4-10
87	1597	1597	25425	23828	1597	0	0.6	1000	17.37	24.226	0.3	M4-10
90	1003	1003	2701	1698	1003	0	0.6	1000	17.37	24.226	0.3	M4-10
6	1	1	1	0	1	0	0.6	1000	17.733	21.592	1.0	M4-10
9	1	1	1	0	1	0	0.6	1000	17.733	21.592	1.0	M4-10
24	2702	2702	19900	17198	2702	0	0.6	1000	17.733	21.592	1.0	M4-10
26	0	0	0	0	0	0	0.6	1000	17.733	21.592	1.0	M4-10
27	133	133	5886	5753	134	1	0.6	1000	17.733	21.592	1.0	M4-10
30	6895	6906	120295	113389	6895	0	0.6	1000	17.733	21.592	1.0	M4-10
33	8645	8705	421821	413116	8645	0	0.6	1000	17.733	21.592	1.0	M4-10
36	185027	185694	3096316	2910622	185073	46	0.6	1000	17.733	21.592	1.0	M4-10
38	0	0	0	0	0	0	0.6	1000	17.733	21.592	1.0	M4-10
39	103685	105276	5000703	4895427	103723	38	0.6	1000	17.733	21.592	1.0	M4-10
42	230408	288092	11710380	11422288	230488	80	0.6	1000	17.733	21.592	1.0	M4-10
45	300983	304182	20158075	19853893	300999	16	0.6	1000	17.733	21.592	1.0	M4-10
46	0	0	0	0	0	0	0.6	1000	17.733	21.592	1.0	M4-10
47	0	0	1	1	0	0	0.6	1000	17.733	21.592	1.0	M4-10
48	117219	119044	17449278	17330234	117228	9	0.6	1000	17.733	21.592	1.0	M4-10
51	154500	155250	22461753	22306503	154518	18	0.6	1000	17.733	21.592	1.0	M4-10
52	66	66	78	12	66	0	0.6	1000	17.733	21.592	1.0	M4-10
54	213245	214176	23905155	23690979	213288	43	0.6	1000	17.733	21.592	1.0	M4-10
56	0	0	0	0	0	0	0.6	1000	17.733	21.592	1.0	M4-10
57	93426	97008	16591680	16494672	93690	264	0.6	1000	17.733	21.592	1.0	M4-10
60	287163	287898	22061403	21773505	287242	79	0.6	1000	17.733	21.592	1.0	M4-10
63	216140	216374	15986685	15770311	216144	4	0.6	1000	17.733	21.592	1.0	M4-10
64	1	1	6	5	1	0	0.6	1000	17.733	21.592	1.0	M4-10
66	95423	95707	9359301	9263594	95425	2	0.6	1000	17.733	21.592	1.0	M4-10
68	0	0	0	0	0	0	0.6	1000	17.733	21.592	1.0	M4-10
69	1350381	1352601	10540936	9188335	1350381	0	0.6	1000	17.733	21.592	1.0	M4-10
70	0	0	0	0	0	0	0.6	1000	17.733	21.592	1.0	M4-10
72	24238	24755	2229216	2204461	24240	2	0.6	1000	17.733	21.592	1.0	M4-10
75	139754	140475	1910035	1769560	139778	24	0.6	1000	17.733	21.592	1.0	M4-10
76	0	0	0	0	0	0	0.6	1000	17.733	21.592	1.0	M4-10
77	0	0	0	0	0	0	0.6	1000	17.733	21.592	1.0	M4-10
78	12071	12133	649230	637097	12071	0	0.6	1000	17.733	21.592	1.0	M4-10
81	2016	2056	113050	110994	2016	0	0.6	1000	17.733	21.592	1.0	M4-10
84	6455	6774	114481	107707	6455	0	0.6	1000	17.733	21.592	1.0	M4-10
87	1597	1597	25425	23828	1597	0	0.6	1000	17.733	21.592	1.0	M4-10
90	1003	1003	2701	1698	1003	0	0.6	1000	17.733	21.592	1.0	M4-10
3	0	0	1	1	1	1	0.6	1000	18.438	37.908	0.1	M5-2
7	1	1	1	0	1	0	0.6	1000	18.438	37.908	0.1	M5-2
18	0	0	0	0	0	0	0.6	1000	18.438	37.908	0.1	M5-2
24	214	214	6903	6689	231	17	0.6	1000	18.438	37.908	0.1	M5-2
27	122051	122051	354061	232010	122051	0	0.6	1000	18.438	37.908	0.1	M5-2
30	3320	3522	101926	98404	3350	30	0.6	1000	18.438	37.908	0.1	M5-2
33	43890	44837	1679028	1634191	43893	3	0.6	1000	18.438	37.908	0.1	M5-2
36	53546	54578	3611328	3556750	53550	4	0.6	1000	18.438	37.908	0.1	M5-2
37	0	0	0	0	0	0	0.6	1000	18.438	37.908	0.1	M5-2
39	111143	120616	12900660	12780044	111909	766	0.6	1000	18.438	37.908	0.1	M5-2
42	259048	263474	28459740	28196266	259872	824	0.6	1000	18.438	37.908	0.1	M5-2
44	0	0	0	0	0	0	0.6	1000	18.438	37.908	0.1	M5-2
45	221123	228873	42739635	42510762	221294	171	0.6	1000	18.438	37.908	0.1	M5-2
48	330204	335275	64212778	63877503	330303	99	0.6	1000	18.438	37.908	0.1	M5-2
50	0	0	0	0	0	0	0.6	1000	18.438	37.908	0.1	M5-2
51	422471	427089	78845403	78418314	423103	632	0.6	1000	18.438	37.908	0.1	M5-2
53	0	0	0	0	0	0	0.6	1000	18.438	37.908	0.1	M5-2
54	359730	364838	54502020	54137182	359800	70	0.6	1000	18.438	37.908	0.1	M5-2
55	0	0	0	0	0	0	0.6	1000	18.438	37.908	0.1	M5-2
56	31	31	91	60	31	0	0.6	1000	18.438	37.908	0.1	M5-2
57	357886	361064	67890378	67529314	358983	1097	0.6	1000	18.438	37.908	0.1	M5-2
58	0	0	0	0	0	0	0.6	1000	18.438	37.908	0.1	M5-2
59	0	0	0	0	0	0	0.6	1000	18.438	37.908	0.1	M5-2
60	231694	238322	49466431	49228109	231722	28	0.6	1000	18.438	37.908	0.1	M5-2
61	21	21	28	7	21	0	0.6	1000	18.438	37.908	0.1	M5-2
62	0	0	0	0	0	0	0.6	1000	18.438	37.908	0.1	M5-2
63	271163	281201	42518031	42236830	271212	49	0.6	1000	18.438	37.908	0.1	M5-2
66	149423	151504	20836740	20685236	150925	1502	0.6	1000	18.438	37.908	0.1	M5-2
67	1	1	3	2	1	0	0.6	1000	18.438	37.908	0.1	M5-2
68	91	105	136	31	91	0	0.6	1000	18.438	37.908	0.1	M5-2
69	65691	67136	12228985	12161849	65693	2	0.6	1000	18.438	37.908	0.1	M5-2
71	21	21	28	7	21	0	0.6	1000	18.438	37.908	0.1	M5-2
72	94226	95226	8207326	8112100	94496	270	0.6	1000	18.438	37.908	0.1	M5-2
75	44111	44516	3219453	3174937	44111	0	0.6	1000	18.438	37.908	0.1	M5-2
78	28951	29067	1314631	1285564	28951	0	0.6	1000	18.438	37.908	0.1	M5-2
81	110737	110805	913276	802471	110737	0	0.6	1000	18.438	37.908	0.1	M5-2
83	0	0	0	0	0	0	0.6	1000	18.438	37.908	0.1	M5-2
84	25573	25606	414505	388899	25573	0	0.6	1000	18.438	37.908	0.1	M5-2
87	5096	5109	84666	79557	5097	1	0.6	1000	18.438	37.908	0.1	M5-2
90	13299	13355	103285	89930	13299	0	0.6	1000	18.438	37.908	0.1	M5-2
100	0	0	0	0	0	0	0.6	1000	18.438	37.908	0.1	M5-2
24	308	308	6328	6020	313	5	0.6	1000	18.605	37.465	0.1	M5-3
27	16086	16095	140715	124620	16098	12	0.6	1000	18.605	37.465	0.1	M5-3
30	4858	4974	159895	154921	4860	2	0.6	1000	18.605	37.465	0.1	M5-3
31	0	0	0	0	0	0	0.6	1000	18.605	37.465	0.1	M5-3
33	7026	7263	653796	646533	7160	134	0.6	1000	18.605	37.465	0.1	M5-3
34	0	0	0	0	0	0	0.6	1000	18.605	37.465	0.1	M5-3
36	135848	137759	5295885	5158126	136058	210	0.6	1000	18.605	37.465	0.1	M5-3
39	99424	130514	10417330	10286816	99430	6	0.6	1000	18.605	37.465	0.1	M5-3
42	86754	91321	19942770	19851449	86834	80	0.6	1000	18.605	37.465	0.1	M5-3
43	0	0	0	0	0	0	0.6	1000	18.605	37.465	0.1	M5-3
44	0	0	0	0	0	0	0.6	1000	18.605	37.465	0.1	M5-3
45	125445	129250	34781970	34652720	125809	364	0.6	1000	18.605	37.465	0.1	M5-3
48	206862	210738	59094756	58884018	207011	149	0.6	1000	18.605	37.465	0.1	M5-3
49	0	0	0	0	0	0	0.6	1000	18.605	37.465	0.1	M5-3
51	487724	494281	81888003	81393722	487932	208	0.6	1000	18.605	37.465	0.1	M5-3
52	36	36	66	30	36	0	0.6	1000	18.605	37.465	0.1	M5-3
53	0	0	0	0	0	0	0.6	1000	18.605	37.465	0.1	M5-3
54	265733	269606	66119250	65849644	266140	407	0.6	1000	18.605	37.465	0.1	M5-3
55	3	3	3	0	3	0	0.6	1000	18.605	37.465	0.1	M5-3
57	162105	169285	52372495	52203210	162401	296	0.6	1000	18.605	37.465	0.1	M5-3
59	0	0	0	0	0	0	0.6	1000	18.605	37.465	0.1	M5-3
60	153278	160056	45797235	45637179	153318	40	0.6	1000	18.605	37.465	0.1	M5-3
62	0	0	0	0	0	0	0.6	1000	18.605	37.465	0.1	M5-3
63	329657	331982	34898835	34566853	329658	1	0.6	1000	18.605	37.465	0.1	M5-3
64	6	6	15	9	6	0	0.6	1000	18.605	37.465	0.1	M5-3
65	3	3	6	3	3	0	0.6	1000	18.605	37.465	0.1	M5-3
66	133366	139137	27911656	27772519	133466	100	0.6	1000	18.605	37.465	0.1	M5-3
67	0	1	3	2	0	0	0.6	1000	18.605	37.465	0.1	M5-3
68	0	0	1	1	0	0	0.6	1000	18.605	37.465	0.1	M5-3
69	243712	245464	20457606	20212142	243712	0	0.6	1000	18.605	37.465	0.1	M5-3
70	0	0	1	1	0	0	0.6	1000	18.605	37.465	0.1	M5-3
71	1	1	1	0	1	0	0.6	1000	18.605	37.465	0.1	M5-3
72	195984	198082	11421810	11223728	196219	235	0.6	1000	18.605	37.465	0.1	M5-3
75	83717	85158	4229686	4144528	83717	0	0.6	1000	18.605	37.465	0.1	M5-3
78	12475	12644	790653	778009	12475	0	0.6	1000	18.605	37.465	0.1	M5-3
79	0	0	0	0	0	0	0.6	1000	18.605	37.465	0.1	M5-3
81	67553	67564	816003	748439	67553	0	0.6	1000	18.605	37.465	0.1	M5-3
84	16901	17129	417241	400112	16901	0	0.6	1000	18.605	37.465	0.1	M5-3
87	1646	1646	29403	27757	1647	1	0.6	1000	18.605	37.465	0.1	M5-3
90	20110	20118	123753	103635	20110	0	0.6	1000	18.605	37.465	0.1	M5-3
3	0	0	1	1	1	1	0.6	1000	19.299	29.425	1.0	M5-2
7	1	1	1	0	1	0	0.6	1000	19.299	29.425	1.0	M5-2
18	0	0	0	0	0	0	0.6	1000	19.299	29.425	1.0	M5-2
24	214	214	6903	6689	231	17	0.6	1000	19.299	29.425	1.0	M5-2
27	122051	122051	354061	232010	122051	0	0.6	1000	19.299	29.425	1.0	M5-2
30	3320	3522	101926	98404	3350	30	0.6	1000	19.299	29.425	1.0	M5-2
33	43890	44837	1679028	1634191	43893	3	0.6	1000	19.299	29.425	1.0	M5-2
36	53919	54578	3611328	3556750	53923	4	0.6	1000	19.299	29.425	1.0	M5-2
37	0	0	0	0	0	0	0.6	1000	19.299	29.425	1.0	M5-2
39	104535	120616	12900660	12780044	104549	14	0.6	1000	19.299	29.425	1.0	M5-2
42	257174	263474	28459740	28196266	258006	832	0.6	1000	19.299	29.425	1.0	M5-2
44	0	0	0	0	0	0	0.6	1000	19.299	29.425	1.0	M5-2
45	223677	228873	42739635	42510762	223738	61	0.6	1000	19.299	29.425	1.0	M5-2
48	331895	335275	64212778	63877503	332007	112	0.6	1000	19.299	29.425	1.0	M5-2
50	0	0	0	0	0	0	0.6	1000	19.299	29.425	1.0	M5-2
51	423582	427089	78845403	78418314	424222	640	0.6	1000	19.299	29.425	1.0	M5-2
53	0	0	0	0	0	0	0.6	1000	19.299	29.425	1.0	M5-2
54	363238	364838	54502020	54137182	363301	63	0.6	1000	19.299	29.425	1.0	M5-2
55	0	0	0	0	0	0	0.6	1000	19.299	29.425	1.0	M5-2
56	31	31	91	60	31	0	0.6	1000	19.299	29.425	1.0	M5-2
57	359238	361064	67890378	67529314	360359	1121	0.6	1000	19.299	29.425	1.0	M5-2
58	0	0	0	0	0	0	0.6	1000	19.299	29.425	1.0	M5-2
59	0	0	0	0	0	0	0.6	1000	19.299	29.425	1.0	M5-2
60	232466	238322	49466431	49228109	232489	23	0.6	1000	19.299	29.425	1.0	M5-2
61	21	21	28	7	21	0	0.6	1000	19.299	29.425	1.0	M5-2
62	0	0	0	0	0	0	0.6	1000	19.299	29.425	1.0	M5-2
63	274360	281201	42518031	42236830	274411	51	0.6	1000	19.299	29.425	1.0	M5-2
66	150085	151504	20836740	20685236	151646	1561	0.6	1000	19.299	29.425	1.0	M5-2
67	1	1	3	2	1	0	0.6	1000	19.299	29.425	1.0	M5-2
68	91	105	136	31	91	0	0.6	1000	19.299	29.425	1.0	M5-2
69	66155	67136	12228985	12161849	66180	25	0.6	1000	19.299	29.425	1.0	M5-2
71	21	21	28	7	21	0	0.6	1000	19.299	29.425	1.0	M5-2
72	94748	95226	8207326	8112100	95588	840	0.6	1000	19.299	29.425	1.0	M5-2
75	44411	44516	3219453	3174937	44411	0	0.6	1000	19.299	29.425	1.0	M5-2
78	28951	29067	1314631	1285564	28951	0	0.6	1000	19.299	29.425	1.0	M5-2
81	110737	110805	913276	802471	110737	0	0.6	1000	19.299	29.425	1.0	M5-2
83	0	0	0	0	0	0	0.6	1000	19.299	29.425	1.0	M5-2
84	25573	25606	414505	388899	25573	0	0.6	1000	19.299	29.425	1.0	M5-2
87	5096	5109	84666	79557	5097	1	0.6	1000	19.299	29.425	1.0	M5-2
90	13299	13355	103285	89930	13299	0	0.6	1000	19.299	29.425	1.0	M5-2
100	0	0	0	0	0	0	0.6	1000	19.299	29.425	1.0	M5-2
3	0	0	1	1	0	0	0.6	1000	19.317	37.559	0.1	M5-5
24	6037	10078	57291	47213	6057	20	0.6	1000	19.317	37.559	0.1	M5-5
27	1746	1747	18528	16781	1765	19	0.6	1000	19.317	37.559	0.1	M5-5
29	0	0	0	0	0	0	0.6	1000	19.317	37.559	0.1	M5-5
30	5098	5147	212226	207079	5619	521	0.6	1000	19.317	37.559	0.1	M5-5
32	0	0	0	0	0	0	0.6	1000	19.317	37.559	0.1	M5-5
33	43556	45315	1771903	1726588	43614	58	0.6	1000	19.317	37.559	0.1	M5-5
36	81143	86887	5282875	5195988	81149	6	0.6	1000	19.317	37.559	0.1	M5-5
39	201987	203840	14935845	14732005	201993	6	0.6	1000	19.317	37.559	0.1	M5-5
42	379228	384044	34999161	34615117	379394	166	0.6	1000	19.317	37.559	0.1	M5-5
45	379607	384335	49237926	48853591	379675	68	0.6	1000	19.317	37.559	0.1	M5-5
47	1	1	1	0	1	0	0.6	1000	19.317	37.559	0.1	M5-5
48	304553	316394	67738980	67422586	304878	325	0.6	1000	19.317	37.559	0.1	M5-5
49	0	0	1	1	0	0	0.6	1000	19.317	37.559	0.1	M5-5
50	0	0	0	0	0	0	0.6	1000	19.317	37.559	0.1	M5-5
51	139197	142966	58509153	58366187	139382	185	0.6	1000	19.317	37.559	0.1	M5-5
53	0	0	0	0	0	0	0.6	1000	19.317	37.559	0.1	M5-5
54	576638	608203	66857266	66249063	576719	81	0.6	1000	19.317	37.559	0.1	M5-5
55	0	0	1	1	0	0	0.6	1000	19.317	37.559	0.1	M5-5
56	0	0	0	0	0	0	0.6	1000	19.317	37.559	0.1	M5-5
57	191098	198194	56716575	56518381	195666	4568	0.6	1000	19.317	37.559	0.1	M5-5
58	210	210	210	0	210	0	0.6	1000	19.317	37.559	0.1	M5-5
59	4	9	21	12	4	0	0.6	1000	19.317	37.559	0.1	M5-5
60	223982	231970	41546170	41314200	223987	5	0.6	1000	19.317	37.559	0.1	M5-5
61	0	0	0	0	0	0	0.6	1000	19.317	37.559	0.1	M5-5
62	0	0	0	0	0	0	0.6	1000	19.317	37.559	0.1	M5-5
63	118900	129043	32453596	32324553	118902	2	0.6	1000	19.317	37.559	0.1	M5-5
64	0	0	1	1	0	0	0.6	1000	19.317	37.559	0.1	M5-5
66	175258	178578	24454521	24275943	175262	4	0.6	1000	19.317	37.559	0.1	M5-5
67	0	0	0	0	0	0	0.6	1000	19.317	37.559	0.1	M5-5
69	207184	214049	22906296	22692247	207248	64	0.6	1000	19.317	37.559	0.1	M5-5
70	0	0	0	0	0	0	0.6	1000	19.317	37.559	0.1	M5-5
72	137806	139273	8957028	8817755	138046	240	0.6	1000	19.317	37.559	0.1	M5-5
73	1	1	3	2	1	0	0.6	1000	19.317	37.559	0.1	M5-5
74	0	0	0	0	0	0	0.6	1000	19.317	37.559	0.1	M5-5
75	51278	51646	4394130	4342484	51324	46	0.6	1000	19.317	37.559	0.1	M5-5
78	19119	19451	1023165	1003714	19119	0	0.6	1000	19.317	37.559	0.1	M5-5
81	21179	21248	727821	706573	21179	0	0.6	1000	19.317	37.559	0.1	M5-5
84	10703	10715	200661	189946	10703	0	0.6	1000	19.317	37.559	0.1	M5-5
87	6286	6313	99681	93368	6286	0	0.6	1000	19.317	37.559	0.1	M5-5
90	8355	9423	70125	60702	8355	0	0.6	1000	19.317	37.559	0.1	M5-5
2	0	0	0	0	0	0	0.6	1000	19.356	37.735	0.1	M5-9
24	177	177	6786	6609	183	6	0.6	1000	19.356	37.735	0.1	M5-9
27	725	737	23871	23134	725	0	0.6	1000	19.356	37.735	0.1	M5-9
30	6565	6576	241165	234589	6575	10	0.6	1000	19.356	37.735	0.1	M5-9
33	200529	201488	2189278	1987790	200535	6	0.6	1000	19.356	37.735	0.1	M5-9
36	55992	57215	3491403	3434188	55992	0	0.6	1000	19.356	37.735	0.1	M5-9
37	0	0	0	0	0	0	0.6	1000	19.356	37.735	0.1	M5-9
39	30938	36069	7378561	7342492	30955	17	0.6	1000	19.356	37.735	0.1	M5-9
42	132732	137222	23780856	23643634	133223	491	0.6	1000	19.356	37.735	0.1	M5-9
44	0	0	0	0	0	0	0.6	1000	19.356	37.735	0.1	M5-9
45	99420	104239	35604141	35499902	99500	80	0.6	1000	19.356	37.735	0.1	M5-9
48	211317	216627	55762080	55545453	211348	31	0.6	1000	19.356	37.735	0.1	M5-9
49	0	0	0	0	0	0	0.6	1000	19.356	37.735	0.1	M5-9
50	190	190	210	20	190	0	0.6	1000	19.356	37.735	0.1	M5-9
51	434197	441159	87615703	87174544	434396	199	0.6	1000	19.356	37.735	0.1	M5-9
52	3	3	15	12	3	0	0.6	1000	19.356	37.735	0.1	M5-9
54	326915	332560	79046451	78713891	327037	122	0.6	1000	19.356	37.735	0.1	M5-9
55	0	0	0	0	0	0	0.6	1000	19.356	37.735	0.1	M5-9
57	225559	239552	57111328	56871776	226272	713	0.6	1000	19.356	37.735	0.1	M5-9
60	719773	725573	75885040	75159467	719816	43	0.6	1000	19.356	37.735	0.1	M5-9
63	176559	178994	30862296	30683302	178012	1453	0.6	1000	19.356	37.735	0.1	M5-9
64	1	1	1	0	1	0	0.6	1000	19.356	37.735	0.1	M5-9
65	0	0	0	0	0	0	0.6	1000	19.356	37.735	0.1	M5-9
66	276001	278881	26082253	25803372	276001	0	0.6	1000	19.356	37.735	0.1	M5-9
67	0	0	0	0	0	0	0.6	1000	19.356	37.735	0.1	M5-9
68	0	0	0	0	0	0	0.6	1000	19.356	37.735	0.1	M5-9
69	118128	121659	11231430	11109771	118161	33	0.6	1000	19.356	37.735	0.1	M5-9
71	0	0	0	0	0	0	0.6	1000	19.356	37.735	0.1	M5-9
72	184311	185224	11768526	11583302	184316	5	0.6	1000	19.356	37.735	0.1	M5-9
75	37682	38610	3121251	3082641	37682	0	0.6	1000	19.356	37.735	0.1	M5-9
78	29428	29894	1483503	1453609	29428	0	0.6	1000	19.356	37.735	0.1	M5-9
79	2278	2278	2278	0	2278	0	0.6	1000	19.356	37.735	0.1	M5-9
81	64663	64982	1242676	1177694	64663	0	0.6	1000	19.356	37.735	0.1	M5-9
82	1	1	1	0	1	0	0.6	1000	19.356	37.735	0.1	M5-9
83	0	0	1	1	0	0	0.6	1000	19.356	37.735	0.1	M5-9
84	3502	3530	134940	131410	3502	0	0.6	1000	19.356	37.735	0.1	M5-9
87	3860	3861	67528	63667	3860	0	0.6	1000	19.356	37.735	0.1	M5-9
90	3033	3033	28441	25408	3033	0	0.6	1000	19.356	37.735	0.1	M5-9
3	0	0	1	1	1	1	0.6	1000	19.493	37.56	0.3	M5-2
7	1	1	1	0	1	0	0.6	1000	19.493	37.56	0.3	M5-2
18	0	0	0	0	0	0	0.6	1000	19.493	37.56	0.3	M5-2
24	214	214	6903	6689	231	17	0.6	1000	19.493	37.56	0.3	M5-2
27	122051	122051	354061	232010	122051	0	0.6	1000	19.493	37.56	0.3	M5-2
30	3320	3522	101926	98404	3350	30	0.6	1000	19.493	37.56	0.3	M5-2
33	43890	44837	1679028	1634191	43893	3	0.6	1000	19.493	37.56	0.3	M5-2
36	53946	54578	3611328	3556750	53950	4	0.6	1000	19.493	37.56	0.3	M5-2
37	0	0	0	0	0	0	0.6	1000	19.493	37.56	0.3	M5-2
39	117953	120616	12900660	12780044	118792	839	0.6	1000	19.493	37.56	0.3	M5-2
42	257652	263474	28459740	28196266	258442	790	0.6	1000	19.493	37.56	0.3	M5-2
44	0	0	0	0	0	0	0.6	1000	19.493	37.56	0.3	M5-2
45	224904	228873	42739635	42510762	224964	60	0.6	1000	19.493	37.56	0.3	M5-2
48	330536	335275	64212778	63877503	330642	106	0.6	1000	19.493	37.56	0.3	M5-2
50	0	0	0	0	0	0	0.6	1000	19.493	37.56	0.3	M5-2
51	423364	427089	78845403	78418314	423984	620	0.6	1000	19.493	37.56	0.3	M5-2
53	0	0	0	0	0	0	0.6	1000	19.493	37.56	0.3	M5-2
54	346308	364838	54502020	54137182	346407	99	0.6	1000	19.493	37.56	0.3	M5-2
55	0	0	0	0	0	0	0.6	1000	19.493	37.56	0.3	M5-2
56	31	31	91	60	31	0	0.6	1000	19.493	37.56	0.3	M5-2
57	358801	361064	67890378	67529314	359922	1121	0.6	1000	19.493	37.56	0.3	M5-2
58	0	0	0	0	0	0	0.6	1000	19.493	37.56	0.3	M5-2
59	0	0	0	0	0	0	0.6	1000	19.493	37.56	0.3	M5-2
60	227885	238322	49466431	49228109	227908	23	0.6	1000	19.493	37.56	0.3	M5-2
61	21	21	28	7	21	0	0.6	1000	19.493	37.56	0.3	M5-2
62	0	0	0	0	0	0	0.6	1000	19.493	37.56	0.3	M5-2
63	274081	281201	42518031	42236830	274132	51	0.6	1000	19.493	37.56	0.3	M5-2
66	149912	151504	20836740	20685236	151473	1561	0.6	1000	19.493	37.56	0.3	M5-2
67	1	1	3	2	1	0	0.6	1000	19.493	37.56	0.3	M5-2
68	91	105	136	31	91	0	0.6	1000	19.493	37.56	0.3	M5-2
69	65733	67136	12228985	12161849	65738	5	0.6	1000	19.493	37.56	0.3	M5-2
71	21	21	28	7	21	0	0.6	1000	19.493	37.56	0.3	M5-2
72	94661	95226	8207326	8112100	95501	840	0.6	1000	19.493	37.56	0.3	M5-2
75	44155	44516	3219453	3174937	44155	0	0.6	1000	19.493	37.56	0.3	M5-2
78	28951	29067	1314631	1285564	28951	0	0.6	1000	19.493	37.56	0.3	M5-2
81	110737	110805	913276	802471	110737	0	0.6	1000	19.493	37.56	0.3	M5-2
83	0	0	0	0	0	0	0.6	1000	19.493	37.56	0.3	M5-2
84	25573	25606	414505	388899	25573	0	0.6	1000	19.493	37.56	0.3	M5-2
87	5096	5109	84666	79557	5097	1	0.6	1000	19.493	37.56	0.3	M5-2
90	13299	13355	103285	89930	13299	0	0.6	1000	19.493	37.56	0.3	M5-2
100	0	0	0	0	0	0	0.6	1000	19.493	37.56	0.3	M5-2
24	308	308	6328	6020	313	5	0.6	1000	19.523	35.93	1.0	M5-3
27	16086	16095	140715	124620	16098	12	0.6	1000	19.523	35.93	1.0	M5-3
30	4858	4974	159895	154921	4860	2	0.6	1000	19.523	35.93	1.0	M5-3
31	0	0	0	0	0	0	0.6	1000	19.523	35.93	1.0	M5-3
33	7026	7263	653796	646533	7160	134	0.6	1000	19.523	35.93	1.0	M5-3
34	0	0	0	0	0	0	0.6	1000	19.523	35.93	1.0	M5-3
36	136237	137759	5295885	5158126	136447	210	0.6	1000	19.523	35.93	1.0	M5-3
39	100155	130514	10417330	10286816	100161	6	0.6	1000	19.523	35.93	1.0	M5-3
42	90569	91321	19942770	19851449	90653	84	0.6	1000	19.523	35.93	1.0	M5-3
43	0	0	0	0	0	0	0.6	1000	19.523	35.93	1.0	M5-3
44	0	0	0	0	0	0	0.6	1000	19.523	35.93	1.0	M5-3
45	122332	129250	34781970	34652720	122738	406	0.6	1000	19.523	35.93	1.0	M5-3
48	208139	210738	59094756	58884018	208799	660	0.6	1000	19.523	35.93	1.0	M5-3
49	0	0	0	0	0	0	0.6	1000	19.523	35.93	1.0	M5-3
51	491504	494281	81888003	81393722	491731	227	0.6	1000	19.523	35.93	1.0	M5-3
52	36	36	66	30	36	0	0.6	1000	19.523	35.93	1.0	M5-3
53	0	0	0	0	0	0	0.6	1000	19.523	35.93	1.0	M5-3
54	267117	269606	66119250	65849644	267526	409	0.6	1000	19.523	35.93	1.0	M5-3
55	3	3	3	0	3	0	0.6	1000	19.523	35.93	1.0	M5-3
57	164388	169285	52372495	52203210	164705	317	0.6	1000	19.523	35.93	1.0	M5-3
59	0	0	0	0	0	0	0.6	1000	19.523	35.93	1.0	M5-3
60	155137	160056	45797235	45637179	155238	101	0.6	1000	19.523	35.93	1.0	M5-3
62	0	0	0	0	0	0	0.6	1000	19.523	35.93	1.0	M5-3
63	331049	331982	34898835	34566853	331050	1	0.6	1000	19.523	35.93	1.0	M5-3
64	6	6	15	9	6	0	0.6	1000	19.523	35.93	1.0	M5-3
65	3	3	6	3	3	0	0.6	1000	19.523	35.93	1.0	M5-3
66	132612	139137	27911656	27772519	132613	1	0.6	1000	19.523	35.93	1.0	M5-3
67	0	1	3	2	0	0	0.6	1000	19.523	35.93	1.0	M5-3
68	0	0	1	1	0	0	0.6	1000	19.523	35.93	1.0	M5-3
69	243483	245464	20457606	20212142	243494	11	0.6	1000	19.523	35.93	1.0	M5-3
70	0	0	1	1	0	0	0.6	1000	19.523	35.93	1.0	M5-3
71	1	1	1	0	1	0	0.6	1000	19.523	35.93	1.0	M5-3
72	196405	198082	11421810	11223728	196641	236	0.6	1000	19.523	35.93	1.0	M5-3
75	84065	85158	4229686	4144528	84065	0	0.6	1000	19.523	35.93	1.0	M5-3
78	12475	12644	790653	778009	12475	0	0.6	1000	19.523	35.93	1.0	M5-3
79	0	0	0	0	0	0	0.6	1000	19.523	35.93	1.0	M5-3
81	67553	67564	816003	748439	67553	0	0.6	1000	19.523	35.93	1.0	M5-3
84	16901	17129	417241	400112	16901	0	0.6	1000	19.523	35.93	1.0	M5-3
87	1646	1646	29403	27757	1647	1	0.6	1000	19.523	35.93	1.0	M5-3
90	20110	20118	123753	103635	20110	0	0.6	1000	19.523	35.93	1.0	M5-3
9	0	0	0	0	0	0	0.6	1000	19.759	36.053	0.1	M5-10
24	4023	4025	51681	47656	4023	0	0.6	1000	19.759	36.053	0.1	M5-10
27	2691	2691	42778	40087	2691	0	0.6	1000	19.759	36.053	0.1	M5-10
28	0	0	0	0	0	0	0.6	1000	19.759	36.053	0.1	M5-10
30	5642	5687	220780	215093	5642	0	0.6	1000	19.759	36.053	0.1	M5-10
33	74184	75175	1973091	1897916	74191	7	0.6	1000	19.759	36.053	0.1	M5-10
34	1	1	1	0	1	0	0.6	1000	19.759	36.053	0.1	M5-10
36	68580	70553	4850055	4779502	68591	11	0.6	1000	19.759	36.053	0.1	M5-10
38	3	3	3	0	3	0	0.6	1000	19.759	36.053	0.1	M5-10
39	87610	94977	11536806	11441829	87618	8	0.6	1000	19.759	36.053	0.1	M5-10
42	175236	178861	27117930	26939069	175360	124	0.6	1000	19.759	36.053	0.1	M5-10
45	408256	413139	47438670	47025531	408550	294	0.6	1000	19.759	36.053	0.1	M5-10
46	0	0	1	1	0	0	0.6	1000	19.759	36.053	0.1	M5-10
48	285173	292743	58584900	58292157	285221	48	0.6	1000	19.759	36.053	0.1	M5-10
51	422527	426369	82593378	82167009	422999	472	0.6	1000	19.759	36.053	0.1	M5-10
52	0	0	1	1	0	0	0.6	1000	19.759	36.053	0.1	M5-10
54	155085	162520	53618190	53455670	155230	145	0.6	1000	19.759	36.053	0.1	M5-10
56	0	0	0	0	0	0	0.6	1000	19.759	36.053	0.1	M5-10
57	368288	388265	62010816	61622551	368369	81	0.6	1000	19.759	36.053	0.1	M5-10
58	0	0	0	0	0	0	0.6	1000	19.759	36.053	0.1	M5-10
59	0	0	0	0	0	0	0.6	1000	19.759	36.053	0.1	M5-10
60	396358	398622	51171786	50773164	396383	25	0.6	1000	19.759	36.053	0.1	M5-10
63	309869	323841	37320480	36996639	309917	48	0.6	1000	19.759	36.053	0.1	M5-10
64	0	0	0	0	0	0	0.6	1000	19.759	36.053	0.1	M5-10
65	0	0	0	0	0	0	0.6	1000	19.759	36.053	0.1	M5-10
66	114838	120664	25300941	25180277	114945	107	0.6	1000	19.759	36.053	0.1	M5-10
69	151323	158025	18816045	18658020	151324	1	0.6	1000	19.759	36.053	0.1	M5-10
70	0	0	1	1	0	0	0.6	1000	19.759	36.053	0.1	M5-10
71	1	1	1	0	1	0	0.6	1000	19.759	36.053	0.1	M5-10
72	198769	203877	10499653	10295776	198826	57	0.6	1000	19.759	36.053	0.1	M5-10
75	56305	57625	3584503	3526878	56305	0	0.6	1000	19.759	36.053	0.1	M5-10
78	28620	29049	1492128	1463079	28620	0	0.6	1000	19.759	36.053	0.1	M5-10
81	5657	5697	324415	318718	5664	7	0.6	1000	19.759	36.053	0.1	M5-10
84	22261	22546	234270	211724	22261	0	0.6	1000	19.759	36.053	0.1	M5-10
87	861	866	42195	41329	881	20	0.6	1000	19.759	36.053	0.1	M5-10
89	0	0	0	0	0	0	0.6	1000	19.759	36.053	0.1	M5-10
90	8671	8673	50086	41413	8671	0	0.6	1000	19.759	36.053	0.1	M5-10
24	869	893	18915	18022	869	0	0.6	1000	20.287	37.121	0.1	M5-7
27	3180	3180	45451	42271	3224	44	0.6	1000	20.287	37.121	0.1	M5-7
30	6598	7335	248160	240825	6708	110	0.6	1000	20.287	37.121	0.1	M5-7
33	9462	9512	743590	734078	9467	5	0.6	1000	20.287	37.121	0.1	M5-7
34	0	0	0	0	0	0	0.6	1000	20.287	37.121	0.1	M5-7
36	47275	48756	3004926	2956170	47338	63	0.6	1000	20.287	37.121	0.1	M5-7
38	0	0	0	0	0	0	0.6	1000	20.287	37.121	0.1	M5-7
39	323077	337132	15354111	15016979	323077	0	0.6	1000	20.287	37.121	0.1	M5-7
41	1	1	1	0	1	0	0.6	1000	20.287	37.121	0.1	M5-7
42	339350	350257	30011878	29661621	339431	81	0.6	1000	20.287	37.121	0.1	M5-7
43	0	0	0	0	0	0	0.6	1000	20.287	37.121	0.1	M5-7
45	176568	179480	41975703	41796223	177493	925	0.6	1000	20.287	37.121	0.1	M5-7
48	169906	199870	53877390	53677520	169953	47	0.6	1000	20.287	37.121	0.1	M5-7
49	3	3	3	0	3	0	0.6	1000	20.287	37.121	0.1	M5-7
51	310629	319118	74951646	74632528	311056	427	0.6	1000	20.287	37.121	0.1	M5-7
52	2	2	10	8	2	0	0.6	1000	20.287	37.121	0.1	M5-7
53	0	0	0	0	0	0	0.6	1000	20.287	37.121	0.1	M5-7
54	340990	348872	70051366	69702494	341325	335	0.6	1000	20.287	37.121	0.1	M5-7
55	0	0	1	1	0	0	0.6	1000	20.287	37.121	0.1	M5-7
56	3	3	3	0	3	0	0.6	1000	20.287	37.121	0.1	M5-7
57	353177	358240	65763246	65405006	353817	640	0.6	1000	20.287	37.121	0.1	M5-7
59	0	0	0	0	0	0	0.6	1000	20.287	37.121	0.1	M5-7
60	127165	133351	38645236	38511885	127227	62	0.6	1000	20.287	37.121	0.1	M5-7
61	0	0	0	0	0	0	0.6	1000	20.287	37.121	0.1	M5-7
62	3	3	10	7	3	0	0.6	1000	20.287	37.121	0.1	M5-7
63	191535	196867	36984300	36787433	191574	39	0.6	1000	20.287	37.121	0.1	M5-7
64	1	1	6	5	1	0	0.6	1000	20.287	37.121	0.1	M5-7
66	203204	205243	23953581	23748338	203210	6	0.6	1000	20.287	37.121	0.1	M5-7
67	1	1	6	5	1	0	0.6	1000	20.287	37.121	0.1	M5-7
69	209069	213269	17249001	17035732	209072	3	0.6	1000	20.287	37.121	0.1	M5-7
70	0	0	0	0	0	0	0.6	1000	20.287	37.121	0.1	M5-7
72	105486	107768	8830503	8722735	105488	2	0.6	1000	20.287	37.121	0.1	M5-7
75	194658	195618	4887501	4691883	194664	6	0.6	1000	20.287	37.121	0.1	M5-7
78	103791	103947	2364225	2260278	103791	0	0.6	1000	20.287	37.121	0.1	M5-7
80	0	0	0	0	0	0	0.6	1000	20.287	37.121	0.1	M5-7
81	4652	4671	307720	303049	4652	0	0.6	1000	20.287	37.121	0.1	M5-7
84	18626	18644	351541	332897	18626	0	0.6	1000	20.287	37.121	0.1	M5-7
85	0	0	0	0	0	0	0.6	1000	20.287	37.121	0.1	M5-7
87	529	529	23653	23124	529	0	0.6	1000	20.287	37.121	0.1	M5-7
90	41892	41911	314821	272910	41892	0	0.6	1000	20.287	37.121	0.1	M5-7
24	101957	102152	254541	152389	101957	0	0.6	1000	20.362	37.831	0.1	M5-8
27	118718	118718	318801	200083	118718	0	0.6	1000	20.362	37.831	0.1	M5-8
30	2188	2234	135981	133747	2202	14	0.6	1000	20.362	37.831	0.1	M5-8
33	26665	27746	1319500	1291754	26674	9	0.6	1000	20.362	37.831	0.1	M5-8
35	0	0	0	0	0	0	0.6	1000	20.362	37.831	0.1	M5-8
36	56556	57821	2951235	2893414	56566	10	0.6	1000	20.362	37.831	0.1	M5-8
39	155392	158036	12890503	12732467	155496	104	0.6	1000	20.362	37.831	0.1	M5-8
41	0	0	0	0	0	0	0.6	1000	20.362	37.831	0.1	M5-8
42	263306	269184	28618395	28349211	263388	82	0.6	1000	20.362	37.831	0.1	M5-8
45	306380	311238	45768528	45457290	307049	669	0.6	1000	20.362	37.831	0.1	M5-8
46	0	0	0	0	0	0	0.6	1000	20.362	37.831	0.1	M5-8
47	21	21	28	7	21	0	0.6	1000	20.362	37.831	0.1	M5-8
48	378201	383779	64553203	64169424	378258	57	0.6	1000	20.362	37.831	0.1	M5-8
49	6	6	15	9	6	0	0.6	1000	20.362	37.831	0.1	M5-8
50	0	0	0	0	0	0	0.6	1000	20.362	37.831	0.1	M5-8
51	220770	224402	60428521	60204119	220823	53	0.6	1000	20.362	37.831	0.1	M5-8
52	1	1	1	0	1	0	0.6	1000	20.362	37.831	0.1	M5-8
53	0	0	1	1	0	0	0.6	1000	20.362	37.831	0.1	M5-8
54	226920	230638	57657691	57427053	227008	88	0.6	1000	20.362	37.831	0.1	M5-8
55	1	1	6	5	1	0	0.6	1000	20.362	37.831	0.1	M5-8
57	331057	334699	68357278	68022579	331302	245	0.6	1000	20.362	37.831	0.1	M5-8
60	397354	413840	62580078	62166238	397366	12	0.6	1000	20.362	37.831	0.1	M5-8
63	245057	248261	45205786	44957525	245062	5	0.6	1000	20.362	37.831	0.1	M5-8
64	0	0	0	0	0	0	0.6	1000	20.362	37.831	0.1	M5-8
65	0	0	0	0	0	0	0.6	1000	20.362	37.831	0.1	M5-8
66	275138	277979	24454521	24176542	275153	15	0.6	1000	20.362	37.831	0.1	M5-8
69	123375	125482	16459453	16333971	123378	3	0.6	1000	20.362	37.831	0.1	M5-8
72	125532	128582	8398851	8270269	125539	7	0.6	1000	20.362	37.831	0.1	M5-8
75	16179	17750	2577585	2559835	16180	1	0.6	1000	20.362	37.831	0.1	M5-8
77	0	0	0	0	0	0	0.6	1000	20.362	37.831	0.1	M5-8
78	30822	32051	1121253	1089202	30823	1	0.6	1000	20.362	37.831	0.1	M5-8
79	3	3	3	0	3	0	0.6	1000	20.362	37.831	0.1	M5-8
81	18564	18604	523776	505172	18565	1	0.6	1000	20.362	37.831	0.1	M5-8
82	0	0	0	0	0	0	0.6	1000	20.362	37.831	0.1	M5-8
84	21170	21184	356590	335406	21170	0	0.6	1000	20.362	37.831	0.1	M5-8
87	1161	1193	59340	58147	1161	0	0.6	1000	20.362	37.831	0.1	M5-8
90	1001	1001	14196	13195	1001	0	0.6	1000	20.362	37.831	0.1	M5-8
3	0	0	1	1	1	1	0.6	1000	20.389	37.108	0.5	M5-2
7	1	1	1	0	1	0	0.6	1000	20.389	37.108	0.5	M5-2
18	0	0	0	0	0	0	0.6	1000	20.389	37.108	0.5	M5-2
24	214	214	6903	6689	231	17	0.6	1000	20.389	37.108	0.5	M5-2
27	122051	122051	354061	232010	122051	0	0.6	1000	20.389	37.108	0.5	M5-2
30	3320	3522	101926	98404	3350	30	0.6	1000	20.389	37.108	0.5	M5-2
33	43890	44837	1679028	1634191	43893	3	0.6	1000	20.389	37.108	0.5	M5-2
36	54066	54578	3611328	3556750	54070	4	0.6	1000	20.389	37.108	0.5	M5-2
37	0	0	0	0	0	0	0.6	1000	20.389	37.108	0.5	M5-2
39	118541	120616	12900660	12780044	119382	841	0.6	1000	20.389	37.108	0.5	M5-2
42	256394	263474	28459740	28196266	257165	771	0.6	1000	20.389	37.108	0.5	M5-2
44	0	0	0	0	0	0	0.6	1000	20.389	37.108	0.5	M5-2
45	225040	228873	42739635	42510762	225267	227	0.6	1000	20.389	37.108	0.5	M5-2
48	331492	335275	64212778	63877503	331598	106	0.6	1000	20.389	37.108	0.5	M5-2
50	0	0	0	0	0	0	0.6	1000	20.389	37.108	0.5	M5-2
51	423494	427089	78845403	78418314	424115	621	0.6	1000	20.389	37.108	0.5	M5-2
53	0	0	0	0	0	0	0.6	1000	20.389	37.108	0.5	M5-2
54	362251	364838	54502020	54137182	362341	90	0.6	1000	20.389	37.108	0.5	M5-2
55	0	0	0	0	0	0	0.6	1000	20.389	37.108	0.5	M5-2
56	31	31	91	60	31	0	0.6	1000	20.389	37.108	0.5	M5-2
57	359169	361064	67890378	67529314	360289	1120	0.6	1000	20.389	37.108	0.5	M5-2
58	0	0	0	0	0	0	0.6	1000	20.389	37.108	0.5	M5-2
59	0	0	0	0	0	0	0.6	1000	20.389	37.108	0.5	M5-2
60	232443	238322	49466431	49228109	232468	25	0.6	1000	20.389	37.108	0.5	M5-2
61	21	21	28	7	21	0	0.6	1000	20.389	37.108	0.5	M5-2
62	0	0	0	0	0	0	0.6	1000	20.389	37.108	0.5	M5-2
63	274302	281201	42518031	42236830	274354	52	0.6	1000	20.389	37.108	0.5	M5-2
66	149239	151504	20836740	20685236	150800	1561	0.6	1000	20.389	37.108	0.5	M5-2
67	1	1	3	2	1	0	0.6	1000	20.389	37.108	0.5	M5-2
68	91	105	136	31	91	0	0.6	1000	20.389	37.108	0.5	M5-2
69	66027	67136	12228985	12161849	66032	5	0.6	1000	20.389	37.108	0.5	M5-2
71	21	21	28	7	21	0	0.6	1000	20.389	37.108	0.5	M5-2
72	94952	95226	8207326	8112100	95792	840	0.6	1000	20.389	37.108	0.5	M5-2
75	44166	44516	3219453	3174937	44166	0	0.6	1000	20.389	37.108	0.5	M5-2
78	28951	29067	1314631	1285564	28951	0	0.6	1000	20.389	37.108	0.5	M5-2
81	110737	110805	913276	802471	110737	0	0.6	1000	20.389	37.108	0.5	M5-2
83	0	0	0	0	0	0	0.6	1000	20.389	37.108	0.5	M5-2
84	25573	25606	414505	388899	25573	0	0.6	1000	20.389	37.108	0.5	M5-2
87	5096	5109	84666	79557	5097	1	0.6	1000	20.389	37.108	0.5	M5-2
90	13299	13355	103285	89930	13299	0	0.6	1000	20.389	37.108	0.5	M5-2
100	0	0	0	0	0	0	0.6	1000	20.389	37.108	0.5	M5-2
24	308	308	6328	6020	313	5	0.6	1000	20.462	37.307	0.3	M5-3
27	16086	16095	140715	124620	16098	12	0.6	1000	20.462	37.307	0.3	M5-3
30	4858	4974	159895	154921	4860	2	0.6	1000	20.462	37.307	0.3	M5-3
31	0	0	0	0	0	0	0.6	1000	20.462	37.307	0.3	M5-3
33	7026	7263	653796	646533	7160	134	0.6	1000	20.462	37.307	0.3	M5-3
34	0	0	0	0	0	0	0.6	1000	20.462	37.307	0.3	M5-3
36	136009	137759	5295885	5158126	136219	210	0.6	1000	20.462	37.307	0.3	M5-3
39	99087	130514	10417330	10286816	99093	6	0.6	1000	20.462	37.307	0.3	M5-3
42	87525	91321	19942770	19851449	87596	71	0.6	1000	20.462	37.307	0.3	M5-3
43	0	0	0	0	0	0	0.6	1000	20.462	37.307	0.3	M5-3
44	0	0	0	0	0	0	0.6	1000	20.462	37.307	0.3	M5-3
45	124200	129250	34781970	34652720	124477	277	0.6	1000	20.462	37.307	0.3	M5-3
48	206393	210738	59094756	58884018	206457	64	0.6	1000	20.462	37.307	0.3	M5-3
49	0	0	0	0	0	0	0.6	1000	20.462	37.307	0.3	M5-3
51	491804	494281	81888003	81393722	492014	210	0.6	1000	20.462	37.307	0.3	M5-3
52	36	36	66	30	36	0	0.6	1000	20.462	37.307	0.3	M5-3
53	0	0	0	0	0	0	0.6	1000	20.462	37.307	0.3	M5-3
54	267206	269606	66119250	65849644	267611	405	0.6	1000	20.462	37.307	0.3	M5-3
55	3	3	3	0	3	0	0.6	1000	20.462	37.307	0.3	M5-3
57	162404	169285	52372495	52203210	162721	317	0.6	1000	20.462	37.307	0.3	M5-3
59	0	0	0	0	0	0	0.6	1000	20.462	37.307	0.3	M5-3
60	154325	160056	45797235	45637179	154425	100	0.6	1000	20.462	37.307	0.3	M5-3
62	0	0	0	0	0	0	0.6	1000	20.462	37.307	0.3	M5-3
63	327573	331982	34898835	34566853	327574	1	0.6	1000	20.462	37.307	0.3	M5-3
64	6	6	15	9	6	0	0.6	1000	20.462	37.307	0.3	M5-3
65	3	3	6	3	3	0	0.6	1000	20.462	37.307	0.3	M5-3
66	132769	139137	27911656	27772519	132771	2	0.6	1000	20.462	37.307	0.3	M5-3
67	0	1	3	2	0	0	0.6	1000	20.462	37.307	0.3	M5-3
68	0	0	1	1	0	0	0.6	1000	20.462	37.307	0.3	M5-3
69	242776	245464	20457606	20212142	242783	7	0.6	1000	20.462	37.307	0.3	M5-3
70	0	0	1	1	0	0	0.6	1000	20.462	37.307	0.3	M5-3
71	1	1	1	0	1	0	0.6	1000	20.462	37.307	0.3	M5-3
72	196835	198082	11421810	11223728	196837	2	0.6	1000	20.462	37.307	0.3	M5-3
75	83929	85158	4229686	4144528	83929	0	0.6	1000	20.462	37.307	0.3	M5-3
78	12475	12644	790653	778009	12475	0	0.6	1000	20.462	37.307	0.3	M5-3
79	0	0	0	0	0	0	0.6	1000	20.462	37.307	0.3	M5-3
81	67553	67564	816003	748439	67553	0	0.6	1000	20.462	37.307	0.3	M5-3
84	16901	17129	417241	400112	16901	0	0.6	1000	20.462	37.307	0.3	M5-3
87	1646	1646	29403	27757	1647	1	0.6	1000	20.462	37.307	0.3	M5-3
90	20110	20118	123753	103635	20110	0	0.6	1000	20.462	37.307	0.3	M5-3
2	0	0	0	0	0	0	0.6	1000	20.512	35.769	0.1	M5-6
9	0	0	0	0	0	0	0.6	1000	20.512	35.769	0.1	M5-6
12	0	0	0	0	0	0	0.6	1000	20.512	35.769	0.1	M5-6
14	0	0	0	0	0	0	0.6	1000	20.512	35.769	0.1	M5-6
23	0	0	0	0	0	0	0.6	1000	20.512	35.769	0.1	M5-6
24	6138	6139	39340	33201	6144	6	0.6	1000	20.512	35.769	0.1	M5-6
27	1247	1253	28203	26950	1257	10	0.6	1000	20.512	35.769	0.1	M5-6
28	0	0	0	0	0	0	0.6	1000	20.512	35.769	0.1	M5-6
30	9186	9392	330891	321499	9274	88	0.6	1000	20.512	35.769	0.1	M5-6
33	15373	15548	975106	959558	15380	7	0.6	1000	20.512	35.769	0.1	M5-6
36	23778	25335	3242331	3216996	23785	7	0.6	1000	20.512	35.769	0.1	M5-6
39	247809	291631	14207115	13915484	247811	2	0.6	1000	20.512	35.769	0.1	M5-6
40	0	0	0	0	0	0	0.6	1000	20.512	35.769	0.1	M5-6
41	0	0	1	1	0	0	0.6	1000	20.512	35.769	0.1	M5-6
42	259629	264231	32833356	32569125	260022	393	0.6	1000	20.512	35.769	0.1	M5-6
45	413888	422919	59759778	59336859	414651	763	0.6	1000	20.512	35.769	0.1	M5-6
48	508337	512948	73441140	72928192	508385	48	0.6	1000	20.512	35.769	0.1	M5-6
49	0	0	0	0	0	0	0.6	1000	20.512	35.769	0.1	M5-6
50	1	1	3	2	1	0	0.6	1000	20.512	35.769	0.1	M5-6
51	323560	336587	71670378	71333791	328667	5107	0.6	1000	20.512	35.769	0.1	M5-6
52	0	0	1	1	0	0	0.6	1000	20.512	35.769	0.1	M5-6
53	0	0	0	0	0	0	0.6	1000	20.512	35.769	0.1	M5-6
54	298827	302607	65054121	64751514	298984	157	0.6	1000	20.512	35.769	0.1	M5-6
56	0	0	1	1	0	0	0.6	1000	20.512	35.769	0.1	M5-6
57	138434	146321	47292675	47146354	139887	1453	0.6	1000	20.512	35.769	0.1	M5-6
58	0	0	1	1	0	0	0.6	1000	20.512	35.769	0.1	M5-6
59	0	0	0	0	0	0	0.6	1000	20.512	35.769	0.1	M5-6
60	277705	293561	49625703	49332142	277878	173	0.6	1000	20.512	35.769	0.1	M5-6
62	0	0	0	0	0	0	0.6	1000	20.512	35.769	0.1	M5-6
63	430320	464512	45120250	44655738	430352	32	0.6	1000	20.512	35.769	0.1	M5-6
64	0	0	3	3	0	0	0.6	1000	20.512	35.769	0.1	M5-6
65	0	0	0	0	0	0	0.6	1000	20.512	35.769	0.1	M5-6
66	140999	145281	21069786	20924505	141005	6	0.6	1000	20.512	35.769	0.1	M5-6
68	0	0	1	1	0	0	0.6	1000	20.512	35.769	0.1	M5-6
69	59913	62053	12647935	12585882	62387	2474	0.6	1000	20.512	35.769	0.1	M5-6
71	0	0	0	0	0	0	0.6	1000	20.512	35.769	0.1	M5-6
72	80802	82032	9607536	9525504	80805	3	0.6	1000	20.512	35.769	0.1	M5-6
75	62902	67076	4261740	4194664	63226	324	0.6	1000	20.512	35.769	0.1	M5-6
78	29425	29908	1514670	1484762	29427	2	0.6	1000	20.512	35.769	0.1	M5-6
80	0	0	0	0	0	0	0.6	1000	20.512	35.769	0.1	M5-6
81	17566	17584	406351	388767	17566	0	0.6	1000	20.512	35.769	0.1	M5-6
83	0	0	0	0	0	0	0.6	1000	20.512	35.769	0.1	M5-6
84	4674	4779	160461	155682	4674	0	0.6	1000	20.512	35.769	0.1	M5-6
87	16514	16514	77815	61301	16514	0	0.6	1000	20.512	35.769	0.1	M5-6
90	643	644	9870	9226	643	0	0.6	1000	20.512	35.769	0.1	M5-6
3	0	0	1	1	0	0	0.6	1000	20.534	36.65	0.3	M5-5
24	6037	10078	57291	47213	6057	20	0.6	1000	20.534	36.65	0.3	M5-5
27	1746	1747	18528	16781	1765	19	0.6	1000	20.534	36.65	0.3	M5-5
29	0	0	0	0	0	0	0.6	1000	20.534	36.65	0.3	M5-5
30	5098	5147	212226	207079	5619	521	0.6	1000	20.534	36.65	0.3	M5-5
32	0	0	0	0	0	0	0.6	1000	20.534	36.65	0.3	M5-5
33	43556	45315	1771903	1726588	43614	58	0.6	1000	20.534	36.65	0.3	M5-5
36	80282	86887	5282875	5195988	80287	5	0.6	1000	20.534	36.65	0.3	M5-5
39	201799	203840	14935845	14732005	201805	6	0.6	1000	20.534	36.65	0.3	M5-5
42	380933	384044	34999161	34615117	381062	129	0.6	1000	20.534	36.65	0.3	M5-5
45	378233	384335	49237926	48853591	378319	86	0.6	1000	20.534	36.65	0.3	M5-5
47	1	1	1	0	1	0	0.6	1000	20.534	36.65	0.3	M5-5
48	314404	316394	67738980	67422586	314685	281	0.6	1000	20.534	36.65	0.3	M5-5
49	0	0	1	1	0	0	0.6	1000	20.534	36.65	0.3	M5-5
50	0	0	0	0	0	0	0.6	1000	20.534	36.65	0.3	M5-5
51	140561	142966	58509153	58366187	140811	250	0.6	1000	20.534	36.65	0.3	M5-5
53	0	0	0	0	0	0	0.6	1000	20.534	36.65	0.3	M5-5
54	576817	608203	66857266	66249063	576905	88	0.6	1000	20.534	36.65	0.3	M5-5
55	0	0	1	1	0	0	0.6	1000	20.534	36.65	0.3	M5-5
56	0	0	0	0	0	0	0.6	1000	20.534	36.65	0.3	M5-5
57	193752	198194	56716575	56518381	198325	4573	0.6	1000	20.534	36.65	0.3	M5-5
58	210	210	210	0	210	0	0.6	1000	20.534	36.65	0.3	M5-5
59	4	9	21	12	4	0	0.6	1000	20.534	36.65	0.3	M5-5
60	225403	231970	41546170	41314200	225409	6	0.6	1000	20.534	36.65	0.3	M5-5
61	0	0	0	0	0	0	0.6	1000	20.534	36.65	0.3	M5-5
62	0	0	0	0	0	0	0.6	1000	20.534	36.65	0.3	M5-5
63	119831	129043	32453596	32324553	119860	29	0.6	1000	20.534	36.65	0.3	M5-5
64	0	0	1	1	0	0	0.6	1000	20.534	36.65	0.3	M5-5
66	176257	178578	24454521	24275943	176261	4	0.6	1000	20.534	36.65	0.3	M5-5
67	0	0	0	0	0	0	0.6	1000	20.534	36.65	0.3	M5-5
69	207406	214049	22906296	22692247	207467	61	0.6	1000	20.534	36.65	0.3	M5-5
70	0	0	0	0	0	0	0.6	1000	20.534	36.65	0.3	M5-5
72	138653	139273	8957028	8817755	138893	240	0.6	1000	20.534	36.65	0.3	M5-5
73	1	1	3	2	1	0	0.6	1000	20.534	36.65	0.3	M5-5
74	0	0	0	0	0	0	0.6	1000	20.534	36.65	0.3	M5-5
75	51317	51646	4394130	4342484	51319	2	0.6	1000	20.534	36.65	0.3	M5-5
78	19119	19451	1023165	1003714	19119	0	0.6	1000	20.534	36.65	0.3	M5-5
81	21179	21248	727821	706573	21179	0	0.6	1000	20.534	36.65	0.3	M5-5
84	10703	10715	200661	189946	10703	0	0.6	1000	20.534	36.65	0.3	M5-5
87	6286	6313	99681	93368	6286	0	0.6	1000	20.534	36.65	0.3	M5-5
90	8355	9423	70125	60702	8355	0	0.6	1000	20.534	36.65	0.3	M5-5
2	0	0	0	0	0	0	0.6	1000	20.6	38.727	0.3	M5-9
24	177	177	6786	6609	183	6	0.6	1000	20.6	38.727	0.3	M5-9
27	725	737	23871	23134	725	0	0.6	1000	20.6	38.727	0.3	M5-9
30	6565	6576	241165	234589	6575	10	0.6	1000	20.6	38.727	0.3	M5-9
33	200529	201488	2189278	1987790	200535	6	0.6	1000	20.6	38.727	0.3	M5-9
36	56540	57215	3491403	3434188	56548	8	0.6	1000	20.6	38.727	0.3	M5-9
37	0	0	0	0	0	0	0.6	1000	20.6	38.727	0.3	M5-9
39	29731	36069	7378561	7342492	29748	17	0.6	1000	20.6	38.727	0.3	M5-9
42	132971	137222	23780856	23643634	133101	130	0.6	1000	20.6	38.727	0.3	M5-9
44	0	0	0	0	0	0	0.6	1000	20.6	38.727	0.3	M5-9
45	102268	104239	35604141	35499902	102362	94	0.6	1000	20.6	38.727	0.3	M5-9
48	213231	216627	55762080	55545453	213264	33	0.6	1000	20.6	38.727	0.3	M5-9
49	0	0	0	0	0	0	0.6	1000	20.6	38.727	0.3	M5-9
50	190	190	210	20	190	0	0.6	1000	20.6	38.727	0.3	M5-9
51	436653	441159	87615703	87174544	436860	207	0.6	1000	20.6	38.727	0.3	M5-9
52	3	3	15	12	3	0	0.6	1000	20.6	38.727	0.3	M5-9
54	328841	332560	79046451	78713891	328964	123	0.6	1000	20.6	38.727	0.3	M5-9
55	0	0	0	0	0	0	0.6	1000	20.6	38.727	0.3	M5-9
57	227137	239552	57111328	56871776	227865	728	0.6	1000	20.6	38.727	0.3	M5-9
60	704910	725573	75885040	75159467	704951	41	0.6	1000	20.6	38.727	0.3	M5-9
63	177588	178994	30862296	30683302	179066	1478	0.6	1000	20.6	38.727	0.3	M5-9
64	1	1	1	0	1	0	0.6	1000	20.6	38.727	0.3	M5-9
65	0	0	0	0	0	0	0.6	1000	20.6	38.727	0.3	M5-9
66	276958	278881	26082253	25803372	276958	0	0.6	1000	20.6	38.727	0.3	M5-9
67	0	0	0	0	0	0	0.6	1000	20.6	38.727	0.3	M5-9
68	0	0	0	0	0	0	0.6	1000	20.6	38.727	0.3	M5-9
69	118535	121659	11231430	11109771	118568	33	0.6	1000	20.6	38.727	0.3	M5-9
71	0	0	0	0	0	0	0.6	1000	20.6	38.727	0.3	M5-9
72	184840	185224	11768526	11583302	184847	7	0.6	1000	20.6	38.727	0.3	M5-9
75	37773	38610	3121251	3082641	37773	0	0.6	1000	20.6	38.727	0.3	M5-9
78	29534	29894	1483503	1453609	29534	0	0.6	1000	20.6	38.727	0.3	M5-9
79	2278	2278	2278	0	2278	0	0.6	1000	20.6	38.727	0.3	M5-9
81	64663	64982	1242676	1177694	64663	0	0.6	1000	20.6	38.727	0.3	M5-9
82	1	1	1	0	1	0	0.6	1000	20.6	38.727	0.3	M5-9
83	0	0	1	1	0	0	0.6	1000	20.6	38.727	0.3	M5-9
84	3502	3530	134940	131410	3502	0	0.6	1000	20.6	38.727	0.3	M5-9
87	3860	3861	67528	63667	3860	0	0.6	1000	20.6	38.727	0.3	M5-9
90	3033	3033	28441	25408	3033	0	0.6	1000	20.6	38.727	0.3	M5-9
3	0	0	3	3	3	3	0.6	1000	20.927	35.122	0.1	M2-3
18	0	0	0	0	0	0	0.6	1000	20.927	35.122	0.1	M2-3
24	79	81	17205	17124	90	11	0.6	1000	20.927	35.122	0.1	M2-3
27	95	95	32385	32290	129	34	0.6	1000	20.927	35.122	0.1	M2-3
30	256	256	73920	73664	285	29	0.6	1000	20.927	35.122	0.1	M2-3
33	4273	4281	524800	520519	4295	22	0.6	1000	20.927	35.122	0.1	M2-3
36	3093	3184	1449253	1446069	3122	29	0.6	1000	20.927	35.122	0.1	M2-3
39	21546	21847	5189031	5167184	21574	28	0.6	1000	20.927	35.122	0.1	M2-3
42	7656	8039	10656036	10647997	8251	595	0.6	1000	20.927	35.122	0.1	M2-3
45	18487	18762	15615666	15596904	18889	402	0.6	1000	20.927	35.122	0.1	M2-3
48	19913	20667	21362916	21342249	20032	119	0.6	1000	20.927	35.122	0.1	M2-3
49	0	0	0	0	0	0	0.6	1000	20.927	35.122	0.1	M2-3
51	20922	21389	27598735	27577346	21194	272	0.6	1000	20.927	35.122	0.1	M2-3
54	14721	15480	20778681	20763201	14825	104	0.6	1000	20.927	35.122	0.1	M2-3
55	0	0	6	6	0	0	0.6	1000	20.927	35.122	0.1	M2-3
56	0	0	0	0	0	0	0.6	1000	20.927	35.122	0.1	M2-3
57	11702	12319	19980681	19968362	12307	605	0.6	1000	20.927	35.122	0.1	M2-3
58	0	0	0	0	0	0	0.6	1000	20.927	35.122	0.1	M2-3
60	34722	35327	20272528	20237201	34780	58	0.6	1000	20.927	35.122	0.1	M2-3
62	0	0	0	0	0	0	0.6	1000	20.927	35.122	0.1	M2-3
63	31277	31663	14658405	14626742	31561	284	0.6	1000	20.927	35.122	0.1	M2-3
65	0	0	1	1	0	0	0.6	1000	20.927	35.122	0.1	M2-3
66	7547	7934	8256016	8248082	7559	12	0.6	1000	20.927	35.122	0.1	M2-3
69	47512	47737	6285285	6237548	47637	125	0.6	1000	20.927	35.122	0.1	M2-3
70	0	0	0	0	0	0	0.6	1000	20.927	35.122	0.1	M2-3
71	0	0	0	0	0	0	0.6	1000	20.927	35.122	0.1	M2-3
72	25235	25428	4238416	4212988	25252	17	0.6	1000	20.927	35.122	0.1	M2-3
75	2896	2941	1059240	1056299	2906	10	0.6	1000	20.927	35.122	0.1	M2-3
76	0	0	0	0	0	0	0.6	1000	20.927	35.122	0.1	M2-3
78	527	529	423660	423131	536	9	0.6	1000	20.927	35.122	0.1	M2-3
81	3750	3750	349030	345280	3750	0	0.6	1000	20.927	35.122	0.1	M2-3
84	881	881	125250	124369	881	0	0.6	1000	20.927	35.122	0.1	M2-3
87	363	363	31626	31263	363	0	0.6	1000	20.927	35.122	0.1	M2-3
90	19	19	11476	11457	19	0	0.6	1000	20.927	35.122	0.1	M2-3
24	101957	102152	254541	152389	101957	0	0.6	1000	20.943	37.389	0.3	M5-8
27	118718	118718	318801	200083	118718	0	0.6	1000	20.943	37.389	0.3	M5-8
30	2188	2234	135981	133747	2202	14	0.6	1000	20.943	37.389	0.3	M5-8
33	26665	27746	1319500	1291754	26674	9	0.6	1000	20.943	37.389	0.3	M5-8
35	0	0	0	0	0	0	0.6	1000	20.943	37.389	0.3	M5-8
36	57374	57821	2951235	2893414	57386	12	0.6	1000	20.943	37.389	0.3	M5-8
39	156117	158036	12890503	12732467	156230	113	0.6	1000	20.943	37.389	0.3	M5-8
41	0	0	0	0	0	0	0.6	1000	20.943	37.389	0.3	M5-8
42	262442	269184	28618395	28349211	262491	49	0.6	1000	20.943	37.389	0.3	M5-8
45	307536	311238	45768528	45457290	308224	688	0.6	1000	20.943	37.389	0.3	M5-8
46	0	0	0	0	0	0	0.6	1000	20.943	37.389	0.3	M5-8
47	21	21	28	7	21	0	0.6	1000	20.943	37.389	0.3	M5-8
48	379359	383779	64553203	64169424	379419	60	0.6	1000	20.943	37.389	0.3	M5-8
49	6	6	15	9	6	0	0.6	1000	20.943	37.389	0.3	M5-8
50	0	0	0	0	0	0	0.6	1000	20.943	37.389	0.3	M5-8
51	222221	224402	60428521	60204119	222287	66	0.6	1000	20.943	37.389	0.3	M5-8
52	1	1	1	0	1	0	0.6	1000	20.943	37.389	0.3	M5-8
53	0	0	1	1	0	0	0.6	1000	20.943	37.389	0.3	M5-8
54	228414	230638	57657691	57427053	228501	87	0.6	1000	20.943	37.389	0.3	M5-8
55	1	1	6	5	1	0	0.6	1000	20.943	37.389	0.3	M5-8
57	332284	334699	68357278	68022579	332529	245	0.6	1000	20.943	37.389	0.3	M5-8
60	410330	413840	62580078	62166238	410341	11	0.6	1000	20.943	37.389	0.3	M5-8
63	246853	248261	45205786	44957525	246858	5	0.6	1000	20.943	37.389	0.3	M5-8
64	0	0	0	0	0	0	0.6	1000	20.943	37.389	0.3	M5-8
65	0	0	0	0	0	0	0.6	1000	20.943	37.389	0.3	M5-8
66	275590	277979	24454521	24176542	275605	15	0.6	1000	20.943	37.389	0.3	M5-8
69	124216	125482	16459453	16333971	124217	1	0.6	1000	20.943	37.389	0.3	M5-8
72	126299	128582	8398851	8270269	126306	7	0.6	1000	20.943	37.389	0.3	M5-8
75	16821	17750	2577585	2559835	16822	1	0.6	1000	20.943	37.389	0.3	M5-8
77	0	0	0	0	0	0	0.6	1000	20.943	37.389	0.3	M5-8
78	30822	32051	1121253	1089202	30823	1	0.6	1000	20.943	37.389	0.3	M5-8
79	3	3	3	0	3	0	0.6	1000	20.943	37.389	0.3	M5-8
81	18564	18604	523776	505172	18565	1	0.6	1000	20.943	37.389	0.3	M5-8
82	0	0	0	0	0	0	0.6	1000	20.943	37.389	0.3	M5-8
84	21170	21184	356590	335406	21170	0	0.6	1000	20.943	37.389	0.3	M5-8
87	1161	1193	59340	58147	1161	0	0.6	1000	20.943	37.389	0.3	M5-8
90	1001	1001	14196	13195	1001	0	0.6	1000	20.943	37.389	0.3	M5-8
24	308	308	6328	6020	313	5	0.6	1000	20.977	37.11	0.5	M5-3
27	16086	16095	140715	124620	16098	12	0.6	1000	20.977	37.11	0.5	M5-3
30	4858	4974	159895	154921	4860	2	0.6	1000	20.977	37.11	0.5	M5-3
31	0	0	0	0	0	0	0.6	1000	20.977	37.11	0.5	M5-3
33	7026	7263	653796	646533	7160	134	0.6	1000	20.977	37.11	0.5	M5-3
34	0	0	0	0	0	0	0.6	1000	20.977	37.11	0.5	M5-3
36	136194	137759	5295885	5158126	136404	210	0.6	1000	20.977	37.11	0.5	M5-3
39	99521	130514	10417330	10286816	99529	8	0.6	1000	20.977	37.11	0.5	M5-3
42	89361	91321	19942770	19851449	89424	63	0.6	1000	20.977	37.11	0.5	M5-3
43	0	0	0	0	0	0	0.6	1000	20.977	37.11	0.5	M5-3
44	0	0	0	0	0	0	0.6	1000	20.977	37.11	0.5	M5-3
45	126128	129250	34781970	34652720	126522	394	0.6	1000	20.977	37.11	0.5	M5-3
48	207351	210738	59094756	58884018	207415	64	0.6	1000	20.977	37.11	0.5	M5-3
49	0	0	0	0	0	0	0.6	1000	20.977	37.11	0.5	M5-3
51	491777	494281	81888003	81393722	491984	207	0.6	1000	20.977	37.11	0.5	M5-3
52	36	36	66	30	36	0	0.6	1000	20.977	37.11	0.5	M5-3
53	0	0	0	0	0	0	0.6	1000	20.977	37.11	0.5	M5-3
54	262724	269606	66119250	65849644	262865	141	0.6	1000	20.977	37.11	0.5	M5-3
55	3	3	3	0	3	0	0.6	1000	20.977	37.11	0.5	M5-3
57	163918	169285	52372495	52203210	164235	317	0.6	1000	20.977	37.11	0.5	M5-3
59	0	0	0	0	0	0	0.6	1000	20.977	37.11	0.5	M5-3
60	155140	160056	45797235	45637179	155241	101	0.6	1000	20.977	37.11	0.5	M5-3
62	0	0	0	0	0	0	0.6	1000	20.977	37.11	0.5	M5-3
63	328454	331982	34898835	34566853	328455	1	0.6	1000	20.977	37.11	0.5	M5-3
64	6	6	15	9	6	0	0.6	1000	20.977	37.11	0.5	M5-3
65	3	3	6	3	3	0	0.6	1000	20.977	37.11	0.5	M5-3
66	132875	139137	27911656	27772519	132875	0	0.6	1000	20.977	37.11	0.5	M5-3
67	0	1	3	2	0	0	0.6	1000	20.977	37.11	0.5	M5-3
68	0	0	1	1	0	0	0.6	1000	20.977	37.11	0.5	M5-3
69	244278	245464	20457606	20212142	244285	7	0.6	1000	20.977	37.11	0.5	M5-3
70	0	0	1	1	0	0	0.6	1000	20.977	37.11	0.5	M5-3
71	1	1	1	0	1	0	0.6	1000	20.977	37.11	0.5	M5-3
72	196410	198082	11421810	11223728	196646	236	0.6	1000	20.977	37.11	0.5	M5-3
75	83983	85158	4229686	4144528	83983	0	0.6	1000	20.977	37.11	0.5	M5-3
78	12475	12644	790653	778009	12475	0	0.6	1000	20.977	37.11	0.5	M5-3
79	0	0	0	0	0	0	0.6	1000	20.977	37.11	0.5	M5-3
81	67553	67564	816003	748439	67553	0	0.6	1000	20.977	37.11	0.5	M5-3
84	16901	17129	417241	400112	16901	0	0.6	1000	20.977	37.11	0.5	M5-3
87	1646	1646	29403	27757	1647	1	0.6	1000	20.977	37.11	0.5	M5-3
90	20110	20118	123753	103635	20110	0	0.6	1000	20.977	37.11	0.5	M5-3
3	0	0	0	0	0	0	0.6	1000	21.018	34.624	0.1	M2-1
12	1	1	1	0	1	0	0.6	1000	21.018	34.624	0.1	M2-1
15	0	0	0	0	0	0	0.6	1000	21.018	34.624	0.1	M2-1
24	80	80	17391	17311	132	52	0.6	1000	21.018	34.624	0.1	M2-1
27	58	58	20706	20648	65	7	0.6	1000	21.018	34.624	0.1	M2-1
30	316	317	102831	102514	326	10	0.6	1000	21.018	34.624	0.1	M2-1
33	760	781	571915	571134	808	48	0.6	1000	21.018	34.624	0.1	M2-1
36	1387	1518	1530375	1528857	1449	62	0.6	1000	21.018	34.624	0.1	M2-1
39	13223	13402	4501500	4488098	13279	56	0.6	1000	21.018	34.624	0.1	M2-1
41	0	0	0	0	0	0	0.6	1000	21.018	34.624	0.1	M2-1
42	28310	28588	10010575	9981987	28426	116	0.6	1000	21.018	34.624	0.1	M2-1
43	0	0	1	1	0	0	0.6	1000	21.018	34.624	0.1	M2-1
45	14696	15621	16522626	16507005	14894	198	0.6	1000	21.018	34.624	0.1	M2-1
46	0	0	1	1	0	0	0.6	1000	21.018	34.624	0.1	M2-1
48	31684	32345	24398605	24366260	31853	169	0.6	1000	21.018	34.624	0.1	M2-1
51	13636	14167	23988201	23974034	13940	304	0.6	1000	21.018	34.624	0.1	M2-1
52	0	0	0	0	0	0	0.6	1000	21.018	34.624	0.1	M2-1
54	33605	34863	24217320	24182457	33681	76	0.6	1000	21.018	34.624	0.1	M2-1
55	0	0	0	0	0	0	0.6	1000	21.018	34.624	0.1	M2-1
57	28019	28771	23932821	23904050	28871	852	0.6	1000	21.018	34.624	0.1	M2-1
58	0	0	0	0	0	0	0.6	1000	21.018	34.624	0.1	M2-1
59	0	0	1	1	0	0	0.6	1000	21.018	34.624	0.1	M2-1
60	13619	14059	16869336	16855277	13694	75	0.6	1000	21.018	34.624	0.1	M2-1
61	0	0	0	0	0	0	0.6	1000	21.018	34.624	0.1	M2-1
62	0	0	0	0	0	0	0.6	1000	21.018	34.624	0.1	M2-1
63	19628	19873	11608971	11589098	19676	48	0.6	1000	21.018	34.624	0.1	M2-1
64	0	0	0	0	0	0	0.6	1000	21.018	34.624	0.1	M2-1
66	42348	42563	7755891	7713328	42363	15	0.6	1000	21.018	34.624	0.1	M2-1
68	0	0	0	0	0	0	0.6	1000	21.018	34.624	0.1	M2-1
69	2549	2772	4928230	4925458	2578	29	0.6	1000	21.018	34.624	0.1	M2-1
72	2605	2716	2248260	2245544	2623	18	0.6	1000	21.018	34.624	0.1	M2-1
73	0	0	1	1	0	0	0.6	1000	21.018	34.624	0.1	M2-1
75	165656	166303	2494261	2327958	165659	3	0.6	1000	21.018	34.624	0.1	M2-1
78	606	617	541320	540703	626	20	0.6	1000	21.018	34.624	0.1	M2-1
81	18083	18097	402753	384656	18083	0	0.6	1000	21.018	34.624	0.1	M2-1
84	295	296	95703	95407	295	0	0.6	1000	21.018	34.624	0.1	M2-1
87	93	102	20100	19998	93	0	0.6	1000	21.018	34.624	0.1	M2-1
90	2	2	9045	9043	2	0	0.6	1000	21.018	34.624	0.1	M2-1
3	0	0	0	0	0	0	0.6	1000	21.185	34.657	0.1	M2-9
6	0	0	1	1	0	0	0.6	1000	21.185	34.657	0.1	M2-9
24	209	209	20910	20701	217	8	0.6	1000	21.185	34.657	0.1	M2-9
27	36	36	17205	17169	68	32	0.6	1000	21.185	34.657	0.1	M2-9
30	48	51	61075	61024	63	15	0.6	1000	21.185	34.657	0.1	M2-9
33	2563	2574	590241	587667	2578	15	0.6	1000	21.185	34.657	0.1	M2-9
36	18108	18529	1418770	1400241	18191	83	0.6	1000	21.185	34.657	0.1	M2-9
39	3829	4104	3766140	3762036	3853	24	0.6	1000	21.185	34.657	0.1	M2-9
41	0	0	0	0	0	0	0.6	1000	21.185	34.657	0.1	M2-9
42	24475	25026	10476753	10451727	26472	1997	0.6	1000	21.185	34.657	0.1	M2-9
44	0	0	0	0	0	0	0.6	1000	21.185	34.657	0.1	M2-9
45	17920	18311	16730220	16711909	18151	231	0.6	1000	21.185	34.657	0.1	M2-9
48	7344	7820	22147840	22140020	7464	120	0.6	1000	21.185	34.657	0.1	M2-9
49	0	0	0	0	0	0	0.6	1000	21.185	34.657	0.1	M2-9
51	34831	36066	26415546	26379480	35185	354	0.6	1000	21.185	34.657	0.1	M2-9
52	0	0	0	0	0	0	0.6	1000	21.185	34.657	0.1	M2-9
54	35857	36466	24608620	24572154	36020	163	0.6	1000	21.185	34.657	0.1	M2-9
55	0	0	1	1	0	0	0.6	1000	21.185	34.657	0.1	M2-9
57	29795	30222	22028203	21997981	30304	509	0.6	1000	21.185	34.657	0.1	M2-9
59	0	0	0	0	0	0	0.6	1000	21.185	34.657	0.1	M2-9
60	14946	15311	16476670	16461359	15001	55	0.6	1000	21.185	34.657	0.1	M2-9
61	0	0	3	3	0	0	0.6	1000	21.185	34.657	0.1	M2-9
63	7769	8154	11899881	11891727	7788	19	0.6	1000	21.185	34.657	0.1	M2-9
66	53900	54409	9899025	9844616	53905	5	0.6	1000	21.185	34.657	0.1	M2-9
69	4764	5033	5260146	5255113	4803	39	0.6	1000	21.185	34.657	0.1	M2-9
72	7289	7701	2995128	2987427	7398	109	0.6	1000	21.185	34.657	0.1	M2-9
75	1935	2025	1343980	1341955	1949	14	0.6	1000	21.185	34.657	0.1	M2-9
78	650	651	435711	435060	654	4	0.6	1000	21.185	34.657	0.1	M2-9
81	801	803	208335	207532	802	1	0.6	1000	21.185	34.657	0.1	M2-9
84	1170	1170	133386	132216	1172	2	0.6	1000	21.185	34.657	0.1	M2-9
87	200	200	21945	21745	200	0	0.6	1000	21.185	34.657	0.1	M2-9
90	127	127	16471	16344	128	1	0.6	1000	21.185	34.657	0.1	M2-9
9	0	0	0	0	0	0	0.6	1000	21.225	36.367	0.3	M5-10
24	4023	4025	51681	47656	4023	0	0.6	1000	21.225	36.367	0.3	M5-10
27	2691	2691	42778	40087	2691	0	0.6	1000	21.225	36.367	0.3	M5-10
28	0	0	0	0	0	0	0.6	1000	21.225	36.367	0.3	M5-10
30	5642	5687	220780	215093	5642	0	0.6	1000	21.225	36.367	0.3	M5-10
33	74184	75175	1973091	1897916	74191	7	0.6	1000	21.225	36.367	0.3	M5-10
34	1	1	1	0	1	0	0.6	1000	21.225	36.367	0.3	M5-10
36	69664	70553	4850055	4779502	69675	11	0.6	1000	21.225	36.367	0.3	M5-10
38	3	3	3	0	3	0	0.6	1000	21.225	36.367	0.3	M5-10
39	82357	94977	11536806	11441829	82365	8	0.6	1000	21.225	36.367	0.3	M5-10
42	177072	178861	27117930	26939069	177220	148	0.6	1000	21.225	36.367	0.3	M5-10
45	409532	413139	47438670	47025531	409846	314	0.6	1000	21.225	36.367	0.3	M5-10
46	0	0	1	1	0	0	0.6	1000	21.225	36.367	0.3	M5-10
48	289789	292743	58584900	58292157	289837	48	0.6	1000	21.225	36.367	0.3	M5-10
51	423027	426369	82593378	82167009	423500	473	0.6	1000	21.225	36.367	0.3	M5-10
52	0	0	1	1	0	0	0.6	1000	21.225	36.367	0.3	M5-10
54	156859	162520	53618190	53455670	156999	140	0.6	1000	21.225	36.367	0.3	M5-10
56	0	0	0	0	0	0	0.6	1000	21.225	36.367	0.3	M5-10
57	373573	388265	62010816	61622551	373855	282	0.6	1000	21.225	36.367	0.3	M5-10
58	0	0	0	0	0	0	0.6	1000	21.225	36.367	0.3	M5-10
59	0	0	0	0	0	0	0.6	1000	21.225	36.367	0.3	M5-10
60	396420	398622	51171786	50773164	396449	29	0.6	1000	21.225	36.367	0.3	M5-10
63	317322	323841	37320480	36996639	317415	93	0.6	1000	21.225	36.367	0.3	M5-10
64	0	0	0	0	0	0	0.6	1000	21.225	36.367	0.3	M5-10
65	0	0	0	0	0	0	0.6	1000	21.225	36.367	0.3	M5-10
66	115873	120664	25300941	25180277	115980	107	0.6	1000	21.225	36.367	0.3	M5-10
69	152641	158025	18816045	18658020	152642	1	0.6	1000	21.225	36.367	0.3	M5-10
70	0	0	1	1	0	0	0.6	1000	21.225	36.367	0.3	M5-10
71	1	1	1	0	1	0	0.6	1000	21.225	36.367	0.3	M5-10
72	198732	203877	10499653	10295776	198789	57	0.6	1000	21.225	36.367	0.3	M5-10
75	56557	57625	3584503	3526878	56557	0	0.6	1000	21.225	36.367	0.3	M5-10
78	28768	29049	1492128	1463079	28768	0	0.6	1000	21.225	36.367	0.3	M5-10
81	5657	5697	324415	318718	5664	7	0.6	1000	21.225	36.367	0.3	M5-10
84	22261	22546	234270	211724	22261	0	0.6	1000	21.225	36.367	0.3	M5-10
87	861	866	42195	41329	881	20	0.6	1000	21.225	36.367	0.3	M5-10
89	0	0	0	0	0	0	0.6	1000	21.225	36.367	0.3	M5-10
90	8671	8673	50086	41413	8671	0	0.6	1000	21.225	36.367	0.3	M5-10
3	0	0	1	1	1	1	0.6	1000	21.447	35.327	0.1	M2-5
6	0	0	0	0	0	0	0.6	1000	21.447	35.327	0.1	M2-5
21	0	0	0	0	0	0	0.6	1000	21.447	35.327	0.1	M2-5
24	79	79	14878	14799	89	10	0.6	1000	21.447	35.327	0.1	M2-5
27	341	341	31375	31034	363	22	0.6	1000	21.447	35.327	0.1	M2-5
29	0	0	0	0	0	0	0.6	1000	21.447	35.327	0.1	M2-5
30	1950	1952	144991	143039	1978	28	0.6	1000	21.447	35.327	0.1	M2-5
33	568	582	456490	455908	594	26	0.6	1000	21.447	35.327	0.1	M2-5
36	878	975	1390278	1389303	933	55	0.6	1000	21.447	35.327	0.1	M2-5
39	19638	20025	4766328	4746303	19681	43	0.6	1000	21.447	35.327	0.1	M2-5
42	14382	14738	8729931	8715193	14616	234	0.6	1000	21.447	35.327	0.1	M2-5
43	0	0	0	0	0	0	0.6	1000	21.447	35.327	0.1	M2-5
45	10581	11227	14228445	14217218	10855	274	0.6	1000	21.447	35.327	0.1	M2-5
48	9623	10242	20972526	20962284	9780	157	0.6	1000	21.447	35.327	0.1	M2-5
50	0	0	1	1	0	0	0.6	1000	21.447	35.327	0.1	M2-5
51	55203	55910	26038936	25983026	55382	179	0.6	1000	21.447	35.327	0.1	M2-5
54	12528	12924	20444815	20431891	12592	64	0.6	1000	21.447	35.327	0.1	M2-5
57	26747	27415	23553816	23526401	27150	403	0.6	1000	21.447	35.327	0.1	M2-5
59	0	0	0	0	0	0	0.6	1000	21.447	35.327	0.1	M2-5
60	19826	20205	18063055	18042850	19904	78	0.6	1000	21.447	35.327	0.1	M2-5
62	0	0	0	0	0	0	0.6	1000	21.447	35.327	0.1	M2-5
63	48282	48491	13694761	13646270	48330	48	0.6	1000	21.447	35.327	0.1	M2-5
65	1	1	1	0	1	0	0.6	1000	21.447	35.327	0.1	M2-5
66	5568	6063	8600878	8594815	5576	8	0.6	1000	21.447	35.327	0.1	M2-5
69	21273	21721	6317235	6295514	21339	66	0.6	1000	21.447	35.327	0.1	M2-5
70	0	0	0	0	0	0	0.6	1000	21.447	35.327	0.1	M2-5
72	167024	167137	4937653	4770516	167058	34	0.6	1000	21.447	35.327	0.1	M2-5
73	0	0	0	0	0	0	0.6	1000	21.447	35.327	0.1	M2-5
75	5177	5280	1261666	1256386	5218	41	0.6	1000	21.447	35.327	0.1	M2-5
77	0	0	0	0	0	0	0.6	1000	21.447	35.327	0.1	M2-5
78	5042	5048	623286	618238	5054	12	0.6	1000	21.447	35.327	0.1	M2-5
81	620	620	277140	276520	622	2	0.6	1000	21.447	35.327	0.1	M2-5
84	125	125	83028	82903	125	0	0.6	1000	21.447	35.327	0.1	M2-5
87	652	652	41041	40389	653	1	0.6	1000	21.447	35.327	0.1	M2-5
89	0	0	0	0	0	0	0.6	1000	21.447	35.327	0.1	M2-5
90	10	10	12880	12870	10	0	0.6	1000	21.447	35.327	0.1	M2-5
3	1	1	1	0	1	0	0.6	1000	21.454	35.431	0.1	M2-10
9	0	0	0	0	0	0	0.6	1000	21.454	35.431	0.1	M2-10
19	0	0	0	0	0	0	0.6	1000	21.454	35.431	0.1	M2-10
24	33	33	8001	7968	41	8	0.6	1000	21.454	35.431	0.1	M2-10
27	541	541	31125	30584	558	17	0.6	1000	21.454	35.431	0.1	M2-10
30	111	111	61425	61314	113	2	0.6	1000	21.454	35.431	0.1	M2-10
33	623	633	440391	439758	659	36	0.6	1000	21.454	35.431	0.1	M2-10
36	14133	14296	1486950	1472654	14165	32	0.6	1000	21.454	35.431	0.1	M2-10
39	5862	6050	4680270	4674220	5882	20	0.6	1000	21.454	35.431	0.1	M2-10
41	0	0	0	0	0	0	0.6	1000	21.454	35.431	0.1	M2-10
42	6567	7127	9311770	9304643	6827	260	0.6	1000	21.454	35.431	0.1	M2-10
44	0	0	0	0	0	0	0.6	1000	21.454	35.431	0.1	M2-10
45	24494	24931	16316328	16291397	24764	270	0.6	1000	21.454	35.431	0.1	M2-10
46	1	1	1	0	1	0	0.6	1000	21.454	35.431	0.1	M2-10
48	10043	10625	22967253	22956628	10206	163	0.6	1000	21.454	35.431	0.1	M2-10
49	0	0	0	0	0	0	0.6	1000	21.454	35.431	0.1	M2-10
51	176372	176809	31311741	31134932	178919	2547	0.6	1000	21.454	35.431	0.1	M2-10
54	61813	62208	24489501	24427293	61897	84	0.6	1000	21.454	35.431	0.1	M2-10
56	0	0	0	0	0	0	0.6	1000	21.454	35.431	0.1	M2-10
57	11363	11673	18274035	18262362	11966	603	0.6	1000	21.454	35.431	0.1	M2-10
60	20592	21036	16944931	16923895	20647	55	0.6	1000	21.454	35.431	0.1	M2-10
62	0	0	0	0	0	0	0.6	1000	21.454	35.431	0.1	M2-10
63	10019	10526	13007550	12997024	10122	103	0.6	1000	21.454	35.431	0.1	M2-10
66	9741	10022	9721845	9711823	9748	7	0.6	1000	21.454	35.431	0.1	M2-10
69	45298	46472	7478778	7432306	45360	62	0.6	1000	21.454	35.431	0.1	M2-10
72	1817	1948	2648451	2646503	1884	67	0.6	1000	21.454	35.431	0.1	M2-10
73	0	0	0	0	0	0	0.6	1000	21.454	35.431	0.1	M2-10
75	17640	17696	1433971	1416275	17650	10	0.6	1000	21.454	35.431	0.1	M2-10
78	640	645	536130	535485	655	15	0.6	1000	21.454	35.431	0.1	M2-10
79	0	0	0	0	0	0	0.6	1000	21.454	35.431	0.1	M2-10
81	962	970	323610	322640	965	3	0.6	1000	21.454	35.431	0.1	M2-10
84	117	120	83436	83316	117	0	0.6	1000	21.454	35.431	0.1	M2-10
87	231	232	27966	27734	231	0	0.6	1000	21.454	35.431	0.1	M2-10
90	1297	1297	17020	15723	1297	0	0.6	1000	21.454	35.431	0.1	M2-10
2	0	0	0	0	0	0	0.6	1000	21.654	38.087	0.5	M5-9
24	177	177	6786	6609	183	6	0.6	1000	21.654	38.087	0.5	M5-9
27	725	737	23871	23134	725	0	0.6	1000	21.654	38.087	0.5	M5-9
30	6565	6576	241165	234589	6575	10	0.6	1000	21.654	38.087	0.5	M5-9
33	200529	201488	2189278	1987790	200535	6	0.6	1000	21.654	38.087	0.5	M5-9
36	56168	57215	3491403	3434188	56176	8	0.6	1000	21.654	38.087	0.5	M5-9
37	0	0	0	0	0	0	0.6	1000	21.654	38.087	0.5	M5-9
39	30396	36069	7378561	7342492	30417	21	0.6	1000	21.654	38.087	0.5	M5-9
42	134172	137222	23780856	23643634	134482	310	0.6	1000	21.654	38.087	0.5	M5-9
44	0	0	0	0	0	0	0.6	1000	21.654	38.087	0.5	M5-9
45	102661	104239	35604141	35499902	102749	88	0.6	1000	21.654	38.087	0.5	M5-9
48	213944	216627	55762080	55545453	213979	35	0.6	1000	21.654	38.087	0.5	M5-9
49	0	0	0	0	0	0	0.6	1000	21.654	38.087	0.5	M5-9
50	190	190	210	20	190	0	0.6	1000	21.654	38.087	0.5	M5-9
51	437656	441159	87615703	87174544	437848	192	0.6	1000	21.654	38.087	0.5	M5-9
52	3	3	15	12	3	0	0.6	1000	21.654	38.087	0.5	M5-9
54	328986	332560	79046451	78713891	329109	123	0.6	1000	21.654	38.087	0.5	M5-9
55	0	0	0	0	0	0	0.6	1000	21.654	38.087	0.5	M5-9
57	227061	239552	57111328	56871776	227661	600	0.6	1000	21.654	38.087	0.5	M5-9
60	720866	725573	75885040	75159467	720903	37	0.6	1000	21.654	38.087	0.5	M5-9
63	177981	178994	30862296	30683302	179434	1453	0.6	1000	21.654	38.087	0.5	M5-9
64	1	1	1	0	1	0	0.6	1000	21.654	38.087	0.5	M5-9
65	0	0	0	0	0	0	0.6	1000	21.654	38.087	0.5	M5-9
66	276936	278881	26082253	25803372	276936	0	0.6	1000	21.654	38.087	0.5	M5-9
67	0	0	0	0	0	0	0.6	1000	21.654	38.087	0.5	M5-9
68	0	0	0	0	0	0	0.6	1000	21.654	38.087	0.5	M5-9
69	118690	121659	11231430	11109771	118723	33	0.6	1000	21.654	38.087	0.5	M5-9
71	0	0	0	0	0	0	0.6	1000	21.654	38.087	0.5	M5-9
72	184965	185224	11768526	11583302	184970	5	0.6	1000	21.654	38.087	0.5	M5-9
75	37881	38610	3121251	3082641	37881	0	0.6	1000	21.654	38.087	0.5	M5-9
78	29802	29894	1483503	1453609	29802	0	0.6	1000	21.654	38.087	0.5	M5-9
79	2278	2278	2278	0	2278	0	0.6	1000	21.654	38.087	0.5	M5-9
81	64663	64982	1242676	1177694	64663	0	0.6	1000	21.654	38.087	0.5	M5-9
82	1	1	1	0	1	0	0.6	1000	21.654	38.087	0.5	M5-9
83	0	0	1	1	0	0	0.6	1000	21.654	38.087	0.5	M5-9
84	3502	3530	134940	131410	3502	0	0.6	1000	21.654	38.087	0.5	M5-9
87	3860	3861	67528	63667	3860	0	0.6	1000	21.654	38.087	0.5	M5-9
90	3033	3033	28441	25408	3033	0	0.6	1000	21.654	38.087	0.5	M5-9
3	0	0	1	1	1	1	0.6	1000	21.693	33.675	0.1	M5-4
6	0	0	0	0	0	0	0.6	1000	21.693	33.675	0.1	M5-4
24	7097	7097	53956	46859	7097	0	0.6	1000	21.693	33.675	0.1	M5-4
25	0	0	0	0	0	0	0.6	1000	21.693	33.675	0.1	M5-4
27	3684	3684	61075	57391	3766	82	0.6	1000	21.693	33.675	0.1	M5-4
30	100119	100170	435711	335541	100129	10	0.6	1000	21.693	33.675	0.1	M5-4
33	32722	35009	1511191	1476182	33106	384	0.6	1000	21.693	33.675	0.1	M5-4
36	131360	133535	4965976	4832441	131367	7	0.6	1000	21.693	33.675	0.1	M5-4
39	75617	77207	9080191	9002984	75627	10	0.6	1000	21.693	33.675	0.1	M5-4
42	348820	352180	29533455	29181275	349166	346	0.6	1000	21.693	33.675	0.1	M5-4
43	0	0	0	0	0	0	0.6	1000	21.693	33.675	0.1	M5-4
45	150906	158736	35082876	34924140	151159	253	0.6	1000	21.693	33.675	0.1	M5-4
46	1	1	3	2	1	0	0.6	1000	21.693	33.675	0.1	M5-4
48	230707	233022	59508595	59275573	230769	62	0.6	1000	21.693	33.675	0.1	M5-4
50	0	0	0	0	0	0	0.6	1000	21.693	33.675	0.1	M5-4
51	256265	261406	69225261	68963855	256560	295	0.6	1000	21.693	33.675	0.1	M5-4
53	0	0	0	0	0	0	0.6	1000	21.693	33.675	0.1	M5-4
54	315140	320429	70834753	70514324	315496	356	0.6	1000	21.693	33.675	0.1	M5-4
55	0	0	15	15	0	0	0.6	1000	21.693	33.675	0.1	M5-4
57	387821	400461	63455745	63055284	388602	781	0.6	1000	21.693	33.675	0.1	M5-4
58	1	1	1	0	1	0	0.6	1000	21.693	33.675	0.1	M5-4
59	1	3	6	3	1	0	0.6	1000	21.693	33.675	0.1	M5-4
60	286630	288440	44589846	44301406	286657	27	0.6	1000	21.693	33.675	0.1	M5-4
61	0	0	0	0	0	0	0.6	1000	21.693	33.675	0.1	M5-4
63	285774	290269	39298545	39008276	285983	209	0.6	1000	21.693	33.675	0.1	M5-4
65	0	0	0	0	0	0	0.6	1000	21.693	33.675	0.1	M5-4
66	236753	240244	28076271	27836027	236762	9	0.6	1000	21.693	33.675	0.1	M5-4
67	10	10	36	26	10	0	0.6	1000	21.693	33.675	0.1	M5-4
69	160139	162726	15975378	15812652	160154	15	0.6	1000	21.693	33.675	0.1	M5-4
72	200186	203047	11460078	11257031	200197	11	0.6	1000	21.693	33.675	0.1	M5-4
75	37532	38105	2575315	2537210	37532	0	0.6	1000	21.693	33.675	0.1	M5-4
78	32382	33322	1704781	1671459	32383	1	0.6	1000	21.693	33.675	0.1	M5-4
81	95121	96031	1565565	1469534	95121	0	0.6	1000	21.693	33.675	0.1	M5-4
84	1194	1237	72390	71153	1194	0	0.6	1000	21.693	33.675	0.1	M5-4
87	7124	7124	62481	55357	7124	0	0.6	1000	21.693	33.675	0.1	M5-4
90	3869	3976	28441	24465	3869	0	0.6	1000	21.693	33.675	0.1	M5-4
3	0	0	3	3	3	3	0.6	1000	21.729	35.97	0.3	M2-3
18	0	0	0	0	0	0	0.6	1000	21.729	35.97	0.3	M2-3
24	79	81	17205	17124	90	11	0.6	1000	21.729	35.97	0.3	M2-3
27	95	95	32385	32290	129	34	0.6	1000	21.729	35.97	0.3	M2-3
30	256	256	73920	73664	285	29	0.6	1000	21.729	35.97	0.3	M2-3
33	4273	4281	524800	520519	4295	22	0.6	1000	21.729	35.97	0.3	M2-3
36	3145	3184	1449253	1446069	3180	35	0.6	1000	21.729	35.97	0.3	M2-3
39	21550	21847	5189031	5167184	21615	65	0.6	1000	21.729	35.97	0.3	M2-3
42	7810	8039	10656036	10647997	8212	402	0.6	1000	21.729	35.97	0.3	M2-3
45	18593	18762	15615666	15596904	18944	351	0.6	1000	21.729	35.97	0.3	M2-3
48	20212	20667	21362916	21342249	20382	170	0.6	1000	21.729	35.97	0.3	M2-3
49	0	0	0	0	0	0	0.6	1000	21.729	35.97	0.3	M2-3
51	21099	21389	27598735	27577346	21363	264	0.6	1000	21.729	35.97	0.3	M2-3
54	15294	15480	20778681	20763201	15431	137	0.6	1000	21.729	35.97	0.3	M2-3
55	0	0	6	6	0	0	0.6	1000	21.729	35.97	0.3	M2-3
56	0	0	0	0	0	0	0.6	1000	21.729	35.97	0.3	M2-3
57	12026	12319	19980681	19968362	12640	614	0.6	1000	21.729	35.97	0.3	M2-3
58	0	0	0	0	0	0	0.6	1000	21.729	35.97	0.3	M2-3
60	34847	35327	20272528	20237201	34901	54	0.6	1000	21.729	35.97	0.3	M2-3
62	0	0	0	0	0	0	0.6	1000	21.729	35.97	0.3	M2-3
63	31511	31663	14658405	14626742	31743	232	0.6	1000	21.729	35.97	0.3	M2-3
65	0	0	1	1	0	0	0.6	1000	21.729	35.97	0.3	M2-3
66	7744	7934	8256016	8248082	7764	20	0.6	1000	21.729	35.97	0.3	M2-3
69	47630	47737	6285285	6237548	47764	134	0.6	1000	21.729	35.97	0.3	M2-3
70	0	0	0	0	0	0	0.6	1000	21.729	35.97	0.3	M2-3
71	0	0	0	0	0	0	0.6	1000	21.729	35.97	0.3	M2-3
72	25331	25428	4238416	4212988	25340	9	0.6	1000	21.729	35.97	0.3	M2-3
75	2897	2941	1059240	1056299	2906	9	0.6	1000	21.729	35.97	0.3	M2-3
76	0	0	0	0	0	0	0.6	1000	21.729	35.97	0.3	M2-3
78	527	529	423660	423131	536	9	0.6	1000	21.729	35.97	0.3	M2-3
81	3750	3750	349030	345280	3750	0	0.6	1000	21.729	35.97	0.3	M2-3
84	881	881	125250	124369	881	0	0.6	1000	21.729	35.97	0.3	M2-3
87	363	363	31626	31263	363	0	0.6	1000	21.729	35.97	0.3	M2-3
90	19	19	11476	11457	19	0	0.6	1000	21.729	35.97	0.3	M2-3
3	0	0	0	0	0	0	0.6	1000	21.84	35.129	0.3	M2-1
12	1	1	1	0	1	0	0.6	1000	21.84	35.129	0.3	M2-1
15	0	0	0	0	0	0	0.6	1000	21.84	35.129	0.3	M2-1
24	80	80	17391	17311	132	52	0.6	1000	21.84	35.129	0.3	M2-1
27	58	58	20706	20648	65	7	0.6	1000	21.84	35.129	0.3	M2-1
30	316	317	102831	102514	326	10	0.6	1000	21.84	35.129	0.3	M2-1
33	760	781	571915	571134	808	48	0.6	1000	21.84	35.129	0.3	M2-1
36	1363	1518	1530375	1528857	1444	81	0.6	1000	21.84	35.129	0.3	M2-1
39	13301	13402	4501500	4488098	13371	70	0.6	1000	21.84	35.129	0.3	M2-1
41	0	0	0	0	0	0	0.6	1000	21.84	35.129	0.3	M2-1
42	28398	28588	10010575	9981987	28603	205	0.6	1000	21.84	35.129	0.3	M2-1
43	0	0	1	1	0	0	0.6	1000	21.84	35.129	0.3	M2-1
45	14997	15621	16522626	16507005	15222	225	0.6	1000	21.84	35.129	0.3	M2-1
46	0	0	1	1	0	0	0.6	1000	21.84	35.129	0.3	M2-1
48	32059	32345	24398605	24366260	32204	145	0.6	1000	21.84	35.129	0.3	M2-1
51	13909	14167	23988201	23974034	14209	300	0.6	1000	21.84	35.129	0.3	M2-1
52	0	0	0	0	0	0	0.6	1000	21.84	35.129	0.3	M2-1
54	33889	34863	24217320	24182457	33966	77	0.6	1000	21.84	35.129	0.3	M2-1
55	0	0	0	0	0	0	0.6	1000	21.84	35.129	0.3	M2-1
57	28182	28771	23932821	23904050	29036	854	0.6	1000	21.84	35.129	0.3	M2-1
58	0	0	0	0	0	0	0.6	1000	21.84	35.129	0.3	M2-1
59	0	0	1	1	0	0	0.6	1000	21.84	35.129	0.3	M2-1
60	13853	14059	16869336	16855277	13915	62	0.6	1000	21.84	35.129	0.3	M2-1
61	0	0	0	0	0	0	0.6	1000	21.84	35.129	0.3	M2-1
62	0	0	0	0	0	0	0.6	1000	21.84	35.129	0.3	M2-1
63	19784	19873	11608971	11589098	19844	60	0.6	1000	21.84	35.129	0.3	M2-1
64	0	0	0	0	0	0	0.6	1000	21.84	35.129	0.3	M2-1
66	42435	42563	7755891	7713328	42450	15	0.6	1000	21.84	35.129	0.3	M2-1
68	0	0	0	0	0	0	0.6	1000	21.84	35.129	0.3	M2-1
69	2653	2772	4928230	4925458	2685	32	0.6	1000	21.84	35.129	0.3	M2-1
72	2631	2716	2248260	2245544	2648	17	0.6	1000	21.84	35.129	0.3	M2-1
73	0	0	1	1	0	0	0.6	1000	21.84	35.129	0.3	M2-1
75	166258	166303	2494261	2327958	166265	7	0.6	1000	21.84	35.129	0.3	M2-1
78	606	617	541320	540703	626	20	0.6	1000	21.84	35.129	0.3	M2-1
81	18083	18097	402753	384656	18083	0	0.6	1000	21.84	35.129	0.3	M2-1
84	295	296	95703	95407	295	0	0.6	1000	21.84	35.129	0.3	M2-1
87	93	102	20100	19998	93	0	0.6	1000	21.84	35.129	0.3	M2-1
90	2	2	9045	9043	2	0	0.6	1000	21.84	35.129	0.3	M2-1
3	0	0	1	1	1	1	0.6	1000	22.053	33.192	0.3	M2-5
6	0	0	0	0	0	0	0.6	1000	22.053	33.192	0.3	M2-5
21	0	0	0	0	0	0	0.6	1000	22.053	33.192	0.3	M2-5
24	79	79	14878	14799	89	10	0.6	1000	22.053	33.192	0.3	M2-5
27	341	341	31375	31034	363	22	0.6	1000	22.053	33.192	0.3	M2-5
29	0	0	0	0	0	0	0.6	1000	22.053	33.192	0.3	M2-5
30	1950	1952	144991	143039	1978	28	0.6	1000	22.053	33.192	0.3	M2-5
33	568	582	456490	455908	594	26	0.6	1000	22.053	33.192	0.3	M2-5
36	946	975	1390278	1389303	984	38	0.6	1000	22.053	33.192	0.3	M2-5
39	19551	20025	4766328	4746303	19599	48	0.6	1000	22.053	33.192	0.3	M2-5
42	14639	14738	8729931	8715193	14905	266	0.6	1000	22.053	33.192	0.3	M2-5
43	0	0	0	0	0	0	0.6	1000	22.053	33.192	0.3	M2-5
45	11004	11227	14228445	14217218	11360	356	0.6	1000	22.053	33.192	0.3	M2-5
48	9994	10242	20972526	20962284	10184	190	0.6	1000	22.053	33.192	0.3	M2-5
50	0	0	1	1	0	0	0.6	1000	22.053	33.192	0.3	M2-5
51	55605	55910	26038936	25983026	55838	233	0.6	1000	22.053	33.192	0.3	M2-5
54	12813	12924	20444815	20431891	12866	53	0.6	1000	22.053	33.192	0.3	M2-5
57	27067	27415	23553816	23526401	27528	461	0.6	1000	22.053	33.192	0.3	M2-5
59	0	0	0	0	0	0	0.6	1000	22.053	33.192	0.3	M2-5
60	19628	20205	18063055	18042850	19708	80	0.6	1000	22.053	33.192	0.3	M2-5
62	0	0	0	0	0	0	0.6	1000	22.053	33.192	0.3	M2-5
63	48356	48491	13694761	13646270	48393	37	0.6	1000	22.053	33.192	0.3	M2-5
65	1	1	1	0	1	0	0.6	1000	22.053	33.192	0.3	M2-5
66	5847	6063	8600878	8594815	5867	20	0.6	1000	22.053	33.192	0.3	M2-5
69	21417	21721	6317235	6295514	21483	66	0.6	1000	22.053	33.192	0.3	M2-5
70	0	0	0	0	0	0	0.6	1000	22.053	33.192	0.3	M2-5
72	167088	167137	4937653	4770516	167119	31	0.6	1000	22.053	33.192	0.3	M2-5
73	0	0	0	0	0	0	0.6	1000	22.053	33.192	0.3	M2-5
75	5236	5280	1261666	1256386	5265	29	0.6	1000	22.053	33.192	0.3	M2-5
77	0	0	0	0	0	0	0.6	1000	22.053	33.192	0.3	M2-5
78	5042	5048	623286	618238	5054	12	0.6	1000	22.053	33.192	0.3	M2-5
81	620	620	277140	276520	622	2	0.6	1000	22.053	33.192	0.3	M2-5
84	125	125	83028	82903	125	0	0.6	1000	22.053	33.192	0.3	M2-5
87	652	652	41041	40389	653	1	0.6	1000	22.053	33.192	0.3	M2-5
89	0	0	0	0	0	0	0.6	1000	22.053	33.192	0.3	M2-5
90	10	10	12880	12870	10	0	0.6	1000	22.053	33.192	0.3	M2-5
2	0	0	0	0	0	0	0.6	1000	22.054	39.015	0.3	M5-6
9	0	0	0	0	0	0	0.6	1000	22.054	39.015	0.3	M5-6
12	0	0	0	0	0	0	0.6	1000	22.054	39.015	0.3	M5-6
14	0	0	0	0	0	0	0.6	1000	22.054	39.015	0.3	M5-6
23	0	0	0	0	0	0	0.6	1000	22.054	39.015	0.3	M5-6
24	6138	6139	39340	33201	6144	6	0.6	1000	22.054	39.015	0.3	M5-6
27	1247	1253	28203	26950	1257	10	0.6	1000	22.054	39.015	0.3	M5-6
28	0	0	0	0	0	0	0.6	1000	22.054	39.015	0.3	M5-6
30	9186	9392	330891	321499	9274	88	0.6	1000	22.054	39.015	0.3	M5-6
33	15373	15548	975106	959558	15380	7	0.6	1000	22.054	39.015	0.3	M5-6
36	24466	25335	3242331	3216996	24474	8	0.6	1000	22.054	39.015	0.3	M5-6
39	252235	291631	14207115	13915484	252240	5	0.6	1000	22.054	39.015	0.3	M5-6
40	0	0	0	0	0	0	0.6	1000	22.054	39.015	0.3	M5-6
41	0	0	1	1	0	0	0.6	1000	22.054	39.015	0.3	M5-6
42	258902	264231	32833356	32569125	259339	437	0.6	1000	22.054	39.015	0.3	M5-6
45	417035	422919	59759778	59336859	417964	929	0.6	1000	22.054	39.015	0.3	M5-6
48	450596	512948	73441140	72928192	450662	66	0.6	1000	22.054	39.015	0.3	M5-6
49	0	0	0	0	0	0	0.6	1000	22.054	39.015	0.3	M5-6
50	1	1	3	2	1	0	0.6	1000	22.054	39.015	0.3	M5-6
51	332935	336587	71670378	71333791	338111	5176	0.6	1000	22.054	39.015	0.3	M5-6
52	0	0	1	1	0	0	0.6	1000	22.054	39.015	0.3	M5-6
53	0	0	0	0	0	0	0.6	1000	22.054	39.015	0.3	M5-6
54	300007	302607	65054121	64751514	300181	174	0.6	1000	22.054	39.015	0.3	M5-6
56	0	0	1	1	0	0	0.6	1000	22.054	39.015	0.3	M5-6
57	141498	146321	47292675	47146354	142951	1453	0.6	1000	22.054	39.015	0.3	M5-6
58	0	0	1	1	0	0	0.6	1000	22.054	39.015	0.3	M5-6
59	0	0	0	0	0	0	0.6	1000	22.054	39.015	0.3	M5-6
60	289757	293561	49625703	49332142	289917	160	0.6	1000	22.054	39.015	0.3	M5-6
62	0	0	0	0	0	0	0.6	1000	22.054	39.015	0.3	M5-6
63	432053	464512	45120250	44655738	432099	46	0.6	1000	22.054	39.015	0.3	M5-6
64	0	0	3	3	0	0	0.6	1000	22.054	39.015	0.3	M5-6
65	0	0	0	0	0	0	0.6	1000	22.054	39.015	0.3	M5-6
66	142806	145281	21069786	20924505	142812	6	0.6	1000	22.054	39.015	0.3	M5-6
68	0	0	1	1	0	0	0.6	1000	22.054	39.015	0.3	M5-6
69	61540	62053	12647935	12585882	63809	2269	0.6	1000	22.054	39.015	0.3	M5-6
71	0	0	0	0	0	0	0.6	1000	22.054	39.015	0.3	M5-6
72	81347	82032	9607536	9525504	81349	2	0.6	1000	22.054	39.015	0.3	M5-6
75	66777	67076	4261740	4194664	66777	0	0.6	1000	22.054	39.015	0.3	M5-6
78	29661	29908	1514670	1484762	29663	2	0.6	1000	22.054	39.015	0.3	M5-6
80	0	0	0	0	0	0	0.6	1000	22.054	39.015	0.3	M5-6
81	17566	17584	406351	388767	17566	0	0.6	1000	22.054	39.015	0.3	M5-6
83	0	0	0	0	0	0	0.6	1000	22.054	39.015	0.3	M5-6
84	4674	4779	160461	155682	4674	0	0.6	1000	22.054	39.015	0.3	M5-6
87	16514	16514	77815	61301	16514	0	0.6	1000	22.054	39.015	0.3	M5-6
90	643	644	9870	9226	643	0	0.6	1000	22.054	39.015	0.3	M5-6
24	101957	102152	254541	152389	101957	0	0.6	1000	22.067	37.022	0.5	M5-8
27	118718	118718	318801	200083	118718	0	0.6	1000	22.067	37.022	0.5	M5-8
30	2188	2234	135981	133747	2202	14	0.6	1000	22.067	37.022	0.5	M5-8
33	26665	27746	1319500	1291754	26674	9	0.6	1000	22.067	37.022	0.5	M5-8
35	0	0	0	0	0	0	0.6	1000	22.067	37.022	0.5	M5-8
36	57544	57821	2951235	2893414	57556	12	0.6	1000	22.067	37.022	0.5	M5-8
39	156453	158036	12890503	12732467	156586	133	0.6	1000	22.067	37.022	0.5	M5-8
41	0	0	0	0	0	0	0.6	1000	22.067	37.022	0.5	M5-8
42	262031	269184	28618395	28349211	262098	67	0.6	1000	22.067	37.022	0.5	M5-8
45	307954	311238	45768528	45457290	308628	674	0.6	1000	22.067	37.022	0.5	M5-8
46	0	0	0	0	0	0	0.6	1000	22.067	37.022	0.5	M5-8
47	21	21	28	7	21	0	0.6	1000	22.067	37.022	0.5	M5-8
48	379516	383779	64553203	64169424	379582	66	0.6	1000	22.067	37.022	0.5	M5-8
49	6	6	15	9	6	0	0.6	1000	22.067	37.022	0.5	M5-8
50	0	0	0	0	0	0	0.6	1000	22.067	37.022	0.5	M5-8
51	222357	224402	60428521	60204119	222429	72	0.6	1000	22.067	37.022	0.5	M5-8
52	1	1	1	0	1	0	0.6	1000	22.067	37.022	0.5	M5-8
53	0	0	1	1	0	0	0.6	1000	22.067	37.022	0.5	M5-8
54	228018	230638	57657691	57427053	228106	88	0.6	1000	22.067	37.022	0.5	M5-8
55	1	1	6	5	1	0	0.6	1000	22.067	37.022	0.5	M5-8
57	332394	334699	68357278	68022579	332639	245	0.6	1000	22.067	37.022	0.5	M5-8
60	401178	413840	62580078	62166238	401189	11	0.6	1000	22.067	37.022	0.5	M5-8
63	245928	248261	45205786	44957525	245931	3	0.6	1000	22.067	37.022	0.5	M5-8
64	0	0	0	0	0	0	0.6	1000	22.067	37.022	0.5	M5-8
65	0	0	0	0	0	0	0.6	1000	22.067	37.022	0.5	M5-8
66	275921	277979	24454521	24176542	275931	10	0.6	1000	22.067	37.022	0.5	M5-8
69	124395	125482	16459453	16333971	124396	1	0.6	1000	22.067	37.022	0.5	M5-8
72	128115	128582	8398851	8270269	128122	7	0.6	1000	22.067	37.022	0.5	M5-8
75	16880	17750	2577585	2559835	16881	1	0.6	1000	22.067	37.022	0.5	M5-8
77	0	0	0	0	0	0	0.6	1000	22.067	37.022	0.5	M5-8
78	30822	32051	1121253	1089202	30823	1	0.6	1000	22.067	37.022	0.5	M5-8
79	3	3	3	0	3	0	0.6	1000	22.067	37.022	0.5	M5-8
81	18564	18604	523776	505172	18565	1	0.6	1000	22.067	37.022	0.5	M5-8
82	0	0	0	0	0	0	0.6	1000	22.067	37.022	0.5	M5-8
84	21170	21184	356590	335406	21170	0	0.6	1000	22.067	37.022	0.5	M5-8
87	1161	1193	59340	58147	1161	0	0.6	1000	22.067	37.022	0.5	M5-8
90	1001	1001	14196	13195	1001	0	0.6	1000	22.067	37.022	0.5	M5-8
3	0	0	1	1	1	1	0.6	1000	22.085	33.806	0.1	M2-4
24	10	10	7750	7740	16	6	0.6	1000	22.085	33.806	0.1	M2-4
27	41	41	15576	15535	81	40	0.6	1000	22.085	33.806	0.1	M2-4
28	0	0	0	0	0	0	0.6	1000	22.085	33.806	0.1	M2-4
30	755	755	77028	76273	762	7	0.6	1000	22.085	33.806	0.1	M2-4
33	792	809	342378	341569	812	20	0.6	1000	22.085	33.806	0.1	M2-4
35	0	0	0	0	0	0	0.6	1000	22.085	33.806	0.1	M2-4
36	987	1198	1407003	1405805	1008	21	0.6	1000	22.085	33.806	0.1	M2-4
39	30095	30320	5067336	5037016	30126	31	0.6	1000	22.085	33.806	0.1	M2-4
42	20869	21266	10312611	10291345	21060	191	0.6	1000	22.085	33.806	0.1	M2-4
45	11558	12313	15337491	15325178	11802	244	0.6	1000	22.085	33.806	0.1	M2-4
46	0	0	3	3	0	0	0.6	1000	22.085	33.806	0.1	M2-4
48	12512	12943	21776700	21763757	12709	197	0.6	1000	22.085	33.806	0.1	M2-4
49	0	0	0	0	0	0	0.6	1000	22.085	33.806	0.1	M2-4
51	74863	75341	30431701	30356360	75416	553	0.6	1000	22.085	33.806	0.1	M2-4
54	10489	10917	21730528	21719611	10583	94	0.6	1000	22.085	33.806	0.1	M2-4
56	0	0	0	0	0	0	0.6	1000	22.085	33.806	0.1	M2-4
57	25258	25962	23574411	23548449	25628	370	0.6	1000	22.085	33.806	0.1	M2-4
58	0	0	0	0	0	0	0.6	1000	22.085	33.806	0.1	M2-4
59	0	0	0	0	0	0	0.6	1000	22.085	33.806	0.1	M2-4
60	28761	29883	18614151	18584268	28845	84	0.6	1000	22.085	33.806	0.1	M2-4
63	4778	5094	12442566	12437472	4824	46	0.6	1000	22.085	33.806	0.1	M2-4
64	0	0	0	0	0	0	0.6	1000	22.085	33.806	0.1	M2-4
65	0	0	0	0	0	0	0.6	1000	22.085	33.806	0.1	M2-4
66	6334	6683	7791378	7784695	6340	6	0.6	1000	22.085	33.806	0.1	M2-4
69	13690	13794	5516181	5502387	13719	29	0.6	1000	22.085	33.806	0.1	M2-4
72	23265	23734	3746953	3723219	23290	25	0.6	1000	22.085	33.806	0.1	M2-4
75	6089	6228	1343980	1337752	6090	1	0.6	1000	22.085	33.806	0.1	M2-4
78	563	574	397386	396812	582	19	0.6	1000	22.085	33.806	0.1	M2-4
81	1191	1218	327645	326427	1192	1	0.6	1000	22.085	33.806	0.1	M2-4
84	100	100	64980	64880	100	0	0.6	1000	22.085	33.806	0.1	M2-4
87	353	366	43071	42705	353	0	0.6	1000	22.085	33.806	0.1	M2-4
90	344	344	21945	21601	348	4	0.6	1000	22.085	33.806	0.1	M2-4
3	0	0	0	0	0	0	0.6	1000	22.111	32.542	0.3	M2-7
6	0	0	0	0	0	0	0.6	1000	22.111	32.542	0.3	M2-7
9	0	0	0	0	0	0	0.6	1000	22.111	32.542	0.3	M2-7
24	387	387	11175	10788	393	6	0.6	1000	22.111	32.542	0.3	M2-7
27	271	271	17020	16749	303	32	0.6	1000	22.111	32.542	0.3	M2-7
30	1103	1105	112101	110996	1119	16	0.6	1000	22.111	32.542	0.3	M2-7
32	0	0	0	0	0	0	0.6	1000	22.111	32.542	0.3	M2-7
33	11034	11046	559153	548107	11061	27	0.6	1000	22.111	32.542	0.3	M2-7
36	7630	7699	1704781	1697082	7674	44	0.6	1000	22.111	32.542	0.3	M2-7
38	0	0	0	0	0	0	0.6	1000	22.111	32.542	0.3	M2-7
39	20339	20406	4981746	4961340	20381	42	0.6	1000	22.111	32.542	0.3	M2-7
40	0	0	0	0	0	0	0.6	1000	22.111	32.542	0.3	M2-7
42	2936	3199	7990003	7986804	3119	183	0.6	1000	22.111	32.542	0.3	M2-7
43	0	0	0	0	0	0	0.6	1000	22.111	32.542	0.3	M2-7
44	0	0	0	0	0	0	0.6	1000	22.111	32.542	0.3	M2-7
45	172907	173085	17520240	17347155	173283	376	0.6	1000	22.111	32.542	0.3	M2-7
48	22973	23450	24286965	24263515	23510	537	0.6	1000	22.111	32.542	0.3	M2-7
49	0	0	0	0	0	0	0.6	1000	22.111	32.542	0.3	M2-7
50	0	0	0	0	0	0	0.6	1000	22.111	32.542	0.3	M2-7
51	36004	36524	25959615	25923091	36239	235	0.6	1000	22.111	32.542	0.3	M2-7
52	0	0	0	0	0	0	0.6	1000	22.111	32.542	0.3	M2-7
53	0	0	0	0	0	0	0.6	1000	22.111	32.542	0.3	M2-7
54	14659	14798	22663278	22648480	14791	132	0.6	1000	22.111	32.542	0.3	M2-7
55	0	0	0	0	0	0	0.6	1000	22.111	32.542	0.3	M2-7
57	13631	13861	22028203	22014342	14072	441	0.6	1000	22.111	32.542	0.3	M2-7
58	0	0	1	1	0	0	0.6	1000	22.111	32.542	0.3	M2-7
60	29714	29971	16293486	16263515	29767	53	0.6	1000	22.111	32.542	0.3	M2-7
63	9348	9454	13439520	13430066	9439	91	0.6	1000	22.111	32.542	0.3	M2-7
64	0	0	1	1	0	0	0.6	1000	22.111	32.542	0.3	M2-7
65	0	0	0	0	0	0	0.6	1000	22.111	32.542	0.3	M2-7
66	8665	8892	8600878	8591986	8678	13	0.6	1000	22.111	32.542	0.3	M2-7
69	65196	65664	8174946	8109282	65222	26	0.6	1000	22.111	32.542	0.3	M2-7
71	0	0	0	0	0	0	0.6	1000	22.111	32.542	0.3	M2-7
72	4936	5030	2946378	2941348	4958	22	0.6	1000	22.111	32.542	0.3	M2-7
75	512	550	905185	904635	521	9	0.6	1000	22.111	32.542	0.3	M2-7
78	487	511	371953	371442	488	1	0.6	1000	22.111	32.542	0.3	M2-7
81	692	697	219453	218756	692	0	0.6	1000	22.111	32.542	0.3	M2-7
84	542	546	97461	96915	542	0	0.6	1000	22.111	32.542	0.3	M2-7
87	376	376	21736	21360	376	0	0.6	1000	22.111	32.542	0.3	M2-7
90	44	44	4950	4906	44	0	0.6	1000	22.111	32.542	0.3	M2-7
3	0	0	1	1	1	1	0.6	1000	22.211	34.615	0.1	M2-6
9	0	0	0	0	0	0	0.6	1000	22.211	34.615	0.1	M2-6
21	0	0	0	0	0	0	0.6	1000	22.211	34.615	0.1	M2-6
24	230	230	21528	21298	298	68	0.6	1000	22.211	34.615	0.1	M2-6
25	0	0	0	0	0	0	0.6	1000	22.211	34.615	0.1	M2-6
27	123	123	24090	23967	143	20	0.6	1000	22.211	34.615	0.1	M2-6
30	985	988	86736	85748	993	8	0.6	1000	22.211	34.615	0.1	M2-6
33	6386	6394	393828	387434	6422	36	0.6	1000	22.211	34.615	0.1	M2-6
36	1215	1338	1046181	1044843	1240	25	0.6	1000	22.211	34.615	0.1	M2-6
39	11255	11574	4477528	4465954	11283	28	0.6	1000	22.211	34.615	0.1	M2-6
42	35393	36757	12199330	12162573	36481	1088	0.6	1000	22.211	34.615	0.1	M2-6
45	8900	9465	13799631	13790166	9091	191	0.6	1000	22.211	34.615	0.1	M2-6
46	0	0	0	0	0	0	0.6	1000	22.211	34.615	0.1	M2-6
47	0	0	1	1	0	0	0.6	1000	22.211	34.615	0.1	M2-6
48	32979	33667	21988396	21954729	33217	238	0.6	1000	22.211	34.615	0.1	M2-6
49	0	0	1	1	0	0	0.6	1000	22.211	34.615	0.1	M2-6
50	0	0	0	0	0	0	0.6	1000	22.211	34.615	0.1	M2-6
51	12604	13071	23718828	23705757	12904	300	0.6	1000	22.211	34.615	0.1	M2-6
54	52591	52975	23505796	23452821	52746	155	0.6	1000	22.211	34.615	0.1	M2-6
57	12583	13056	19198306	19185250	13223	640	0.6	1000	22.211	34.615	0.1	M2-6
60	11967	12478	17668540	17656062	12189	222	0.6	1000	22.211	34.615	0.1	M2-6
63	22343	27271	13778625	13751354	22384	41	0.6	1000	22.211	34.615	0.1	M2-6
66	5881	6121	7463316	7457195	5905	24	0.6	1000	22.211	34.615	0.1	M2-6
67	3	3	3	0	3	0	0.6	1000	22.211	34.615	0.1	M2-6
68	1	1	3	2	1	0	0.6	1000	22.211	34.615	0.1	M2-6
69	170483	170803	8931651	8760848	170539	56	0.6	1000	22.211	34.615	0.1	M2-6
72	4436	4790	3280641	3275851	4514	78	0.6	1000	22.211	34.615	0.1	M2-6
75	17578	17641	1352190	1334549	17595	17	0.6	1000	22.211	34.615	0.1	M2-6
78	1274	1279	592416	591137	1280	6	0.6	1000	22.211	34.615	0.1	M2-6
81	3999	4005	263901	259896	4002	3	0.6	1000	22.211	34.615	0.1	M2-6
84	411	411	124750	124339	411	0	0.6	1000	22.211	34.615	0.1	M2-6
87	120	120	26796	26676	120	0	0.6	1000	22.211	34.615	0.1	M2-6
90	223	224	21321	21097	223	0	0.6	1000	22.211	34.615	0.1	M2-6
98	0	0	0	0	0	0	0.6	1000	22.211	34.615	0.1	M2-6
9	0	0	0	0	0	0	0.6	1000	22.275	35.398	0.5	M5-10
24	4023	4025	51681	47656	4023	0	0.6	1000	22.275	35.398	0.5	M5-10
27	2691	2691	42778	40087	2691	0	0.6	1000	22.275	35.398	0.5	M5-10
28	0	0	0	0	0	0	0.6	1000	22.275	35.398	0.5	M5-10
30	5642	5687	220780	215093	5642	0	0.6	1000	22.275	35.398	0.5	M5-10
33	74184	75175	1973091	1897916	74191	7	0.6	1000	22.275	35.398	0.5	M5-10
34	1	1	1	0	1	0	0.6	1000	22.275	35.398	0.5	M5-10
36	69463	70553	4850055	4779502	69469	6	0.6	1000	22.275	35.398	0.5	M5-10
38	3	3	3	0	3	0	0.6	1000	22.275	35.398	0.5	M5-10
39	90663	94977	11536806	11441829	90671	8	0.6	1000	22.275	35.398	0.5	M5-10
42	175440	178861	27117930	26939069	175599	159	0.6	1000	22.275	35.398	0.5	M5-10
45	409756	413139	47438670	47025531	409949	193	0.6	1000	22.275	35.398	0.5	M5-10
46	0	0	1	1	0	0	0.6	1000	22.275	35.398	0.5	M5-10
48	290103	292743	58584900	58292157	290145	42	0.6	1000	22.275	35.398	0.5	M5-10
51	421730	426369	82593378	82167009	422201	471	0.6	1000	22.275	35.398	0.5	M5-10
52	0	0	1	1	0	0	0.6	1000	22.275	35.398	0.5	M5-10
54	157174	162520	53618190	53455670	157293	119	0.6	1000	22.275	35.398	0.5	M5-10
56	0	0	0	0	0	0	0.6	1000	22.275	35.398	0.5	M5-10
57	375052	388265	62010816	61622551	375348	296	0.6	1000	22.275	35.398	0.5	M5-10
58	0	0	0	0	0	0	0.6	1000	22.275	35.398	0.5	M5-10
59	0	0	0	0	0	0	0.6	1000	22.275	35.398	0.5	M5-10
60	396900	398622	51171786	50773164	396925	25	0.6	1000	22.275	35.398	0.5	M5-10
63	317431	323841	37320480	36996639	317524	93	0.6	1000	22.275	35.398	0.5	M5-10
64	0	0	0	0	0	0	0.6	1000	22.275	35.398	0.5	M5-10
65	0	0	0	0	0	0	0.6	1000	22.275	35.398	0.5	M5-10
66	115878	120664	25300941	25180277	115977	99	0.6	1000	22.275	35.398	0.5	M5-10
69	151233	158025	18816045	18658020	151234	1	0.6	1000	22.275	35.398	0.5	M5-10
70	0	0	1	1	0	0	0.6	1000	22.275	35.398	0.5	M5-10
71	1	1	1	0	1	0	0.6	1000	22.275	35.398	0.5	M5-10
72	200544	203877	10499653	10295776	200601	57	0.6	1000	22.275	35.398	0.5	M5-10
75	56703	57625	3584503	3526878	56703	0	0.6	1000	22.275	35.398	0.5	M5-10
78	28801	29049	1492128	1463079	28801	0	0.6	1000	22.275	35.398	0.5	M5-10
81	5657	5697	324415	318718	5664	7	0.6	1000	22.275	35.398	0.5	M5-10
84	22261	22546	234270	211724	22261	0	0.6	1000	22.275	35.398	0.5	M5-10
87	861	866	42195	41329	881	20	0.6	1000	22.275	35.398	0.5	M5-10
89	0	0	0	0	0	0	0.6	1000	22.275	35.398	0.5	M5-10
90	8671	8673	50086	41413	8671	0	0.6	1000	22.275	35.398	0.5	M5-10
3	0	0	0	0	0	0	0.6	1000	22.283	34.651	0.1	M2-8
6	0	0	0	0	0	0	0.6	1000	22.283	34.651	0.1	M2-8
8	0	0	0	0	0	0	0.6	1000	22.283	34.651	0.1	M2-8
12	0	0	0	0	0	0	0.6	1000	22.283	34.651	0.1	M2-8
15	0	0	0	0	0	0	0.6	1000	22.283	34.651	0.1	M2-8
18	0	0	1	1	0	0	0.6	1000	22.283	34.651	0.1	M2-8
24	53	53	17578	17525	62	9	0.6	1000	22.283	34.651	0.1	M2-8
27	11	11	21528	21517	37	26	0.6	1000	22.283	34.651	0.1	M2-8
28	0	0	0	0	0	0	0.6	1000	22.283	34.651	0.1	M2-8
30	262	263	58653	58390	266	4	0.6	1000	22.283	34.651	0.1	M2-8
32	0	0	0	0	0	0	0.6	1000	22.283	34.651	0.1	M2-8
33	1467	1514	578350	576836	1485	18	0.6	1000	22.283	34.651	0.1	M2-8
36	15232	15366	1853775	1838409	15263	31	0.6	1000	22.283	34.651	0.1	M2-8
38	0	0	1	1	0	0	0.6	1000	22.283	34.651	0.1	M2-8
39	5899	6403	4450636	4444233	5921	22	0.6	1000	22.283	34.651	0.1	M2-8
40	0	0	0	0	0	0	0.6	1000	22.283	34.651	0.1	M2-8
42	23351	23875	10131751	10107876	23883	532	0.6	1000	22.283	34.651	0.1	M2-8
45	6175	6498	13543410	13536912	6379	204	0.6	1000	22.283	34.651	0.1	M2-8
46	0	0	0	0	0	0	0.6	1000	22.283	34.651	0.1	M2-8
48	10382	10669	22408165	22397496	10558	176	0.6	1000	22.283	34.651	0.1	M2-8
49	0	0	1	1	0	0	0.6	1000	22.283	34.651	0.1	M2-8
51	9419	9914	22636356	22626442	9671	252	0.6	1000	22.283	34.651	0.1	M2-8
52	0	0	1	1	0	0	0.6	1000	22.283	34.651	0.1	M2-8
54	15576	16473	21849355	21832882	15637	61	0.6	1000	22.283	34.651	0.1	M2-8
55	0	0	0	0	0	0	0.6	1000	22.283	34.651	0.1	M2-8
57	15775	16371	21803106	21786735	16260	485	0.6	1000	22.283	34.651	0.1	M2-8
58	0	0	0	0	0	0	0.6	1000	22.283	34.651	0.1	M2-8
59	0	0	0	0	0	0	0.6	1000	22.283	34.651	0.1	M2-8
60	12451	12784	16921653	16908869	12500	49	0.6	1000	22.283	34.651	0.1	M2-8
62	0	0	0	0	0	0	0.6	1000	22.283	34.651	0.1	M2-8
63	26920	27543	13984116	13956573	26970	50	0.6	1000	22.283	34.651	0.1	M2-8
65	0	0	1	1	0	0	0.6	1000	22.283	34.651	0.1	M2-8
66	35623	36059	11565645	11529586	35630	7	0.6	1000	22.283	34.651	0.1	M2-8
68	0	0	0	0	0	0	0.6	1000	22.283	34.651	0.1	M2-8
69	8983	9212	6144265	6135053	9017	34	0.6	1000	22.283	34.651	0.1	M2-8
70	0	0	0	0	0	0	0.6	1000	22.283	34.651	0.1	M2-8
72	26751	27532	3128751	3101219	27160	409	0.6	1000	22.283	34.651	0.1	M2-8
73	0	0	0	0	0	0	0.6	1000	22.283	34.651	0.1	M2-8
75	2583	2645	1226961	1224316	2592	9	0.6	1000	22.283	34.651	0.1	M2-8
78	1727	1802	671061	669259	1742	15	0.6	1000	22.283	34.651	0.1	M2-8
81	5308	5308	299151	293843	5309	1	0.6	1000	22.283	34.651	0.1	M2-8
84	243	243	96141	95898	245	2	0.6	1000	22.283	34.651	0.1	M2-8
87	702	703	61776	61073	702	0	0.6	1000	22.283	34.651	0.1	M2-8
90	425	428	14365	13937	425	0	0.6	1000	22.283	34.651	0.1	M2-8
6	0	0	0	0	0	0	0.6	1000	22.47	34.628	0.1	M5-1
8	3	6	6	0	3	0	0.6	1000	22.47	34.628	0.1	M5-1
9	28	28	28	0	28	0	0.6	1000	22.47	34.628	0.1	M5-1
24	9161	9286	76636	67350	9282	121	0.6	1000	22.47	34.628	0.1	M5-1
27	9928	11312	53956	42644	9928	0	0.6	1000	22.47	34.628	0.1	M5-1
30	84740	84807	512578	427771	84741	1	0.6	1000	22.47	34.628	0.1	M5-1
33	15278	16399	1097421	1081022	15288	10	0.6	1000	22.47	34.628	0.1	M5-1
35	0	0	0	0	0	0	0.6	1000	22.47	34.628	0.1	M5-1
36	38046	38513	3324331	3285818	38073	27	0.6	1000	22.47	34.628	0.1	M5-1
37	0	0	0	0	0	0	0.6	1000	22.47	34.628	0.1	M5-1
39	71936	78081	8914753	8836672	71939	3	0.6	1000	22.47	34.628	0.1	M5-1
40	0	0	0	0	0	0	0.6	1000	22.47	34.628	0.1	M5-1
42	166115	168038	24440536	24272498	166437	322	0.6	1000	22.47	34.628	0.1	M5-1
45	178092	190901	46527481	46336580	178314	222	0.6	1000	22.47	34.628	0.1	M5-1
47	0	0	0	0	0	0	0.6	1000	22.47	34.628	0.1	M5-1
48	423291	430088	84142878	83712790	423774	483	0.6	1000	22.47	34.628	0.1	M5-1
49	0	0	0	0	0	0	0.6	1000	22.47	34.628	0.1	M5-1
51	275082	283513	65259600	64976087	276840	1758	0.6	1000	22.47	34.628	0.1	M5-1
54	391210	394658	62826445	62431787	391223	13	0.6	1000	22.47	34.628	0.1	M5-1
55	1	1	1	0	1	0	0.6	1000	22.47	34.628	0.1	M5-1
57	392824	402140	60077241	59675101	392997	173	0.6	1000	22.47	34.628	0.1	M5-1
58	0	0	0	0	0	0	0.6	1000	22.47	34.628	0.1	M5-1
59	0	0	0	0	0	0	0.6	1000	22.47	34.628	0.1	M5-1
60	135304	141584	42878430	42736846	135604	300	0.6	1000	22.47	34.628	0.1	M5-1
61	0	1	1	0	0	0	0.6	1000	22.47	34.628	0.1	M5-1
62	3	3	6	3	3	0	0.6	1000	22.47	34.628	0.1	M5-1
63	281624	283443	33020001	32736558	281683	59	0.6	1000	22.47	34.628	0.1	M5-1
64	0	0	0	0	0	0	0.6	1000	22.47	34.628	0.1	M5-1
66	144668	146922	23225520	23078598	144668	0	0.6	1000	22.47	34.628	0.1	M5-1
69	209514	210783	17877210	17666427	209516	2	0.6	1000	22.47	34.628	0.1	M5-1
72	196464	198785	11005086	10806301	196639	175	0.6	1000	22.47	34.628	0.1	M5-1
75	26722	27401	2809635	2782234	26726	4	0.6	1000	22.47	34.628	0.1	M5-1
76	0	0	0	0	0	0	0.6	1000	22.47	34.628	0.1	M5-1
78	57190	58159	2273778	2215619	57190	0	0.6	1000	22.47	34.628	0.1	M5-1
81	14868	14958	644680	629722	14868	0	0.6	1000	22.47	34.628	0.1	M5-1
84	29235	29526	328455	298929	29235	0	0.6	1000	22.47	34.628	0.1	M5-1
87	4182	4182	52650	48468	4185	3	0.6	1000	22.47	34.628	0.1	M5-1
90	2090	2090	18721	16631	2090	0	0.6	1000	22.47	34.628	0.1	M5-1
3	0	0	1	1	1	1	0.6	1000	22.524	35.434	0.1	M2-2
6	0	0	1	1	0	0	0.6	1000	22.524	35.434	0.1	M2-2
18	0	0	0	0	0	0	0.6	1000	22.524	35.434	0.1	M2-2
24	111	111	16471	16360	125	14	0.6	1000	22.524	35.434	0.1	M2-2
27	160	160	14535	14375	160	0	0.6	1000	22.524	35.434	0.1	M2-2
30	173	174	92665	92491	198	25	0.6	1000	22.524	35.434	0.1	M2-2
33	936	936	392055	391119	1015	79	0.6	1000	22.524	35.434	0.1	M2-2
36	7232	7409	1684530	1677121	7461	229	0.6	1000	22.524	35.434	0.1	M2-2
39	22034	22134	4713985	4691851	22054	20	0.6	1000	22.524	35.434	0.1	M2-2
42	4959	5340	10818226	10812886	5179	220	0.6	1000	22.524	35.434	0.1	M2-2
44	1	1	1	0	1	0	0.6	1000	22.524	35.434	0.1	M2-2
45	16467	17051	17026530	17009479	16697	230	0.6	1000	22.524	35.434	0.1	M2-2
46	0	0	0	0	0	0	0.6	1000	22.524	35.434	0.1	M2-2
48	29943	31132	24559536	24528404	30098	155	0.6	1000	22.524	35.434	0.1	M2-2
49	0	0	0	0	0	0	0.6	1000	22.524	35.434	0.1	M2-2
51	16631	17184	25300941	25283757	16874	243	0.6	1000	22.524	35.434	0.1	M2-2
52	0	0	0	0	0	0	0.6	1000	22.524	35.434	0.1	M2-2
53	0	0	1	1	0	0	0.6	1000	22.524	35.434	0.1	M2-2
54	9789	10321	21264981	21254660	9869	80	0.6	1000	22.524	35.434	0.1	M2-2
57	183172	184015	26060590	25876575	184425	1253	0.6	1000	22.524	35.434	0.1	M2-2
58	0	0	1	1	0	0	0.6	1000	22.524	35.434	0.1	M2-2
59	0	0	0	0	0	0	0.6	1000	22.524	35.434	0.1	M2-2
60	25500	26102	16863528	16837426	25544	44	0.6	1000	22.524	35.434	0.1	M2-2
63	9627	10197	13957686	13947489	9764	137	0.6	1000	22.524	35.434	0.1	M2-2
66	17675	18242	8382465	8364223	17902	227	0.6	1000	22.524	35.434	0.1	M2-2
67	0	0	0	0	0	0	0.6	1000	22.524	35.434	0.1	M2-2
69	3766	3945	5737578	5733633	3797	31	0.6	1000	22.524	35.434	0.1	M2-2
70	0	0	0	0	0	0	0.6	1000	22.524	35.434	0.1	M2-2
72	57310	57705	4323270	4265565	57318	8	0.6	1000	22.524	35.434	0.1	M2-2
74	0	0	1	1	0	0	0.6	1000	22.524	35.434	0.1	M2-2
75	5254	5400	1507716	1502316	5269	15	0.6	1000	22.524	35.434	0.1	M2-2
76	0	0	0	0	0	0	0.6	1000	22.524	35.434	0.1	M2-2
78	418	418	375411	374993	419	1	0.6	1000	22.524	35.434	0.1	M2-2
81	5165	5167	260281	255114	5169	4	0.6	1000	22.524	35.434	0.1	M2-2
84	223	223	87990	87767	224	1	0.6	1000	22.524	35.434	0.1	M2-2
87	299	299	35778	35479	299	0	0.6	1000	22.524	35.434	0.1	M2-2
90	39	40	17205	17165	39	0	0.6	1000	22.524	35.434	0.1	M2-2
24	869	893	18915	18022	869	0	0.6	1000	22.528	35.149	0.5	M5-7
27	3180	3180	45451	42271	3224	44	0.6	1000	22.528	35.149	0.5	M5-7
30	6598	7335	248160	240825	6708	110	0.6	1000	22.528	35.149	0.5	M5-7
33	9462	9512	743590	734078	9467	5	0.6	1000	22.528	35.149	0.5	M5-7
34	0	0	0	0	0	0	0.6	1000	22.528	35.149	0.5	M5-7
36	47297	48756	3004926	2956170	47344	47	0.6	1000	22.528	35.149	0.5	M5-7
38	0	0	0	0	0	0	0.6	1000	22.528	35.149	0.5	M5-7
39	312688	337132	15354111	15016979	312688	0	0.6	1000	22.528	35.149	0.5	M5-7
41	1	1	1	0	1	0	0.6	1000	22.528	35.149	0.5	M5-7
42	340193	350257	30011878	29661621	340269	76	0.6	1000	22.528	35.149	0.5	M5-7
43	0	0	0	0	0	0	0.6	1000	22.528	35.149	0.5	M5-7
45	177558	179480	41975703	41796223	178474	916	0.6	1000	22.528	35.149	0.5	M5-7
48	170958	199870	53877390	53677520	171003	45	0.6	1000	22.528	35.149	0.5	M5-7
49	3	3	3	0	3	0	0.6	1000	22.528	35.149	0.5	M5-7
51	311148	319118	74951646	74632528	311476	328	0.6	1000	22.528	35.149	0.5	M5-7
52	2	2	10	8	2	0	0.6	1000	22.528	35.149	0.5	M5-7
53	0	0	0	0	0	0	0.6	1000	22.528	35.149	0.5	M5-7
54	346065	348872	70051366	69702494	346366	301	0.6	1000	22.528	35.149	0.5	M5-7
55	0	0	1	1	0	0	0.6	1000	22.528	35.149	0.5	M5-7
56	3	3	3	0	3	0	0.6	1000	22.528	35.149	0.5	M5-7
57	354656	358240	65763246	65405006	355318	662	0.6	1000	22.528	35.149	0.5	M5-7
59	0	0	0	0	0	0	0.6	1000	22.528	35.149	0.5	M5-7
60	132609	133351	38645236	38511885	132686	77	0.6	1000	22.528	35.149	0.5	M5-7
61	0	0	0	0	0	0	0.6	1000	22.528	35.149	0.5	M5-7
62	3	3	10	7	3	0	0.6	1000	22.528	35.149	0.5	M5-7
63	192403	196867	36984300	36787433	192412	9	0.6	1000	22.528	35.149	0.5	M5-7
64	1	1	6	5	1	0	0.6	1000	22.528	35.149	0.5	M5-7
66	203684	205243	23953581	23748338	203688	4	0.6	1000	22.528	35.149	0.5	M5-7
67	1	1	6	5	1	0	0.6	1000	22.528	35.149	0.5	M5-7
69	209087	213269	17249001	17035732	209088	1	0.6	1000	22.528	35.149	0.5	M5-7
70	0	0	0	0	0	0	0.6	1000	22.528	35.149	0.5	M5-7
72	106643	107768	8830503	8722735	106646	3	0.6	1000	22.528	35.149	0.5	M5-7
75	194740	195618	4887501	4691883	194746	6	0.6	1000	22.528	35.149	0.5	M5-7
78	103504	103947	2364225	2260278	103504	0	0.6	1000	22.528	35.149	0.5	M5-7
80	0	0	0	0	0	0	0.6	1000	22.528	35.149	0.5	M5-7
81	4652	4671	307720	303049	4652	0	0.6	1000	22.528	35.149	0.5	M5-7
84	18626	18644	351541	332897	18626	0	0.6	1000	22.528	35.149	0.5	M5-7
85	0	0	0	0	0	0	0.6	1000	22.528	35.149	0.5	M5-7
87	529	529	23653	23124	529	0	0.6	1000	22.528	35.149	0.5	M5-7
90	41892	41911	314821	272910	41892	0	0.6	1000	22.528	35.149	0.5	M5-7
3	0	0	1	1	0	0	0.6	1000	22.532	38.778	0.5	M5-5
24	6037	10078	57291	47213	6057	20	0.6	1000	22.532	38.778	0.5	M5-5
27	1746	1747	18528	16781	1765	19	0.6	1000	22.532	38.778	0.5	M5-5
29	0	0	0	0	0	0	0.6	1000	22.532	38.778	0.5	M5-5
30	5098	5147	212226	207079	5619	521	0.6	1000	22.532	38.778	0.5	M5-5
32	0	0	0	0	0	0	0.6	1000	22.532	38.778	0.5	M5-5
33	43556	45315	1771903	1726588	43614	58	0.6	1000	22.532	38.778	0.5	M5-5
36	73126	86887	5282875	5195988	73136	10	0.6	1000	22.532	38.778	0.5	M5-5
39	198015	203840	14935845	14732005	198021	6	0.6	1000	22.532	38.778	0.5	M5-5
42	379482	384044	34999161	34615117	379614	132	0.6	1000	22.532	38.778	0.5	M5-5
45	380371	384335	49237926	48853591	380433	62	0.6	1000	22.532	38.778	0.5	M5-5
47	1	1	1	0	1	0	0.6	1000	22.532	38.778	0.5	M5-5
48	315007	316394	67738980	67422586	315292	285	0.6	1000	22.532	38.778	0.5	M5-5
49	0	0	1	1	0	0	0.6	1000	22.532	38.778	0.5	M5-5
50	0	0	0	0	0	0	0.6	1000	22.532	38.778	0.5	M5-5
51	141068	142966	58509153	58366187	141318	250	0.6	1000	22.532	38.778	0.5	M5-5
53	0	0	0	0	0	0	0.6	1000	22.532	38.778	0.5	M5-5
54	591812	608203	66857266	66249063	591978	166	0.6	1000	22.532	38.778	0.5	M5-5
55	0	0	1	1	0	0	0.6	1000	22.532	38.778	0.5	M5-5
56	0	0	0	0	0	0	0.6	1000	22.532	38.778	0.5	M5-5
57	194708	198194	56716575	56518381	199195	4487	0.6	1000	22.532	38.778	0.5	M5-5
58	210	210	210	0	210	0	0.6	1000	22.532	38.778	0.5	M5-5
59	4	9	21	12	4	0	0.6	1000	22.532	38.778	0.5	M5-5
60	226119	231970	41546170	41314200	226125	6	0.6	1000	22.532	38.778	0.5	M5-5
61	0	0	0	0	0	0	0.6	1000	22.532	38.778	0.5	M5-5
62	0	0	0	0	0	0	0.6	1000	22.532	38.778	0.5	M5-5
63	120166	129043	32453596	32324553	120195	29	0.6	1000	22.532	38.778	0.5	M5-5
64	0	0	1	1	0	0	0.6	1000	22.532	38.778	0.5	M5-5
66	176770	178578	24454521	24275943	176774	4	0.6	1000	22.532	38.778	0.5	M5-5
67	0	0	0	0	0	0	0.6	1000	22.532	38.778	0.5	M5-5
69	207161	214049	22906296	22692247	207170	9	0.6	1000	22.532	38.778	0.5	M5-5
70	0	0	0	0	0	0	0.6	1000	22.532	38.778	0.5	M5-5
72	138783	139273	8957028	8817755	139023	240	0.6	1000	22.532	38.778	0.5	M5-5
73	1	1	3	2	1	0	0.6	1000	22.532	38.778	0.5	M5-5
74	0	0	0	0	0	0	0.6	1000	22.532	38.778	0.5	M5-5
75	51352	51646	4394130	4342484	51352	0	0.6	1000	22.532	38.778	0.5	M5-5
78	19119	19451	1023165	1003714	19119	0	0.6	1000	22.532	38.778	0.5	M5-5
81	21179	21248	727821	706573	21179	0	0.6	1000	22.532	38.778	0.5	M5-5
84	10703	10715	200661	189946	10703	0	0.6	1000	22.532	38.778	0.5	M5-5
87	6286	6313	99681	93368	6286	0	0.6	1000	22.532	38.778	0.5	M5-5
90	8355	9423	70125	60702	8355	0	0.6	1000	22.532	38.778	0.5	M5-5
24	869	893	18915	18022	869	0	0.6	1000	22.544	34.948	0.3	M5-7
27	3180	3180	45451	42271	3224	44	0.6	1000	22.544	34.948	0.3	M5-7
30	6598	7335	248160	240825	6708	110	0.6	1000	22.544	34.948	0.3	M5-7
33	9462	9512	743590	734078	9467	5	0.6	1000	22.544	34.948	0.3	M5-7
34	0	0	0	0	0	0	0.6	1000	22.544	34.948	0.3	M5-7
36	47337	48756	3004926	2956170	47384	47	0.6	1000	22.544	34.948	0.3	M5-7
38	0	0	0	0	0	0	0.6	1000	22.544	34.948	0.3	M5-7
39	304562	337132	15354111	15016979	304562	0	0.6	1000	22.544	34.948	0.3	M5-7
41	1	1	1	0	1	0	0.6	1000	22.544	34.948	0.3	M5-7
42	339954	350257	30011878	29661621	340063	109	0.6	1000	22.544	34.948	0.3	M5-7
43	0	0	0	0	0	0	0.6	1000	22.544	34.948	0.3	M5-7
45	177781	179480	41975703	41796223	178624	843	0.6	1000	22.544	34.948	0.3	M5-7
48	193824	199870	53877390	53677520	193860	36	0.6	1000	22.544	34.948	0.3	M5-7
49	3	3	3	0	3	0	0.6	1000	22.544	34.948	0.3	M5-7
51	312096	319118	74951646	74632528	312240	144	0.6	1000	22.544	34.948	0.3	M5-7
52	2	2	10	8	2	0	0.6	1000	22.544	34.948	0.3	M5-7
53	0	0	0	0	0	0	0.6	1000	22.544	34.948	0.3	M5-7
54	345654	348872	70051366	69702494	345952	298	0.6	1000	22.544	34.948	0.3	M5-7
55	0	0	1	1	0	0	0.6	1000	22.544	34.948	0.3	M5-7
56	3	3	3	0	3	0	0.6	1000	22.544	34.948	0.3	M5-7
57	354483	358240	65763246	65405006	355147	664	0.6	1000	22.544	34.948	0.3	M5-7
59	0	0	0	0	0	0	0.6	1000	22.544	34.948	0.3	M5-7
60	129363	133351	38645236	38511885	129440	77	0.6	1000	22.544	34.948	0.3	M5-7
61	0	0	0	0	0	0	0.6	1000	22.544	34.948	0.3	M5-7
62	3	3	10	7	3	0	0.6	1000	22.544	34.948	0.3	M5-7
63	192223	196867	36984300	36787433	192232	9	0.6	1000	22.544	34.948	0.3	M5-7
64	1	1	6	5	1	0	0.6	1000	22.544	34.948	0.3	M5-7
66	203635	205243	23953581	23748338	203641	6	0.6	1000	22.544	34.948	0.3	M5-7
67	1	1	6	5	1	0	0.6	1000	22.544	34.948	0.3	M5-7
69	208657	213269	17249001	17035732	208658	1	0.6	1000	22.544	34.948	0.3	M5-7
70	0	0	0	0	0	0	0.6	1000	22.544	34.948	0.3	M5-7
72	106758	107768	8830503	8722735	106761	3	0.6	1000	22.544	34.948	0.3	M5-7
75	194584	195618	4887501	4691883	194584	0	0.6	1000	22.544	34.948	0.3	M5-7
78	103480	103947	2364225	2260278	103480	0	0.6	1000	22.544	34.948	0.3	M5-7
80	0	0	0	0	0	0	0.6	1000	22.544	34.948	0.3	M5-7
81	4652	4671	307720	303049	4652	0	0.6	1000	22.544	34.948	0.3	M5-7
84	18626	18644	351541	332897	18626	0	0.6	1000	22.544	34.948	0.3	M5-7
85	0	0	0	0	0	0	0.6	1000	22.544	34.948	0.3	M5-7
87	529	529	23653	23124	529	0	0.6	1000	22.544	34.948	0.3	M5-7
90	41892	41911	314821	272910	41892	0	0.6	1000	22.544	34.948	0.3	M5-7
6	0	0	0	0	0	0	0.6	1000	22.552	34.194	0.3	M5-1
8	3	6	6	0	3	0	0.6	1000	22.552	34.194	0.3	M5-1
9	28	28	28	0	28	0	0.6	1000	22.552	34.194	0.3	M5-1
24	9161	9286	76636	67350	9282	121	0.6	1000	22.552	34.194	0.3	M5-1
27	9928	11312	53956	42644	9928	0	0.6	1000	22.552	34.194	0.3	M5-1
30	84740	84807	512578	427771	84741	1	0.6	1000	22.552	34.194	0.3	M5-1
33	15278	16399	1097421	1081022	15288	10	0.6	1000	22.552	34.194	0.3	M5-1
35	0	0	0	0	0	0	0.6	1000	22.552	34.194	0.3	M5-1
36	38268	38513	3324331	3285818	38289	21	0.6	1000	22.552	34.194	0.3	M5-1
37	0	0	0	0	0	0	0.6	1000	22.552	34.194	0.3	M5-1
39	75877	78081	8914753	8836672	75879	2	0.6	1000	22.552	34.194	0.3	M5-1
40	0	0	0	0	0	0	0.6	1000	22.552	34.194	0.3	M5-1
42	166760	168038	24440536	24272498	167156	396	0.6	1000	22.552	34.194	0.3	M5-1
45	187155	190901	46527481	46336580	187339	184	0.6	1000	22.552	34.194	0.3	M5-1
47	0	0	0	0	0	0	0.6	1000	22.552	34.194	0.3	M5-1
48	424272	430088	84142878	83712790	424763	491	0.6	1000	22.552	34.194	0.3	M5-1
49	0	0	0	0	0	0	0.6	1000	22.552	34.194	0.3	M5-1
51	277176	283513	65259600	64976087	278934	1758	0.6	1000	22.552	34.194	0.3	M5-1
54	392680	394658	62826445	62431787	392797	117	0.6	1000	22.552	34.194	0.3	M5-1
55	1	1	1	0	1	0	0.6	1000	22.552	34.194	0.3	M5-1
57	399100	402140	60077241	59675101	399329	229	0.6	1000	22.552	34.194	0.3	M5-1
58	0	0	0	0	0	0	0.6	1000	22.552	34.194	0.3	M5-1
59	0	0	0	0	0	0	0.6	1000	22.552	34.194	0.3	M5-1
60	135526	141584	42878430	42736846	135823	297	0.6	1000	22.552	34.194	0.3	M5-1
61	0	1	1	0	0	0	0.6	1000	22.552	34.194	0.3	M5-1
62	3	3	6	3	3	0	0.6	1000	22.552	34.194	0.3	M5-1
63	282459	283443	33020001	32736558	282522	63	0.6	1000	22.552	34.194	0.3	M5-1
64	0	0	0	0	0	0	0.6	1000	22.552	34.194	0.3	M5-1
66	145229	146922	23225520	23078598	145229	0	0.6	1000	22.552	34.194	0.3	M5-1
69	209853	210783	17877210	17666427	209866	13	0.6	1000	22.552	34.194	0.3	M5-1
72	197326	198785	11005086	10806301	197500	174	0.6	1000	22.552	34.194	0.3	M5-1
75	27109	27401	2809635	2782234	27113	4	0.6	1000	22.552	34.194	0.3	M5-1
76	0	0	0	0	0	0	0.6	1000	22.552	34.194	0.3	M5-1
78	57331	58159	2273778	2215619	57331	0	0.6	1000	22.552	34.194	0.3	M5-1
81	14868	14958	644680	629722	14868	0	0.6	1000	22.552	34.194	0.3	M5-1
84	29235	29526	328455	298929	29235	0	0.6	1000	22.552	34.194	0.3	M5-1
87	4182	4182	52650	48468	4185	3	0.6	1000	22.552	34.194	0.3	M5-1
90	2090	2090	18721	16631	2090	0	0.6	1000	22.552	34.194	0.3	M5-1
3	0	0	1	1	1	1	0.6	1000	22.687	33.796	0.3	M2-6
9	0	0	0	0	0	0	0.6	1000	22.687	33.796	0.3	M2-6
21	0	0	0	0	0	0	0.6	1000	22.687	33.796	0.3	M2-6
24	230	230	21528	21298	298	68	0.6	1000	22.687	33.796	0.3	M2-6
25	0	0	0	0	0	0	0.6	1000	22.687	33.796	0.3	M2-6
27	123	123	24090	23967	143	20	0.6	1000	22.687	33.796	0.3	M2-6
30	985	988	86736	85748	993	8	0.6	1000	22.687	33.796	0.3	M2-6
33	6386	6394	393828	387434	6422	36	0.6	1000	22.687	33.796	0.3	M2-6
36	1286	1338	1046181	1044843	1315	29	0.6	1000	22.687	33.796	0.3	M2-6
39	10732	11574	4477528	4465954	10770	38	0.6	1000	22.687	33.796	0.3	M2-6
42	35530	36757	12199330	12162573	36627	1097	0.6	1000	22.687	33.796	0.3	M2-6
45	9227	9465	13799631	13790166	9478	251	0.6	1000	22.687	33.796	0.3	M2-6
46	0	0	0	0	0	0	0.6	1000	22.687	33.796	0.3	M2-6
47	0	0	1	1	0	0	0.6	1000	22.687	33.796	0.3	M2-6
48	33153	33667	21988396	21954729	33386	233	0.6	1000	22.687	33.796	0.3	M2-6
49	0	0	1	1	0	0	0.6	1000	22.687	33.796	0.3	M2-6
50	0	0	0	0	0	0	0.6	1000	22.687	33.796	0.3	M2-6
51	12891	13071	23718828	23705757	13190	299	0.6	1000	22.687	33.796	0.3	M2-6
54	52714	52975	23505796	23452821	52883	169	0.6	1000	22.687	33.796	0.3	M2-6
57	12791	13056	19198306	19185250	13368	577	0.6	1000	22.687	33.796	0.3	M2-6
60	12238	12478	17668540	17656062	12327	89	0.6	1000	22.687	33.796	0.3	M2-6
63	22450	27271	13778625	13751354	22491	41	0.6	1000	22.687	33.796	0.3	M2-6
66	6015	6121	7463316	7457195	6047	32	0.6	1000	22.687	33.796	0.3	M2-6
67	3	3	3	0	3	0	0.6	1000	22.687	33.796	0.3	M2-6
68	1	1	3	2	1	0	0.6	1000	22.687	33.796	0.3	M2-6
69	170635	170803	8931651	8760848	170691	56	0.6	1000	22.687	33.796	0.3	M2-6
72	4690	4790	3280641	3275851	4770	80	0.6	1000	22.687	33.796	0.3	M2-6
75	17604	17641	1352190	1334549	17616	12	0.6	1000	22.687	33.796	0.3	M2-6
78	1274	1279	592416	591137	1280	6	0.6	1000	22.687	33.796	0.3	M2-6
81	3999	4005	263901	259896	4002	3	0.6	1000	22.687	33.796	0.3	M2-6
84	411	411	124750	124339	411	0	0.6	1000	22.687	33.796	0.3	M2-6
87	120	120	26796	26676	120	0	0.6	1000	22.687	33.796	0.3	M2-6
90	223	224	21321	21097	223	0	0.6	1000	22.687	33.796	0.3	M2-6
98	0	0	0	0	0	0	0.6	1000	22.687	33.796	0.3	M2-6
3	0	0	0	0	0	0	0.6	1000	22.739	33.79	0.5	M2-7
6	0	0	0	0	0	0	0.6	1000	22.739	33.79	0.5	M2-7
9	0	0	0	0	0	0	0.6	1000	22.739	33.79	0.5	M2-7
24	387	387	11175	10788	393	6	0.6	1000	22.739	33.79	0.5	M2-7
27	271	271	17020	16749	303	32	0.6	1000	22.739	33.79	0.5	M2-7
30	1103	1105	112101	110996	1119	16	0.6	1000	22.739	33.79	0.5	M2-7
32	0	0	0	0	0	0	0.6	1000	22.739	33.79	0.5	M2-7
33	11034	11046	559153	548107	11061	27	0.6	1000	22.739	33.79	0.5	M2-7
36	7639	7699	1704781	1697082	7686	47	0.6	1000	22.739	33.79	0.5	M2-7
38	0	0	0	0	0	0	0.6	1000	22.739	33.79	0.5	M2-7
39	20356	20406	4981746	4961340	20398	42	0.6	1000	22.739	33.79	0.5	M2-7
40	0	0	0	0	0	0	0.6	1000	22.739	33.79	0.5	M2-7
42	3043	3199	7990003	7986804	3235	192	0.6	1000	22.739	33.79	0.5	M2-7
43	0	0	0	0	0	0	0.6	1000	22.739	33.79	0.5	M2-7
44	0	0	0	0	0	0	0.6	1000	22.739	33.79	0.5	M2-7
45	172930	173085	17520240	17347155	173341	411	0.6	1000	22.739	33.79	0.5	M2-7
48	23025	23450	24286965	24263515	23554	529	0.6	1000	22.739	33.79	0.5	M2-7
49	0	0	0	0	0	0	0.6	1000	22.739	33.79	0.5	M2-7
50	0	0	0	0	0	0	0.6	1000	22.739	33.79	0.5	M2-7
51	36220	36524	25959615	25923091	36486	266	0.6	1000	22.739	33.79	0.5	M2-7
52	0	0	0	0	0	0	0.6	1000	22.739	33.79	0.5	M2-7
53	0	0	0	0	0	0	0.6	1000	22.739	33.79	0.5	M2-7
54	14702	14798	22663278	22648480	14846	144	0.6	1000	22.739	33.79	0.5	M2-7
55	0	0	0	0	0	0	0.6	1000	22.739	33.79	0.5	M2-7
57	13710	13861	22028203	22014342	14174	464	0.6	1000	22.739	33.79	0.5	M2-7
58	0	0	1	1	0	0	0.6	1000	22.739	33.79	0.5	M2-7
60	29712	29971	16293486	16263515	29773	61	0.6	1000	22.739	33.79	0.5	M2-7
63	9349	9454	13439520	13430066	9450	101	0.6	1000	22.739	33.79	0.5	M2-7
64	0	0	1	1	0	0	0.6	1000	22.739	33.79	0.5	M2-7
65	0	0	0	0	0	0	0.6	1000	22.739	33.79	0.5	M2-7
66	8706	8892	8600878	8591986	8722	16	0.6	1000	22.739	33.79	0.5	M2-7
69	65218	65664	8174946	8109282	65251	33	0.6	1000	22.739	33.79	0.5	M2-7
71	0	0	0	0	0	0	0.6	1000	22.739	33.79	0.5	M2-7
72	5005	5030	2946378	2941348	5032	27	0.6	1000	22.739	33.79	0.5	M2-7
75	513	550	905185	904635	529	16	0.6	1000	22.739	33.79	0.5	M2-7
78	487	511	371953	371442	488	1	0.6	1000	22.739	33.79	0.5	M2-7
81	692	697	219453	218756	692	0	0.6	1000	22.739	33.79	0.5	M2-7
84	542	546	97461	96915	542	0	0.6	1000	22.739	33.79	0.5	M2-7
87	376	376	21736	21360	376	0	0.6	1000	22.739	33.79	0.5	M2-7
90	44	44	4950	4906	44	0	0.6	1000	22.739	33.79	0.5	M2-7
3	1	1	1	0	1	0	0.6	1000	22.766	34.706	0.3	M2-10
9	0	0	0	0	0	0	0.6	1000	22.766	34.706	0.3	M2-10
19	0	0	0	0	0	0	0.6	1000	22.766	34.706	0.3	M2-10
24	33	33	8001	7968	41	8	0.6	1000	22.766	34.706	0.3	M2-10
27	541	541	31125	30584	558	17	0.6	1000	22.766	34.706	0.3	M2-10
30	111	111	61425	61314	113	2	0.6	1000	22.766	34.706	0.3	M2-10
33	623	633	440391	439758	659	36	0.6	1000	22.766	34.706	0.3	M2-10
36	14259	14296	1486950	1472654	14281	22	0.6	1000	22.766	34.706	0.3	M2-10
39	5887	6050	4680270	4674220	5910	23	0.6	1000	22.766	34.706	0.3	M2-10
41	0	0	0	0	0	0	0.6	1000	22.766	34.706	0.3	M2-10
42	6914	7127	9311770	9304643	7206	292	0.6	1000	22.766	34.706	0.3	M2-10
44	0	0	0	0	0	0	0.6	1000	22.766	34.706	0.3	M2-10
45	24731	24931	16316328	16291397	25005	274	0.6	1000	22.766	34.706	0.3	M2-10
46	1	1	1	0	1	0	0.6	1000	22.766	34.706	0.3	M2-10
48	10378	10625	22967253	22956628	10529	151	0.6	1000	22.766	34.706	0.3	M2-10
49	0	0	0	0	0	0	0.6	1000	22.766	34.706	0.3	M2-10
51	176601	176809	31311741	31134932	179276	2675	0.6	1000	22.766	34.706	0.3	M2-10
54	62049	62208	24489501	24427293	62188	139	0.6	1000	22.766	34.706	0.3	M2-10
56	0	0	0	0	0	0	0.6	1000	22.766	34.706	0.3	M2-10
57	11512	11673	18274035	18262362	12150	638	0.6	1000	22.766	34.706	0.3	M2-10
60	20629	21036	16944931	16923895	20688	59	0.6	1000	22.766	34.706	0.3	M2-10
62	0	0	0	0	0	0	0.6	1000	22.766	34.706	0.3	M2-10
63	10159	10526	13007550	12997024	10268	109	0.6	1000	22.766	34.706	0.3	M2-10
66	9902	10022	9721845	9711823	9911	9	0.6	1000	22.766	34.706	0.3	M2-10
69	45438	46472	7478778	7432306	45488	50	0.6	1000	22.766	34.706	0.3	M2-10
72	1890	1948	2648451	2646503	1966	76	0.6	1000	22.766	34.706	0.3	M2-10
73	0	0	0	0	0	0	0.6	1000	22.766	34.706	0.3	M2-10
75	17675	17696	1433971	1416275	17686	11	0.6	1000	22.766	34.706	0.3	M2-10
78	640	645	536130	535485	655	15	0.6	1000	22.766	34.706	0.3	M2-10
79	0	0	0	0	0	0	0.6	1000	22.766	34.706	0.3	M2-10
81	962	970	323610	322640	965	3	0.6	1000	22.766	34.706	0.3	M2-10
84	117	120	83436	83316	117	0	0.6	1000	22.766	34.706	0.3	M2-10
87	231	232	27966	27734	231	0	0.6	1000	22.766	34.706	0.3	M2-10
90	1297	1297	17020	15723	1297	0	0.6	1000	22.766	34.706	0.3	M2-10
3	0	0	1	1	1	1	0.6	1000	22.859	34.932	0.3	M2-2
6	0	0	1	1	0	0	0.6	1000	22.859	34.932	0.3	M2-2
18	0	0	0	0	0	0	0.6	1000	22.859	34.932	0.3	M2-2
24	111	111	16471	16360	125	14	0.6	1000	22.859	34.932	0.3	M2-2
27	160	160	14535	14375	160	0	0.6	1000	22.859	34.932	0.3	M2-2
30	173	174	92665	92491	198	25	0.6	1000	22.859	34.932	0.3	M2-2
33	936	936	392055	391119	1015	79	0.6	1000	22.859	34.932	0.3	M2-2
36	7273	7409	1684530	1677121	7486	213	0.6	1000	22.859	34.932	0.3	M2-2
39	22065	22134	4713985	4691851	22092	27	0.6	1000	22.859	34.932	0.3	M2-2
42	5153	5340	10818226	10812886	5302	149	0.6	1000	22.859	34.932	0.3	M2-2
44	1	1	1	0	1	0	0.6	1000	22.859	34.932	0.3	M2-2
45	16708	17051	17026530	17009479	16906	198	0.6	1000	22.859	34.932	0.3	M2-2
46	0	0	0	0	0	0	0.6	1000	22.859	34.932	0.3	M2-2
48	30916	31132	24559536	24528404	31122	206	0.6	1000	22.859	34.932	0.3	M2-2
49	0	0	0	0	0	0	0.6	1000	22.859	34.932	0.3	M2-2
51	16927	17184	25300941	25283757	17152	225	0.6	1000	22.859	34.932	0.3	M2-2
52	0	0	0	0	0	0	0.6	1000	22.859	34.932	0.3	M2-2
53	0	0	1	1	0	0	0.6	1000	22.859	34.932	0.3	M2-2
54	10069	10321	21264981	21254660	10179	110	0.6	1000	22.859	34.932	0.3	M2-2
57	183581	184015	26060590	25876575	184895	1314	0.6	1000	22.859	34.932	0.3	M2-2
58	0	0	1	1	0	0	0.6	1000	22.859	34.932	0.3	M2-2
59	0	0	0	0	0	0	0.6	1000	22.859	34.932	0.3	M2-2
60	25756	26102	16863528	16837426	25806	50	0.6	1000	22.859	34.932	0.3	M2-2
63	9827	10197	13957686	13947489	9961	134	0.6	1000	22.859	34.932	0.3	M2-2
66	17918	18242	8382465	8364223	17998	80	0.6	1000	22.859	34.932	0.3	M2-2
67	0	0	0	0	0	0	0.6	1000	22.859	34.932	0.3	M2-2
69	3896	3945	5737578	5733633	3929	33	0.6	1000	22.859	34.932	0.3	M2-2
70	0	0	0	0	0	0	0.6	1000	22.859	34.932	0.3	M2-2
72	57562	57705	4323270	4265565	57563	1	0.6	1000	22.859	34.932	0.3	M2-2
74	0	0	1	1	0	0	0.6	1000	22.859	34.932	0.3	M2-2
75	5283	5400	1507716	1502316	5297	14	0.6	1000	22.859	34.932	0.3	M2-2
76	0	0	0	0	0	0	0.6	1000	22.859	34.932	0.3	M2-2
78	418	418	375411	374993	419	1	0.6	1000	22.859	34.932	0.3	M2-2
81	5165	5167	260281	255114	5169	4	0.6	1000	22.859	34.932	0.3	M2-2
84	223	223	87990	87767	224	1	0.6	1000	22.859	34.932	0.3	M2-2
87	299	299	35778	35479	299	0	0.6	1000	22.859	34.932	0.3	M2-2
90	39	40	17205	17165	39	0	0.6	1000	22.859	34.932	0.3	M2-2
3	0	0	1	1	1	1	0.6	1000	22.949	33.622	0.3	M5-4
6	0	0	0	0	0	0	0.6	1000	22.949	33.622	0.3	M5-4
24	7097	7097	53956	46859	7097	0	0.6	1000	22.949	33.622	0.3	M5-4
25	0	0	0	0	0	0	0.6	1000	22.949	33.622	0.3	M5-4
27	3684	3684	61075	57391	3766	82	0.6	1000	22.949	33.622	0.3	M5-4
30	100119	100170	435711	335541	100129	10	0.6	1000	22.949	33.622	0.3	M5-4
33	32722	35009	1511191	1476182	33106	384	0.6	1000	22.949	33.622	0.3	M5-4
36	132534	133535	4965976	4832441	132562	28	0.6	1000	22.949	33.622	0.3	M5-4
39	76026	77207	9080191	9002984	76039	13	0.6	1000	22.949	33.622	0.3	M5-4
42	346540	352180	29533455	29181275	346880	340	0.6	1000	22.949	33.622	0.3	M5-4
43	0	0	0	0	0	0	0.6	1000	22.949	33.622	0.3	M5-4
45	152529	158736	35082876	34924140	152798	269	0.6	1000	22.949	33.622	0.3	M5-4
46	1	1	3	2	1	0	0.6	1000	22.949	33.622	0.3	M5-4
48	231520	233022	59508595	59275573	231581	61	0.6	1000	22.949	33.622	0.3	M5-4
50	0	0	0	0	0	0	0.6	1000	22.949	33.622	0.3	M5-4
51	257611	261406	69225261	68963855	257910	299	0.6	1000	22.949	33.622	0.3	M5-4
53	0	0	0	0	0	0	0.6	1000	22.949	33.622	0.3	M5-4
54	317052	320429	70834753	70514324	317454	402	0.6	1000	22.949	33.622	0.3	M5-4
55	0	0	15	15	0	0	0.6	1000	22.949	33.622	0.3	M5-4
57	389034	400461	63455745	63055284	389422	388	0.6	1000	22.949	33.622	0.3	M5-4
58	1	1	1	0	1	0	0.6	1000	22.949	33.622	0.3	M5-4
59	1	3	6	3	1	0	0.6	1000	22.949	33.622	0.3	M5-4
60	286404	288440	44589846	44301406	286435	31	0.6	1000	22.949	33.622	0.3	M5-4
61	0	0	0	0	0	0	0.6	1000	22.949	33.622	0.3	M5-4
63	287578	290269	39298545	39008276	287787	209	0.6	1000	22.949	33.622	0.3	M5-4
65	0	0	0	0	0	0	0.6	1000	22.949	33.622	0.3	M5-4
66	237683	240244	28076271	27836027	237692	9	0.6	1000	22.949	33.622	0.3	M5-4
67	10	10	36	26	10	0	0.6	1000	22.949	33.622	0.3	M5-4
69	160743	162726	15975378	15812652	160758	15	0.6	1000	22.949	33.622	0.3	M5-4
72	191748	203047	11460078	11257031	191759	11	0.6	1000	22.949	33.622	0.3	M5-4
75	37819	38105	2575315	2537210	37819	0	0.6	1000	22.949	33.622	0.3	M5-4
78	32430	33322	1704781	1671459	32431	1	0.6	1000	22.949	33.622	0.3	M5-4
81	95415	96031	1565565	1469534	95415	0	0.6	1000	22.949	33.622	0.3	M5-4
84	1194	1237	72390	71153	1194	0	0.6	1000	22.949	33.622	0.3	M5-4
87	7124	7124	62481	55357	7124	0	0.6	1000	22.949	33.622	0.3	M5-4
90	3869	3976	28441	24465	3869	0	0.6	1000	22.949	33.622	0.3	M5-4
3	0	0	0	0	0	0	0.6	1000	23.027	33.783	0.3	M2-9
6	0	0	1	1	0	0	0.6	1000	23.027	33.783	0.3	M2-9
24	209	209	20910	20701	217	8	0.6	1000	23.027	33.783	0.3	M2-9
27	36	36	17205	17169	68	32	0.6	1000	23.027	33.783	0.3	M2-9
30	48	51	61075	61024	63	15	0.6	1000	23.027	33.783	0.3	M2-9
33	2563	2574	590241	587667	2578	15	0.6	1000	23.027	33.783	0.3	M2-9
36	18087	18529	1418770	1400241	18168	81	0.6	1000	23.027	33.783	0.3	M2-9
39	3929	4104	3766140	3762036	3963	34	0.6	1000	23.027	33.783	0.3	M2-9
41	0	0	0	0	0	0	0.6	1000	23.027	33.783	0.3	M2-9
42	24709	25026	10476753	10451727	26562	1853	0.6	1000	23.027	33.783	0.3	M2-9
44	0	0	0	0	0	0	0.6	1000	23.027	33.783	0.3	M2-9
45	18139	18311	16730220	16711909	18459	320	0.6	1000	23.027	33.783	0.3	M2-9
48	7501	7820	22147840	22140020	7620	119	0.6	1000	23.027	33.783	0.3	M2-9
49	0	0	0	0	0	0	0.6	1000	23.027	33.783	0.3	M2-9
51	34755	36066	26415546	26379480	35045	290	0.6	1000	23.027	33.783	0.3	M2-9
52	0	0	0	0	0	0	0.6	1000	23.027	33.783	0.3	M2-9
54	36174	36466	24608620	24572154	36346	172	0.6	1000	23.027	33.783	0.3	M2-9
55	0	0	1	1	0	0	0.6	1000	23.027	33.783	0.3	M2-9
57	29894	30222	22028203	21997981	30342	448	0.6	1000	23.027	33.783	0.3	M2-9
59	0	0	0	0	0	0	0.6	1000	23.027	33.783	0.3	M2-9
60	15093	15311	16476670	16461359	15159	66	0.6	1000	23.027	33.783	0.3	M2-9
61	0	0	3	3	0	0	0.6	1000	23.027	33.783	0.3	M2-9
63	8032	8154	11899881	11891727	8049	17	0.6	1000	23.027	33.783	0.3	M2-9
66	54068	54409	9899025	9844616	54087	19	0.6	1000	23.027	33.783	0.3	M2-9
69	4949	5033	5260146	5255113	4996	47	0.6	1000	23.027	33.783	0.3	M2-9
72	7501	7701	2995128	2987427	7614	113	0.6	1000	23.027	33.783	0.3	M2-9
75	2002	2025	1343980	1341955	2016	14	0.6	1000	23.027	33.783	0.3	M2-9
78	650	651	435711	435060	654	4	0.6	1000	23.027	33.783	0.3	M2-9
81	801	803	208335	207532	802	1	0.6	1000	23.027	33.783	0.3	M2-9
84	1170	1170	133386	132216	1172	2	0.6	1000	23.027	33.783	0.3	M2-9
87	200	200	21945	21745	200	0	0.6	1000	23.027	33.783	0.3	M2-9
90	127	127	16471	16344	128	1	0.6	1000	23.027	33.783	0.3	M2-9
2	0	0	0	0	0	0	0.6	1000	23.143	35.097	0.5	M5-6
9	0	0	0	0	0	0	0.6	1000	23.143	35.097	0.5	M5-6
12	0	0	0	0	0	0	0.6	1000	23.143	35.097	0.5	M5-6
14	0	0	0	0	0	0	0.6	1000	23.143	35.097	0.5	M5-6
23	0	0	0	0	0	0	0.6	1000	23.143	35.097	0.5	M5-6
24	6138	6139	39340	33201	6144	6	0.6	1000	23.143	35.097	0.5	M5-6
27	1247	1253	28203	26950	1257	10	0.6	1000	23.143	35.097	0.5	M5-6
28	0	0	0	0	0	0	0.6	1000	23.143	35.097	0.5	M5-6
30	9186	9392	330891	321499	9274	88	0.6	1000	23.143	35.097	0.5	M5-6
33	15373	15548	975106	959558	15380	7	0.6	1000	23.143	35.097	0.5	M5-6
36	24726	25335	3242331	3216996	24734	8	0.6	1000	23.143	35.097	0.5	M5-6
39	253561	291631	14207115	13915484	253563	2	0.6	1000	23.143	35.097	0.5	M5-6
40	0	0	0	0	0	0	0.6	1000	23.143	35.097	0.5	M5-6
41	0	0	1	1	0	0	0.6	1000	23.143	35.097	0.5	M5-6
42	260285	264231	32833356	32569125	260688	403	0.6	1000	23.143	35.097	0.5	M5-6
45	405330	422919	59759778	59336859	406217	887	0.6	1000	23.143	35.097	0.5	M5-6
48	511153	512948	73441140	72928192	511256	103	0.6	1000	23.143	35.097	0.5	M5-6
49	0	0	0	0	0	0	0.6	1000	23.143	35.097	0.5	M5-6
50	1	1	3	2	1	0	0.6	1000	23.143	35.097	0.5	M5-6
51	326402	336587	71670378	71333791	327678	1276	0.6	1000	23.143	35.097	0.5	M5-6
52	0	0	1	1	0	0	0.6	1000	23.143	35.097	0.5	M5-6
53	0	0	0	0	0	0	0.6	1000	23.143	35.097	0.5	M5-6
54	299868	302607	65054121	64751514	300042	174	0.6	1000	23.143	35.097	0.5	M5-6
56	0	0	1	1	0	0	0.6	1000	23.143	35.097	0.5	M5-6
57	141142	146321	47292675	47146354	142595	1453	0.6	1000	23.143	35.097	0.5	M5-6
58	0	0	1	1	0	0	0.6	1000	23.143	35.097	0.5	M5-6
59	0	0	0	0	0	0	0.6	1000	23.143	35.097	0.5	M5-6
60	290462	293561	49625703	49332142	290622	160	0.6	1000	23.143	35.097	0.5	M5-6
62	0	0	0	0	0	0	0.6	1000	23.143	35.097	0.5	M5-6
63	432082	464512	45120250	44655738	432128	46	0.6	1000	23.143	35.097	0.5	M5-6
64	0	0	3	3	0	0	0.6	1000	23.143	35.097	0.5	M5-6
65	0	0	0	0	0	0	0.6	1000	23.143	35.097	0.5	M5-6
66	144134	145281	21069786	20924505	144140	6	0.6	1000	23.143	35.097	0.5	M5-6
68	0	0	1	1	0	0	0.6	1000	23.143	35.097	0.5	M5-6
69	61633	62053	12647935	12585882	61642	9	0.6	1000	23.143	35.097	0.5	M5-6
71	0	0	0	0	0	0	0.6	1000	23.143	35.097	0.5	M5-6
72	81237	82032	9607536	9525504	81239	2	0.6	1000	23.143	35.097	0.5	M5-6
75	64199	67076	4261740	4194664	64199	0	0.6	1000	23.143	35.097	0.5	M5-6
78	29727	29908	1514670	1484762	29729	2	0.6	1000	23.143	35.097	0.5	M5-6
80	0	0	0	0	0	0	0.6	1000	23.143	35.097	0.5	M5-6
81	17566	17584	406351	388767	17566	0	0.6	1000	23.143	35.097	0.5	M5-6
83	0	0	0	0	0	0	0.6	1000	23.143	35.097	0.5	M5-6
84	4674	4779	160461	155682	4674	0	0.6	1000	23.143	35.097	0.5	M5-6
87	16514	16514	77815	61301	16514	0	0.6	1000	23.143	35.097	0.5	M5-6
90	643	644	9870	9226	643	0	0.6	1000	23.143	35.097	0.5	M5-6
3	0	0	0	0	0	0	0.6	1000	23.169	33.993	0.1	M2-7
6	0	0	0	0	0	0	0.6	1000	23.169	33.993	0.1	M2-7
9	0	0	0	0	0	0	0.6	1000	23.169	33.993	0.1	M2-7
24	387	387	11175	10788	393	6	0.6	1000	23.169	33.993	0.1	M2-7
27	271	271	17020	16749	303	32	0.6	1000	23.169	33.993	0.1	M2-7
30	1103	1105	112101	110996	1119	16	0.6	1000	23.169	33.993	0.1	M2-7
32	0	0	0	0	0	0	0.6	1000	23.169	33.993	0.1	M2-7
33	11034	11046	559153	548107	11061	27	0.6	1000	23.169	33.993	0.1	M2-7
36	7575	7699	1704781	1697082	7630	55	0.6	1000	23.169	33.993	0.1	M2-7
38	0	0	0	0	0	0	0.6	1000	23.169	33.993	0.1	M2-7
39	20233	20406	4981746	4961340	20262	29	0.6	1000	23.169	33.993	0.1	M2-7
40	0	0	0	0	0	0	0.6	1000	23.169	33.993	0.1	M2-7
42	2829	3199	7990003	7986804	3004	175	0.6	1000	23.169	33.993	0.1	M2-7
43	0	0	0	0	0	0	0.6	1000	23.169	33.993	0.1	M2-7
44	0	0	0	0	0	0	0.6	1000	23.169	33.993	0.1	M2-7
45	172579	173085	17520240	17347155	172897	318	0.6	1000	23.169	33.993	0.1	M2-7
48	22697	23450	24286965	24263515	23223	526	0.6	1000	23.169	33.993	0.1	M2-7
49	0	0	0	0	0	0	0.6	1000	23.169	33.993	0.1	M2-7
50	0	0	0	0	0	0	0.6	1000	23.169	33.993	0.1	M2-7
51	35811	36524	25959615	25923091	36020	209	0.6	1000	23.169	33.993	0.1	M2-7
52	0	0	0	0	0	0	0.6	1000	23.169	33.993	0.1	M2-7
53	0	0	0	0	0	0	0.6	1000	23.169	33.993	0.1	M2-7
54	14440	14798	22663278	22648480	14547	107	0.6	1000	23.169	33.993	0.1	M2-7
55	0	0	0	0	0	0	0.6	1000	23.169	33.993	0.1	M2-7
57	13487	13861	22028203	22014342	13886	399	0.6	1000	23.169	33.993	0.1	M2-7
58	0	0	1	1	0	0	0.6	1000	23.169	33.993	0.1	M2-7
60	29498	29971	16293486	16263515	29566	68	0.6	1000	23.169	33.993	0.1	M2-7
63	9251	9454	13439520	13430066	9337	86	0.6	1000	23.169	33.993	0.1	M2-7
64	0	0	1	1	0	0	0.6	1000	23.169	33.993	0.1	M2-7
65	0	0	0	0	0	0	0.6	1000	23.169	33.993	0.1	M2-7
66	8519	8892	8600878	8591986	8533	14	0.6	1000	23.169	33.993	0.1	M2-7
69	65027	65664	8174946	8109282	65057	30	0.6	1000	23.169	33.993	0.1	M2-7
71	0	0	0	0	0	0	0.6	1000	23.169	33.993	0.1	M2-7
72	4475	5030	2946378	2941348	4495	20	0.6	1000	23.169	33.993	0.1	M2-7
75	480	550	905185	904635	481	1	0.6	1000	23.169	33.993	0.1	M2-7
78	487	511	371953	371442	488	1	0.6	1000	23.169	33.993	0.1	M2-7
81	692	697	219453	218756	692	0	0.6	1000	23.169	33.993	0.1	M2-7
84	542	546	97461	96915	542	0	0.6	1000	23.169	33.993	0.1	M2-7
87	376	376	21736	21360	376	0	0.6	1000	23.169	33.993	0.1	M2-7
90	44	44	4950	4906	44	0	0.6	1000	23.169	33.993	0.1	M2-7
3	0	0	1	1	1	1	0.6	1000	23.364	32.687	0.3	M2-4
24	10	10	7750	7740	16	6	0.6	1000	23.364	32.687	0.3	M2-4
27	41	41	15576	15535	81	40	0.6	1000	23.364	32.687	0.3	M2-4
28	0	0	0	0	0	0	0.6	1000	23.364	32.687	0.3	M2-4
30	755	755	77028	76273	762	7	0.6	1000	23.364	32.687	0.3	M2-4
33	792	809	342378	341569	812	20	0.6	1000	23.364	32.687	0.3	M2-4
35	0	0	0	0	0	0	0.6	1000	23.364	32.687	0.3	M2-4
36	1143	1198	1407003	1405805	1171	28	0.6	1000	23.364	32.687	0.3	M2-4
39	30143	30320	5067336	5037016	30178	35	0.6	1000	23.364	32.687	0.3	M2-4
42	20543	21266	10312611	10291345	20744	201	0.6	1000	23.364	32.687	0.3	M2-4
45	11827	12313	15337491	15325178	12104	277	0.6	1000	23.364	32.687	0.3	M2-4
46	0	0	3	3	0	0	0.6	1000	23.364	32.687	0.3	M2-4
48	12706	12943	21776700	21763757	12896	190	0.6	1000	23.364	32.687	0.3	M2-4
49	0	0	0	0	0	0	0.6	1000	23.364	32.687	0.3	M2-4
51	75186	75341	30431701	30356360	75763	577	0.6	1000	23.364	32.687	0.3	M2-4
54	10578	10917	21730528	21719611	10684	106	0.6	1000	23.364	32.687	0.3	M2-4
56	0	0	0	0	0	0	0.6	1000	23.364	32.687	0.3	M2-4
57	25518	25962	23574411	23548449	25787	269	0.6	1000	23.364	32.687	0.3	M2-4
58	0	0	0	0	0	0	0.6	1000	23.364	32.687	0.3	M2-4
59	0	0	0	0	0	0	0.6	1000	23.364	32.687	0.3	M2-4
60	28280	29883	18614151	18584268	28340	60	0.6	1000	23.364	32.687	0.3	M2-4
63	4984	5094	12442566	12437472	5030	46	0.6	1000	23.364	32.687	0.3	M2-4
64	0	0	0	0	0	0	0.6	1000	23.364	32.687	0.3	M2-4
65	0	0	0	0	0	0	0.6	1000	23.364	32.687	0.3	M2-4
66	6547	6683	7791378	7784695	6552	5	0.6	1000	23.364	32.687	0.3	M2-4
69	13741	13794	5516181	5502387	13766	25	0.6	1000	23.364	32.687	0.3	M2-4
72	23439	23734	3746953	3723219	23468	29	0.6	1000	23.364	32.687	0.3	M2-4
75	6027	6228	1343980	1337752	6029	2	0.6	1000	23.364	32.687	0.3	M2-4
78	563	574	397386	396812	582	19	0.6	1000	23.364	32.687	0.3	M2-4
81	1191	1218	327645	326427	1192	1	0.6	1000	23.364	32.687	0.3	M2-4
84	100	100	64980	64880	100	0	0.6	1000	23.364	32.687	0.3	M2-4
87	353	366	43071	42705	353	0	0.6	1000	23.364	32.687	0.3	M2-4
90	344	344	21945	21601	348	4	0.6	1000	23.364	32.687	0.3	M2-4
3	1	1	1	0	1	0	0.6	1000	23.426	35.765	0.5	M2-10
9	0	0	0	0	0	0	0.6	1000	23.426	35.765	0.5	M2-10
19	0	0	0	0	0	0	0.6	1000	23.426	35.765	0.5	M2-10
24	33	33	8001	7968	41	8	0.6	1000	23.426	35.765	0.5	M2-10
27	541	541	31125	30584	558	17	0.6	1000	23.426	35.765	0.5	M2-10
30	111	111	61425	61314	113	2	0.6	1000	23.426	35.765	0.5	M2-10
33	623	633	440391	439758	659	36	0.6	1000	23.426	35.765	0.5	M2-10
36	14252	14296	1486950	1472654	14286	34	0.6	1000	23.426	35.765	0.5	M2-10
39	5979	6050	4680270	4674220	6001	22	0.6	1000	23.426	35.765	0.5	M2-10
41	0	0	0	0	0	0	0.6	1000	23.426	35.765	0.5	M2-10
42	6904	7127	9311770	9304643	7178	274	0.6	1000	23.426	35.765	0.5	M2-10
44	0	0	0	0	0	0	0.6	1000	23.426	35.765	0.5	M2-10
45	24741	24931	16316328	16291397	25033	292	0.6	1000	23.426	35.765	0.5	M2-10
46	1	1	1	0	1	0	0.6	1000	23.426	35.765	0.5	M2-10
48	10466	10625	22967253	22956628	10631	165	0.6	1000	23.426	35.765	0.5	M2-10
49	0	0	0	0	0	0	0.6	1000	23.426	35.765	0.5	M2-10
51	176076	176809	31311741	31134932	176318	242	0.6	1000	23.426	35.765	0.5	M2-10
54	62084	62208	24489501	24427293	62232	148	0.6	1000	23.426	35.765	0.5	M2-10
56	0	0	0	0	0	0	0.6	1000	23.426	35.765	0.5	M2-10
57	11555	11673	18274035	18262362	12191	636	0.6	1000	23.426	35.765	0.5	M2-10
60	20769	21036	16944931	16923895	20830	61	0.6	1000	23.426	35.765	0.5	M2-10
62	0	0	0	0	0	0	0.6	1000	23.426	35.765	0.5	M2-10
63	10251	10526	13007550	12997024	10360	109	0.6	1000	23.426	35.765	0.5	M2-10
66	9922	10022	9721845	9711823	9930	8	0.6	1000	23.426	35.765	0.5	M2-10
69	45531	46472	7478778	7432306	45589	58	0.6	1000	23.426	35.765	0.5	M2-10
72	1913	1948	2648451	2646503	1988	75	0.6	1000	23.426	35.765	0.5	M2-10
73	0	0	0	0	0	0	0.6	1000	23.426	35.765	0.5	M2-10
75	17682	17696	1433971	1416275	17692	10	0.6	1000	23.426	35.765	0.5	M2-10
78	640	645	536130	535485	655	15	0.6	1000	23.426	35.765	0.5	M2-10
79	0	0	0	0	0	0	0.6	1000	23.426	35.765	0.5	M2-10
81	962	970	323610	322640	965	3	0.6	1000	23.426	35.765	0.5	M2-10
84	117	120	83436	83316	117	0	0.6	1000	23.426	35.765	0.5	M2-10
87	231	232	27966	27734	231	0	0.6	1000	23.426	35.765	0.5	M2-10
90	1297	1297	17020	15723	1297	0	0.6	1000	23.426	35.765	0.5	M2-10
3	0	0	1	1	1	1	0.6	1000	23.501	34.971	0.5	M2-2
6	0	0	1	1	0	0	0.6	1000	23.501	34.971	0.5	M2-2
18	0	0	0	0	0	0	0.6	1000	23.501	34.971	0.5	M2-2
24	111	111	16471	16360	125	14	0.6	1000	23.501	34.971	0.5	M2-2
27	160	160	14535	14375	160	0	0.6	1000	23.501	34.971	0.5	M2-2
30	173	174	92665	92491	198	25	0.6	1000	23.501	34.971	0.5	M2-2
33	936	936	392055	391119	1015	79	0.6	1000	23.501	34.971	0.5	M2-2
36	7282	7409	1684530	1677121	7511	229	0.6	1000	23.501	34.971	0.5	M2-2
39	22104	22134	4713985	4691851	22135	31	0.6	1000	23.501	34.971	0.5	M2-2
42	5246	5340	10818226	10812886	5499	253	0.6	1000	23.501	34.971	0.5	M2-2
44	1	1	1	0	1	0	0.6	1000	23.501	34.971	0.5	M2-2
45	16725	17051	17026530	17009479	16934	209	0.6	1000	23.501	34.971	0.5	M2-2
46	0	0	0	0	0	0	0.6	1000	23.501	34.971	0.5	M2-2
48	30932	31132	24559536	24528404	31121	189	0.6	1000	23.501	34.971	0.5	M2-2
49	0	0	0	0	0	0	0.6	1000	23.501	34.971	0.5	M2-2
51	17004	17184	25300941	25283757	17271	267	0.6	1000	23.501	34.971	0.5	M2-2
52	0	0	0	0	0	0	0.6	1000	23.501	34.971	0.5	M2-2
53	0	0	1	1	0	0	0.6	1000	23.501	34.971	0.5	M2-2
54	10139	10321	21264981	21254660	10256	117	0.6	1000	23.501	34.971	0.5	M2-2
57	183625	184015	26060590	25876575	184606	981	0.6	1000	23.501	34.971	0.5	M2-2
58	0	0	1	1	0	0	0.6	1000	23.501	34.971	0.5	M2-2
59	0	0	0	0	0	0	0.6	1000	23.501	34.971	0.5	M2-2
60	25808	26102	16863528	16837426	25860	52	0.6	1000	23.501	34.971	0.5	M2-2
63	9868	10197	13957686	13947489	10007	139	0.6	1000	23.501	34.971	0.5	M2-2
66	17946	18242	8382465	8364223	18043	97	0.6	1000	23.501	34.971	0.5	M2-2
67	0	0	0	0	0	0	0.6	1000	23.501	34.971	0.5	M2-2
69	3907	3945	5737578	5733633	3934	27	0.6	1000	23.501	34.971	0.5	M2-2
70	0	0	0	0	0	0	0.6	1000	23.501	34.971	0.5	M2-2
72	57636	57705	4323270	4265565	57638	2	0.6	1000	23.501	34.971	0.5	M2-2
74	0	0	1	1	0	0	0.6	1000	23.501	34.971	0.5	M2-2
75	5291	5400	1507716	1502316	5315	24	0.6	1000	23.501	34.971	0.5	M2-2
76	0	0	0	0	0	0	0.6	1000	23.501	34.971	0.5	M2-2
78	418	418	375411	374993	419	1	0.6	1000	23.501	34.971	0.5	M2-2
81	5165	5167	260281	255114	5169	4	0.6	1000	23.501	34.971	0.5	M2-2
84	223	223	87990	87767	224	1	0.6	1000	23.501	34.971	0.5	M2-2
87	299	299	35778	35479	299	0	0.6	1000	23.501	34.971	0.5	M2-2
90	39	40	17205	17165	39	0	0.6	1000	23.501	34.971	0.5	M2-2
3	0	0	0	0	0	0	0.6	1000	23.567	33.606	0.5	M2-9
6	0	0	1	1	0	0	0.6	1000	23.567	33.606	0.5	M2-9
24	209	209	20910	20701	217	8	0.6	1000	23.567	33.606	0.5	M2-9
27	36	36	17205	17169	68	32	0.6	1000	23.567	33.606	0.5	M2-9
30	48	51	61075	61024	63	15	0.6	1000	23.567	33.606	0.5	M2-9
33	2563	2574	590241	587667	2578	15	0.6	1000	23.567	33.606	0.5	M2-9
36	18134	18529	1418770	1400241	18218	84	0.6	1000	23.567	33.606	0.5	M2-9
39	3937	4104	3766140	3762036	3978	41	0.6	1000	23.567	33.606	0.5	M2-9
41	0	0	0	0	0	0	0.6	1000	23.567	33.606	0.5	M2-9
42	24723	25026	10476753	10451727	26772	2049	0.6	1000	23.567	33.606	0.5	M2-9
44	0	0	0	0	0	0	0.6	1000	23.567	33.606	0.5	M2-9
45	18181	18311	16730220	16711909	18395	214	0.6	1000	23.567	33.606	0.5	M2-9
48	7633	7820	22147840	22140020	7765	132	0.6	1000	23.567	33.606	0.5	M2-9
49	0	0	0	0	0	0	0.6	1000	23.567	33.606	0.5	M2-9
51	34616	36066	26415546	26379480	34949	333	0.6	1000	23.567	33.606	0.5	M2-9
52	0	0	0	0	0	0	0.6	1000	23.567	33.606	0.5	M2-9
54	36233	36466	24608620	24572154	36387	154	0.6	1000	23.567	33.606	0.5	M2-9
55	0	0	1	1	0	0	0.6	1000	23.567	33.606	0.5	M2-9
57	30000	30222	22028203	21997981	30485	485	0.6	1000	23.567	33.606	0.5	M2-9
59	0	0	0	0	0	0	0.6	1000	23.567	33.606	0.5	M2-9
60	15085	15311	16476670	16461359	15149	64	0.6	1000	23.567	33.606	0.5	M2-9
61	0	0	3	3	0	0	0.6	1000	23.567	33.606	0.5	M2-9
63	8072	8154	11899881	11891727	8091	19	0.6	1000	23.567	33.606	0.5	M2-9
66	54165	54409	9899025	9844616	54185	20	0.6	1000	23.567	33.606	0.5	M2-9
69	4986	5033	5260146	5255113	5038	52	0.6	1000	23.567	33.606	0.5	M2-9
72	7521	7701	2995128	2987427	7634	113	0.6	1000	23.567	33.606	0.5	M2-9
75	2008	2025	1343980	1341955	2023	15	0.6	1000	23.567	33.606	0.5	M2-9
78	650	651	435711	435060	654	4	0.6	1000	23.567	33.606	0.5	M2-9
81	801	803	208335	207532	802	1	0.6	1000	23.567	33.606	0.5	M2-9
84	1170	1170	133386	132216	1172	2	0.6	1000	23.567	33.606	0.5	M2-9
87	200	200	21945	21745	200	0	0.6	1000	23.567	33.606	0.5	M2-9
90	127	127	16471	16344	128	1	0.6	1000	23.567	33.606	0.5	M2-9
3	0	0	3	3	3	3	0.6	1000	23.623	35.162	0.5	M2-3
18	0	0	0	0	0	0	0.6	1000	23.623	35.162	0.5	M2-3
24	79	81	17205	17124	90	11	0.6	1000	23.623	35.162	0.5	M2-3
27	95	95	32385	32290	129	34	0.6	1000	23.623	35.162	0.5	M2-3
30	256	256	73920	73664	285	29	0.6	1000	23.623	35.162	0.5	M2-3
33	4273	4281	524800	520519	4295	22	0.6	1000	23.623	35.162	0.5	M2-3
36	3150	3184	1449253	1446069	3188	38	0.6	1000	23.623	35.162	0.5	M2-3
39	21596	21847	5189031	5167184	21612	16	0.6	1000	23.623	35.162	0.5	M2-3
42	7907	8039	10656036	10647997	8355	448	0.6	1000	23.623	35.162	0.5	M2-3
45	18636	18762	15615666	15596904	19045	409	0.6	1000	23.623	35.162	0.5	M2-3
48	20231	20667	21362916	21342249	20367	136	0.6	1000	23.623	35.162	0.5	M2-3
49	0	0	0	0	0	0	0.6	1000	23.623	35.162	0.5	M2-3
51	21189	21389	27598735	27577346	21440	251	0.6	1000	23.623	35.162	0.5	M2-3
54	15323	15480	20778681	20763201	15464	141	0.6	1000	23.623	35.162	0.5	M2-3
55	0	0	6	6	0	0	0.6	1000	23.623	35.162	0.5	M2-3
56	0	0	0	0	0	0	0.6	1000	23.623	35.162	0.5	M2-3
57	12105	12319	19980681	19968362	12720	615	0.6	1000	23.623	35.162	0.5	M2-3
58	0	0	0	0	0	0	0.6	1000	23.623	35.162	0.5	M2-3
60	34862	35327	20272528	20237201	34917	55	0.6	1000	23.623	35.162	0.5	M2-3
62	0	0	0	0	0	0	0.6	1000	23.623	35.162	0.5	M2-3
63	31607	31663	14658405	14626742	31726	119	0.6	1000	23.623	35.162	0.5	M2-3
65	0	0	1	1	0	0	0.6	1000	23.623	35.162	0.5	M2-3
66	7802	7934	8256016	8248082	7821	19	0.6	1000	23.623	35.162	0.5	M2-3
69	47642	47737	6285285	6237548	47765	123	0.6	1000	23.623	35.162	0.5	M2-3
70	0	0	0	0	0	0	0.6	1000	23.623	35.162	0.5	M2-3
71	0	0	0	0	0	0	0.6	1000	23.623	35.162	0.5	M2-3
72	25361	25428	4238416	4212988	25376	15	0.6	1000	23.623	35.162	0.5	M2-3
75	2918	2941	1059240	1056299	2928	10	0.6	1000	23.623	35.162	0.5	M2-3
76	0	0	0	0	0	0	0.6	1000	23.623	35.162	0.5	M2-3
78	527	529	423660	423131	536	9	0.6	1000	23.623	35.162	0.5	M2-3
81	3750	3750	349030	345280	3750	0	0.6	1000	23.623	35.162	0.5	M2-3
84	881	881	125250	124369	881	0	0.6	1000	23.623	35.162	0.5	M2-3
87	363	363	31626	31263	363	0	0.6	1000	23.623	35.162	0.5	M2-3
90	19	19	11476	11457	19	0	0.6	1000	23.623	35.162	0.5	M2-3
3	0	0	1	1	1	1	0.6	1000	23.736	33.552	0.5	M2-4
24	10	10	7750	7740	16	6	0.6	1000	23.736	33.552	0.5	M2-4
27	41	41	15576	15535	81	40	0.6	1000	23.736	33.552	0.5	M2-4
28	0	0	0	0	0	0	0.6	1000	23.736	33.552	0.5	M2-4
30	755	755	77028	76273	762	7	0.6	1000	23.736	33.552	0.5	M2-4
33	792	809	342378	341569	812	20	0.6	1000	23.736	33.552	0.5	M2-4
35	0	0	0	0	0	0	0.6	1000	23.736	33.552	0.5	M2-4
36	1149	1198	1407003	1405805	1181	32	0.6	1000	23.736	33.552	0.5	M2-4
39	30179	30320	5067336	5037016	30218	39	0.6	1000	23.736	33.552	0.5	M2-4
42	20823	21266	10312611	10291345	20975	152	0.6	1000	23.736	33.552	0.5	M2-4
45	11932	12313	15337491	15325178	12298	366	0.6	1000	23.736	33.552	0.5	M2-4
46	0	0	3	3	0	0	0.6	1000	23.736	33.552	0.5	M2-4
48	12756	12943	21776700	21763757	12962	206	0.6	1000	23.736	33.552	0.5	M2-4
49	0	0	0	0	0	0	0.6	1000	23.736	33.552	0.5	M2-4
51	75224	75341	30431701	30356360	75772	548	0.6	1000	23.736	33.552	0.5	M2-4
54	10792	10917	21730528	21719611	10887	95	0.6	1000	23.736	33.552	0.5	M2-4
56	0	0	0	0	0	0	0.6	1000	23.736	33.552	0.5	M2-4
57	25581	25962	23574411	23548449	25892	311	0.6	1000	23.736	33.552	0.5	M2-4
58	0	0	0	0	0	0	0.6	1000	23.736	33.552	0.5	M2-4
59	0	0	0	0	0	0	0.6	1000	23.736	33.552	0.5	M2-4
60	29102	29883	18614151	18584268	29166	64	0.6	1000	23.736	33.552	0.5	M2-4
63	5009	5094	12442566	12437472	5057	48	0.6	1000	23.736	33.552	0.5	M2-4
64	0	0	0	0	0	0	0.6	1000	23.736	33.552	0.5	M2-4
65	0	0	0	0	0	0	0.6	1000	23.736	33.552	0.5	M2-4
66	6551	6683	7791378	7784695	6556	5	0.6	1000	23.736	33.552	0.5	M2-4
69	13748	13794	5516181	5502387	13775	27	0.6	1000	23.736	33.552	0.5	M2-4
72	23490	23734	3746953	3723219	23521	31	0.6	1000	23.736	33.552	0.5	M2-4
75	6123	6228	1343980	1337752	6126	3	0.6	1000	23.736	33.552	0.5	M2-4
78	563	574	397386	396812	582	19	0.6	1000	23.736	33.552	0.5	M2-4
81	1191	1218	327645	326427	1192	1	0.6	1000	23.736	33.552	0.5	M2-4
84	100	100	64980	64880	100	0	0.6	1000	23.736	33.552	0.5	M2-4
87	353	366	43071	42705	353	0	0.6	1000	23.736	33.552	0.5	M2-4
90	344	344	21945	21601	348	4	0.6	1000	23.736	33.552	0.5	M2-4
24	101957	102152	254541	152389	101957	0	0.6	1000	23.877	37.084	1.0	M5-8
27	118718	118718	318801	200083	118718	0	0.6	1000	23.877	37.084	1.0	M5-8
30	2188	2234	135981	133747	2202	14	0.6	1000	23.877	37.084	1.0	M5-8
33	26665	27746	1319500	1291754	26674	9	0.6	1000	23.877	37.084	1.0	M5-8
35	0	0	0	0	0	0	0.6	1000	23.877	37.084	1.0	M5-8
36	56906	57821	2951235	2893414	56918	12	0.6	1000	23.877	37.084	1.0	M5-8
39	155794	158036	12890503	12732467	155900	106	0.6	1000	23.877	37.084	1.0	M5-8
41	0	0	0	0	0	0	0.6	1000	23.877	37.084	1.0	M5-8
42	262420	269184	28618395	28349211	262525	105	0.6	1000	23.877	37.084	1.0	M5-8
45	307943	311238	45768528	45457290	308619	676	0.6	1000	23.877	37.084	1.0	M5-8
46	0	0	0	0	0	0	0.6	1000	23.877	37.084	1.0	M5-8
47	21	21	28	7	21	0	0.6	1000	23.877	37.084	1.0	M5-8
48	379522	383779	64553203	64169424	379590	68	0.6	1000	23.877	37.084	1.0	M5-8
49	6	6	15	9	6	0	0.6	1000	23.877	37.084	1.0	M5-8
50	0	0	0	0	0	0	0.6	1000	23.877	37.084	1.0	M5-8
51	222301	224402	60428521	60204119	222373	72	0.6	1000	23.877	37.084	1.0	M5-8
52	1	1	1	0	1	0	0.6	1000	23.877	37.084	1.0	M5-8
53	0	0	1	1	0	0	0.6	1000	23.877	37.084	1.0	M5-8
54	228328	230638	57657691	57427053	228429	101	0.6	1000	23.877	37.084	1.0	M5-8
55	1	1	6	5	1	0	0.6	1000	23.877	37.084	1.0	M5-8
57	332689	334699	68357278	68022579	332930	241	0.6	1000	23.877	37.084	1.0	M5-8
60	410583	413840	62580078	62166238	410595	12	0.6	1000	23.877	37.084	1.0	M5-8
63	247205	248261	45205786	44957525	247209	4	0.6	1000	23.877	37.084	1.0	M5-8
64	0	0	0	0	0	0	0.6	1000	23.877	37.084	1.0	M5-8
65	0	0	0	0	0	0	0.6	1000	23.877	37.084	1.0	M5-8
66	276476	277979	24454521	24176542	276491	15	0.6	1000	23.877	37.084	1.0	M5-8
69	124215	125482	16459453	16333971	124218	3	0.6	1000	23.877	37.084	1.0	M5-8
72	126245	128582	8398851	8270269	126252	7	0.6	1000	23.877	37.084	1.0	M5-8
75	17005	17750	2577585	2559835	17006	1	0.6	1000	23.877	37.084	1.0	M5-8
77	0	0	0	0	0	0	0.6	1000	23.877	37.084	1.0	M5-8
78	30822	32051	1121253	1089202	30823	1	0.6	1000	23.877	37.084	1.0	M5-8
79	3	3	3	0	3	0	0.6	1000	23.877	37.084	1.0	M5-8
81	18564	18604	523776	505172	18565	1	0.6	1000	23.877	37.084	1.0	M5-8
82	0	0	0	0	0	0	0.6	1000	23.877	37.084	1.0	M5-8
84	21170	21184	356590	335406	21170	0	0.6	1000	23.877	37.084	1.0	M5-8
87	1161	1193	59340	58147	1161	0	0.6	1000	23.877	37.084	1.0	M5-8
90	1001	1001	14196	13195	1001	0	0.6	1000	23.877	37.084	1.0	M5-8
6	0	0	0	0	0	0	0.6	1000	23.945	34.843	0.5	M5-1
8	3	6	6	0	3	0	0.6	1000	23.945	34.843	0.5	M5-1
9	28	28	28	0	28	0	0.6	1000	23.945	34.843	0.5	M5-1
24	9161	9286	76636	67350	9282	121	0.6	1000	23.945	34.843	0.5	M5-1
27	9928	11312	53956	42644	9928	0	0.6	1000	23.945	34.843	0.5	M5-1
30	84740	84807	512578	427771	84741	1	0.6	1000	23.945	34.843	0.5	M5-1
33	15278	16399	1097421	1081022	15288	10	0.6	1000	23.945	34.843	0.5	M5-1
35	0	0	0	0	0	0	0.6	1000	23.945	34.843	0.5	M5-1
36	38135	38513	3324331	3285818	38158	23	0.6	1000	23.945	34.843	0.5	M5-1
37	0	0	0	0	0	0	0.6	1000	23.945	34.843	0.5	M5-1
39	76302	78081	8914753	8836672	76304	2	0.6	1000	23.945	34.843	0.5	M5-1
40	0	0	0	0	0	0	0.6	1000	23.945	34.843	0.5	M5-1
42	165053	168038	24440536	24272498	165441	388	0.6	1000	23.945	34.843	0.5	M5-1
45	180942	190901	46527481	46336580	181183	241	0.6	1000	23.945	34.843	0.5	M5-1
47	0	0	0	0	0	0	0.6	1000	23.945	34.843	0.5	M5-1
48	423770	430088	84142878	83712790	424281	511	0.6	1000	23.945	34.843	0.5	M5-1
49	0	0	0	0	0	0	0.6	1000	23.945	34.843	0.5	M5-1
51	278185	283513	65259600	64976087	279987	1802	0.6	1000	23.945	34.843	0.5	M5-1
54	386446	394658	62826445	62431787	386563	117	0.6	1000	23.945	34.843	0.5	M5-1
55	1	1	1	0	1	0	0.6	1000	23.945	34.843	0.5	M5-1
57	400269	402140	60077241	59675101	400493	224	0.6	1000	23.945	34.843	0.5	M5-1
58	0	0	0	0	0	0	0.6	1000	23.945	34.843	0.5	M5-1
59	0	0	0	0	0	0	0.6	1000	23.945	34.843	0.5	M5-1
60	138332	141584	42878430	42736846	138636	304	0.6	1000	23.945	34.843	0.5	M5-1
61	0	1	1	0	0	0	0.6	1000	23.945	34.843	0.5	M5-1
62	3	3	6	3	3	0	0.6	1000	23.945	34.843	0.5	M5-1
63	282507	283443	33020001	32736558	282570	63	0.6	1000	23.945	34.843	0.5	M5-1
64	0	0	0	0	0	0	0.6	1000	23.945	34.843	0.5	M5-1
66	144208	146922	23225520	23078598	144208	0	0.6	1000	23.945	34.843	0.5	M5-1
69	210209	210783	17877210	17666427	210232	23	0.6	1000	23.945	34.843	0.5	M5-1
72	197329	198785	11005086	10806301	197511	182	0.6	1000	23.945	34.843	0.5	M5-1
75	27174	27401	2809635	2782234	27178	4	0.6	1000	23.945	34.843	0.5	M5-1
76	0	0	0	0	0	0	0.6	1000	23.945	34.843	0.5	M5-1
78	57357	58159	2273778	2215619	57357	0	0.6	1000	23.945	34.843	0.5	M5-1
81	14868	14958	644680	629722	14868	0	0.6	1000	23.945	34.843	0.5	M5-1
84	29235	29526	328455	298929	29235	0	0.6	1000	23.945	34.843	0.5	M5-1
87	4182	4182	52650	48468	4185	3	0.6	1000	23.945	34.843	0.5	M5-1
90	2090	2090	18721	16631	2090	0	0.6	1000	23.945	34.843	0.5	M5-1
3	0	0	0	0	0	0	0.6	1000	23.965	35.006	0.5	M2-1
12	1	1	1	0	1	0	0.6	1000	23.965	35.006	0.5	M2-1
15	0	0	0	0	0	0	0.6	1000	23.965	35.006	0.5	M2-1
24	80	80	17391	17311	132	52	0.6	1000	23.965	35.006	0.5	M2-1
27	58	58	20706	20648	65	7	0.6	1000	23.965	35.006	0.5	M2-1
30	316	317	102831	102514	326	10	0.6	1000	23.965	35.006	0.5	M2-1
33	760	781	571915	571134	808	48	0.6	1000	23.965	35.006	0.5	M2-1
36	1442	1518	1530375	1528857	1513	71	0.6	1000	23.965	35.006	0.5	M2-1
39	13307	13402	4501500	4488098	13376	69	0.6	1000	23.965	35.006	0.5	M2-1
41	0	0	0	0	0	0	0.6	1000	23.965	35.006	0.5	M2-1
42	28475	28588	10010575	9981987	28719	244	0.6	1000	23.965	35.006	0.5	M2-1
43	0	0	1	1	0	0	0.6	1000	23.965	35.006	0.5	M2-1
45	14995	15621	16522626	16507005	15215	220	0.6	1000	23.965	35.006	0.5	M2-1
46	0	0	1	1	0	0	0.6	1000	23.965	35.006	0.5	M2-1
48	32075	32345	24398605	24366260	32256	181	0.6	1000	23.965	35.006	0.5	M2-1
51	13958	14167	23988201	23974034	14294	336	0.6	1000	23.965	35.006	0.5	M2-1
52	0	0	0	0	0	0	0.6	1000	23.965	35.006	0.5	M2-1
54	33858	34863	24217320	24182457	34016	158	0.6	1000	23.965	35.006	0.5	M2-1
55	0	0	0	0	0	0	0.6	1000	23.965	35.006	0.5	M2-1
57	28364	28771	23932821	23904050	29222	858	0.6	1000	23.965	35.006	0.5	M2-1
58	0	0	0	0	0	0	0.6	1000	23.965	35.006	0.5	M2-1
59	0	0	1	1	0	0	0.6	1000	23.965	35.006	0.5	M2-1
60	13911	14059	16869336	16855277	13970	59	0.6	1000	23.965	35.006	0.5	M2-1
61	0	0	0	0	0	0	0.6	1000	23.965	35.006	0.5	M2-1
62	0	0	0	0	0	0	0.6	1000	23.965	35.006	0.5	M2-1
63	19789	19873	11608971	11589098	19852	63	0.6	1000	23.965	35.006	0.5	M2-1
64	0	0	0	0	0	0	0.6	1000	23.965	35.006	0.5	M2-1
66	42470	42563	7755891	7713328	42486	16	0.6	1000	23.965	35.006	0.5	M2-1
68	0	0	0	0	0	0	0.6	1000	23.965	35.006	0.5	M2-1
69	2675	2772	4928230	4925458	2709	34	0.6	1000	23.965	35.006	0.5	M2-1
72	2692	2716	2248260	2245544	2710	18	0.6	1000	23.965	35.006	0.5	M2-1
73	0	0	1	1	0	0	0.6	1000	23.965	35.006	0.5	M2-1
75	165153	166303	2494261	2327958	165160	7	0.6	1000	23.965	35.006	0.5	M2-1
78	606	617	541320	540703	626	20	0.6	1000	23.965	35.006	0.5	M2-1
81	18083	18097	402753	384656	18083	0	0.6	1000	23.965	35.006	0.5	M2-1
84	295	296	95703	95407	295	0	0.6	1000	23.965	35.006	0.5	M2-1
87	93	102	20100	19998	93	0	0.6	1000	23.965	35.006	0.5	M2-1
90	2	2	9045	9043	2	0	0.6	1000	23.965	35.006	0.5	M2-1
3	0	0	0	0	0	0	0.6	1000	24.016	33.82	0.5	M2-8
6	0	0	0	0	0	0	0.6	1000	24.016	33.82	0.5	M2-8
8	0	0	0	0	0	0	0.6	1000	24.016	33.82	0.5	M2-8
12	0	0	0	0	0	0	0.6	1000	24.016	33.82	0.5	M2-8
15	0	0	0	0	0	0	0.6	1000	24.016	33.82	0.5	M2-8
18	0	0	1	1	0	0	0.6	1000	24.016	33.82	0.5	M2-8
24	53	53	17578	17525	62	9	0.6	1000	24.016	33.82	0.5	M2-8
27	11	11	21528	21517	37	26	0.6	1000	24.016	33.82	0.5	M2-8
28	0	0	0	0	0	0	0.6	1000	24.016	33.82	0.5	M2-8
30	262	263	58653	58390	266	4	0.6	1000	24.016	33.82	0.5	M2-8
32	0	0	0	0	0	0	0.6	1000	24.016	33.82	0.5	M2-8
33	1467	1514	578350	576836	1485	18	0.6	1000	24.016	33.82	0.5	M2-8
36	15328	15366	1853775	1838409	15370	42	0.6	1000	24.016	33.82	0.5	M2-8
38	0	0	1	1	0	0	0.6	1000	24.016	33.82	0.5	M2-8
39	5857	6403	4450636	4444233	5894	37	0.6	1000	24.016	33.82	0.5	M2-8
40	0	0	0	0	0	0	0.6	1000	24.016	33.82	0.5	M2-8
42	23735	23875	10131751	10107876	24251	516	0.6	1000	24.016	33.82	0.5	M2-8
45	6344	6498	13543410	13536912	6602	258	0.6	1000	24.016	33.82	0.5	M2-8
46	0	0	0	0	0	0	0.6	1000	24.016	33.82	0.5	M2-8
48	10571	10669	22408165	22397496	10754	183	0.6	1000	24.016	33.82	0.5	M2-8
49	0	0	1	1	0	0	0.6	1000	24.016	33.82	0.5	M2-8
51	9786	9914	22636356	22626442	10042	256	0.6	1000	24.016	33.82	0.5	M2-8
52	0	0	1	1	0	0	0.6	1000	24.016	33.82	0.5	M2-8
54	15841	16473	21849355	21832882	15926	85	0.6	1000	24.016	33.82	0.5	M2-8
55	0	0	0	0	0	0	0.6	1000	24.016	33.82	0.5	M2-8
57	16157	16371	21803106	21786735	16672	515	0.6	1000	24.016	33.82	0.5	M2-8
58	0	0	0	0	0	0	0.6	1000	24.016	33.82	0.5	M2-8
59	0	0	0	0	0	0	0.6	1000	24.016	33.82	0.5	M2-8
60	12715	12784	16921653	16908869	12765	50	0.6	1000	24.016	33.82	0.5	M2-8
62	0	0	0	0	0	0	0.6	1000	24.016	33.82	0.5	M2-8
63	26956	27543	13984116	13956573	26996	40	0.6	1000	24.016	33.82	0.5	M2-8
65	0	0	1	1	0	0	0.6	1000	24.016	33.82	0.5	M2-8
66	35730	36059	11565645	11529586	35746	16	0.6	1000	24.016	33.82	0.5	M2-8
68	0	0	0	0	0	0	0.6	1000	24.016	33.82	0.5	M2-8
69	9156	9212	6144265	6135053	9198	42	0.6	1000	24.016	33.82	0.5	M2-8
70	0	0	0	0	0	0	0.6	1000	24.016	33.82	0.5	M2-8
72	26994	27532	3128751	3101219	27405	411	0.6	1000	24.016	33.82	0.5	M2-8
73	0	0	0	0	0	0	0.6	1000	24.016	33.82	0.5	M2-8
75	2606	2645	1226961	1224316	2615	9	0.6	1000	24.016	33.82	0.5	M2-8
78	1792	1802	671061	669259	1807	15	0.6	1000	24.016	33.82	0.5	M2-8
81	5308	5308	299151	293843	5309	1	0.6	1000	24.016	33.82	0.5	M2-8
84	243	243	96141	95898	245	2	0.6	1000	24.016	33.82	0.5	M2-8
87	702	703	61776	61073	702	0	0.6	1000	24.016	33.82	0.5	M2-8
90	425	428	14365	13937	425	0	0.6	1000	24.016	33.82	0.5	M2-8
3	0	0	0	0	0	0	0.6	1000	24.069	34.246	0.3	M2-8
6	0	0	0	0	0	0	0.6	1000	24.069	34.246	0.3	M2-8
8	0	0	0	0	0	0	0.6	1000	24.069	34.246	0.3	M2-8
12	0	0	0	0	0	0	0.6	1000	24.069	34.246	0.3	M2-8
15	0	0	0	0	0	0	0.6	1000	24.069	34.246	0.3	M2-8
18	0	0	1	1	0	0	0.6	1000	24.069	34.246	0.3	M2-8
24	53	53	17578	17525	62	9	0.6	1000	24.069	34.246	0.3	M2-8
27	11	11	21528	21517	37	26	0.6	1000	24.069	34.246	0.3	M2-8
28	0	0	0	0	0	0	0.6	1000	24.069	34.246	0.3	M2-8
30	262	263	58653	58390	266	4	0.6	1000	24.069	34.246	0.3	M2-8
32	0	0	0	0	0	0	0.6	1000	24.069	34.246	0.3	M2-8
33	1467	1514	578350	576836	1485	18	0.6	1000	24.069	34.246	0.3	M2-8
36	15313	15366	1853775	1838409	15345	32	0.6	1000	24.069	34.246	0.3	M2-8
38	0	0	1	1	0	0	0.6	1000	24.069	34.246	0.3	M2-8
39	5896	6403	4450636	4444233	5919	23	0.6	1000	24.069	34.246	0.3	M2-8
40	0	0	0	0	0	0	0.6	1000	24.069	34.246	0.3	M2-8
42	23632	23875	10131751	10107876	24151	519	0.6	1000	24.069	34.246	0.3	M2-8
45	6330	6498	13543410	13536912	6573	243	0.6	1000	24.069	34.246	0.3	M2-8
46	0	0	0	0	0	0	0.6	1000	24.069	34.246	0.3	M2-8
48	10478	10669	22408165	22397496	10637	159	0.6	1000	24.069	34.246	0.3	M2-8
49	0	0	1	1	0	0	0.6	1000	24.069	34.246	0.3	M2-8
51	9768	9914	22636356	22626442	10027	259	0.6	1000	24.069	34.246	0.3	M2-8
52	0	0	1	1	0	0	0.6	1000	24.069	34.246	0.3	M2-8
54	15745	16473	21849355	21832882	15835	90	0.6	1000	24.069	34.246	0.3	M2-8
55	0	0	0	0	0	0	0.6	1000	24.069	34.246	0.3	M2-8
57	16068	16371	21803106	21786735	16573	505	0.6	1000	24.069	34.246	0.3	M2-8
58	0	0	0	0	0	0	0.6	1000	24.069	34.246	0.3	M2-8
59	0	0	0	0	0	0	0.6	1000	24.069	34.246	0.3	M2-8
60	12639	12784	16921653	16908869	12689	50	0.6	1000	24.069	34.246	0.3	M2-8
62	0	0	0	0	0	0	0.6	1000	24.069	34.246	0.3	M2-8
63	26883	27543	13984116	13956573	26927	44	0.6	1000	24.069	34.246	0.3	M2-8
65	0	0	1	1	0	0	0.6	1000	24.069	34.246	0.3	M2-8
66	35722	36059	11565645	11529586	35738	16	0.6	1000	24.069	34.246	0.3	M2-8
68	0	0	0	0	0	0	0.6	1000	24.069	34.246	0.3	M2-8
69	9076	9212	6144265	6135053	9111	35	0.6	1000	24.069	34.246	0.3	M2-8
70	0	0	0	0	0	0	0.6	1000	24.069	34.246	0.3	M2-8
72	26945	27532	3128751	3101219	27356	411	0.6	1000	24.069	34.246	0.3	M2-8
73	0	0	0	0	0	0	0.6	1000	24.069	34.246	0.3	M2-8
75	2612	2645	1226961	1224316	2621	9	0.6	1000	24.069	34.246	0.3	M2-8
78	1786	1802	671061	669259	1791	5	0.6	1000	24.069	34.246	0.3	M2-8
81	5308	5308	299151	293843	5309	1	0.6	1000	24.069	34.246	0.3	M2-8
84	243	243	96141	95898	245	2	0.6	1000	24.069	34.246	0.3	M2-8
87	702	703	61776	61073	702	0	0.6	1000	24.069	34.246	0.3	M2-8
90	425	428	14365	13937	425	0	0.6	1000	24.069	34.246	0.3	M2-8
6	0	0	0	0	0	0	0.6	1000	24.071	31.051	1.0	M5-1
8	3	6	6	0	3	0	0.6	1000	24.071	31.051	1.0	M5-1
9	28	28	28	0	28	0	0.6	1000	24.071	31.051	1.0	M5-1
24	9161	9286	76636	67350	9282	121	0.6	1000	24.071	31.051	1.0	M5-1
27	9928	11312	53956	42644	9928	0	0.6	1000	24.071	31.051	1.0	M5-1
30	84740	84807	512578	427771	84741	1	0.6	1000	24.071	31.051	1.0	M5-1
33	15278	16399	1097421	1081022	15288	10	0.6	1000	24.071	31.051	1.0	M5-1
35	0	0	0	0	0	0	0.6	1000	24.071	31.051	1.0	M5-1
36	38392	38513	3324331	3285818	38422	30	0.6	1000	24.071	31.051	1.0	M5-1
37	0	0	0	0	0	0	0.6	1000	24.071	31.051	1.0	M5-1
39	75263	78081	8914753	8836672	75265	2	0.6	1000	24.071	31.051	1.0	M5-1
40	0	0	0	0	0	0	0.6	1000	24.071	31.051	1.0	M5-1
42	165925	168038	24440536	24272498	166040	115	0.6	1000	24.071	31.051	1.0	M5-1
45	181392	190901	46527481	46336580	181571	179	0.6	1000	24.071	31.051	1.0	M5-1
47	0	0	0	0	0	0	0.6	1000	24.071	31.051	1.0	M5-1
48	424076	430088	84142878	83712790	424571	495	0.6	1000	24.071	31.051	1.0	M5-1
49	0	0	0	0	0	0	0.6	1000	24.071	31.051	1.0	M5-1
51	280272	283513	65259600	64976087	282047	1775	0.6	1000	24.071	31.051	1.0	M5-1
54	392839	394658	62826445	62431787	392946	107	0.6	1000	24.071	31.051	1.0	M5-1
55	1	1	1	0	1	0	0.6	1000	24.071	31.051	1.0	M5-1
57	400340	402140	60077241	59675101	400562	222	0.6	1000	24.071	31.051	1.0	M5-1
58	0	0	0	0	0	0	0.6	1000	24.071	31.051	1.0	M5-1
59	0	0	0	0	0	0	0.6	1000	24.071	31.051	1.0	M5-1
60	138715	141584	42878430	42736846	139023	308	0.6	1000	24.071	31.051	1.0	M5-1
61	0	1	1	0	0	0	0.6	1000	24.071	31.051	1.0	M5-1
62	3	3	6	3	3	0	0.6	1000	24.071	31.051	1.0	M5-1
63	282571	283443	33020001	32736558	282634	63	0.6	1000	24.071	31.051	1.0	M5-1
64	0	0	0	0	0	0	0.6	1000	24.071	31.051	1.0	M5-1
66	145514	146922	23225520	23078598	145514	0	0.6	1000	24.071	31.051	1.0	M5-1
69	209870	210783	17877210	17666427	209905	35	0.6	1000	24.071	31.051	1.0	M5-1
72	197525	198785	11005086	10806301	197707	182	0.6	1000	24.071	31.051	1.0	M5-1
75	27215	27401	2809635	2782234	27219	4	0.6	1000	24.071	31.051	1.0	M5-1
76	0	0	0	0	0	0	0.6	1000	24.071	31.051	1.0	M5-1
78	57367	58159	2273778	2215619	57367	0	0.6	1000	24.071	31.051	1.0	M5-1
81	14868	14958	644680	629722	14868	0	0.6	1000	24.071	31.051	1.0	M5-1
84	29235	29526	328455	298929	29235	0	0.6	1000	24.071	31.051	1.0	M5-1
87	4182	4182	52650	48468	4185	3	0.6	1000	24.071	31.051	1.0	M5-1
90	2090	2090	18721	16631	2090	0	0.6	1000	24.071	31.051	1.0	M5-1
3	0	0	1	1	1	1	0.6	1000	24.111	33.706	0.5	M2-6
9	0	0	0	0	0	0	0.6	1000	24.111	33.706	0.5	M2-6
21	0	0	0	0	0	0	0.6	1000	24.111	33.706	0.5	M2-6
24	230	230	21528	21298	298	68	0.6	1000	24.111	33.706	0.5	M2-6
25	0	0	0	0	0	0	0.6	1000	24.111	33.706	0.5	M2-6
27	123	123	24090	23967	143	20	0.6	1000	24.111	33.706	0.5	M2-6
30	985	988	86736	85748	993	8	0.6	1000	24.111	33.706	0.5	M2-6
33	6386	6394	393828	387434	6422	36	0.6	1000	24.111	33.706	0.5	M2-6
36	1300	1338	1046181	1044843	1332	32	0.6	1000	24.111	33.706	0.5	M2-6
39	10936	11574	4477528	4465954	10974	38	0.6	1000	24.111	33.706	0.5	M2-6
42	35317	36757	12199330	12162573	35568	251	0.6	1000	24.111	33.706	0.5	M2-6
45	9254	9465	13799631	13790166	9567	313	0.6	1000	24.111	33.706	0.5	M2-6
46	0	0	0	0	0	0	0.6	1000	24.111	33.706	0.5	M2-6
47	0	0	1	1	0	0	0.6	1000	24.111	33.706	0.5	M2-6
48	33201	33667	21988396	21954729	33450	249	0.6	1000	24.111	33.706	0.5	M2-6
49	0	0	1	1	0	0	0.6	1000	24.111	33.706	0.5	M2-6
50	0	0	0	0	0	0	0.6	1000	24.111	33.706	0.5	M2-6
51	12955	13071	23718828	23705757	13256	301	0.6	1000	24.111	33.706	0.5	M2-6
54	52768	52975	23505796	23452821	52934	166	0.6	1000	24.111	33.706	0.5	M2-6
57	12867	13056	19198306	19185250	13502	635	0.6	1000	24.111	33.706	0.5	M2-6
60	12283	12478	17668540	17656062	12366	83	0.6	1000	24.111	33.706	0.5	M2-6
63	22497	27271	13778625	13751354	22547	50	0.6	1000	24.111	33.706	0.5	M2-6
66	6076	6121	7463316	7457195	6108	32	0.6	1000	24.111	33.706	0.5	M2-6
67	3	3	3	0	3	0	0.6	1000	24.111	33.706	0.5	M2-6
68	1	1	3	2	1	0	0.6	1000	24.111	33.706	0.5	M2-6
69	170714	170803	8931651	8760848	170781	67	0.6	1000	24.111	33.706	0.5	M2-6
72	4727	4790	3280641	3275851	4807	80	0.6	1000	24.111	33.706	0.5	M2-6
75	17626	17641	1352190	1334549	17645	19	0.6	1000	24.111	33.706	0.5	M2-6
78	1274	1279	592416	591137	1280	6	0.6	1000	24.111	33.706	0.5	M2-6
81	3999	4005	263901	259896	4002	3	0.6	1000	24.111	33.706	0.5	M2-6
84	411	411	124750	124339	411	0	0.6	1000	24.111	33.706	0.5	M2-6
87	120	120	26796	26676	120	0	0.6	1000	24.111	33.706	0.5	M2-6
90	223	224	21321	21097	223	0	0.6	1000	24.111	33.706	0.5	M2-6
98	0	0	0	0	0	0	0.6	1000	24.111	33.706	0.5	M2-6
9	0	0	0	0	0	0	0.6	1000	24.222	35.643	1.0	M5-10
24	4023	4025	51681	47656	4023	0	0.6	1000	24.222	35.643	1.0	M5-10
27	2691	2691	42778	40087	2691	0	0.6	1000	24.222	35.643	1.0	M5-10
28	0	0	0	0	0	0	0.6	1000	24.222	35.643	1.0	M5-10
30	5642	5687	220780	215093	5642	0	0.6	1000	24.222	35.643	1.0	M5-10
33	74184	75175	1973091	1897916	74191	7	0.6	1000	24.222	35.643	1.0	M5-10
34	1	1	1	0	1	0	0.6	1000	24.222	35.643	1.0	M5-10
36	69208	70553	4850055	4779502	69219	11	0.6	1000	24.222	35.643	1.0	M5-10
38	3	3	3	0	3	0	0.6	1000	24.222	35.643	1.0	M5-10
39	88795	94977	11536806	11441829	88803	8	0.6	1000	24.222	35.643	1.0	M5-10
42	175251	178861	27117930	26939069	175442	191	0.6	1000	24.222	35.643	1.0	M5-10
45	409706	413139	47438670	47025531	410032	326	0.6	1000	24.222	35.643	1.0	M5-10
46	0	0	1	1	0	0	0.6	1000	24.222	35.643	1.0	M5-10
48	290185	292743	58584900	58292157	290230	45	0.6	1000	24.222	35.643	1.0	M5-10
51	424463	426369	82593378	82167009	424835	372	0.6	1000	24.222	35.643	1.0	M5-10
52	0	0	1	1	0	0	0.6	1000	24.222	35.643	1.0	M5-10
54	157821	162520	53618190	53455670	157958	137	0.6	1000	24.222	35.643	1.0	M5-10
56	0	0	0	0	0	0	0.6	1000	24.222	35.643	1.0	M5-10
57	381826	388265	62010816	61622551	382120	294	0.6	1000	24.222	35.643	1.0	M5-10
58	0	0	0	0	0	0	0.6	1000	24.222	35.643	1.0	M5-10
59	0	0	0	0	0	0	0.6	1000	24.222	35.643	1.0	M5-10
60	395354	398622	51171786	50773164	395383	29	0.6	1000	24.222	35.643	1.0	M5-10
63	317450	323841	37320480	36996639	317543	93	0.6	1000	24.222	35.643	1.0	M5-10
64	0	0	0	0	0	0	0.6	1000	24.222	35.643	1.0	M5-10
65	0	0	0	0	0	0	0.6	1000	24.222	35.643	1.0	M5-10
66	115905	120664	25300941	25180277	116012	107	0.6	1000	24.222	35.643	1.0	M5-10
69	151071	158025	18816045	18658020	151078	7	0.6	1000	24.222	35.643	1.0	M5-10
70	0	0	1	1	0	0	0.6	1000	24.222	35.643	1.0	M5-10
71	1	1	1	0	1	0	0.6	1000	24.222	35.643	1.0	M5-10
72	200098	203877	10499653	10295776	200155	57	0.6	1000	24.222	35.643	1.0	M5-10
75	56696	57625	3584503	3526878	56696	0	0.6	1000	24.222	35.643	1.0	M5-10
78	28850	29049	1492128	1463079	28850	0	0.6	1000	24.222	35.643	1.0	M5-10
81	5657	5697	324415	318718	5664	7	0.6	1000	24.222	35.643	1.0	M5-10
84	22261	22546	234270	211724	22261	0	0.6	1000	24.222	35.643	1.0	M5-10
87	861	866	42195	41329	881	20	0.6	1000	24.222	35.643	1.0	M5-10
89	0	0	0	0	0	0	0.6	1000	24.222	35.643	1.0	M5-10
90	8671	8673	50086	41413	8671	0	0.6	1000	24.222	35.643	1.0	M5-10
3	0	0	1	1	1	1	0.6	1000	24.715	35.575	0.5	M5-4
6	0	0	0	0	0	0	0.6	1000	24.715	35.575	0.5	M5-4
24	7097	7097	53956	46859	7097	0	0.6	1000	24.715	35.575	0.5	M5-4
25	0	0	0	0	0	0	0.6	1000	24.715	35.575	0.5	M5-4
27	3684	3684	61075	57391	3766	82	0.6	1000	24.715	35.575	0.5	M5-4
30	100119	100170	435711	335541	100129	10	0.6	1000	24.715	35.575	0.5	M5-4
33	32722	35009	1511191	1476182	33106	384	0.6	1000	24.715	35.575	0.5	M5-4
36	132598	133535	4965976	4832441	132630	32	0.6	1000	24.715	35.575	0.5	M5-4
39	76112	77207	9080191	9002984	76125	13	0.6	1000	24.715	35.575	0.5	M5-4
42	346700	352180	29533455	29181275	347034	334	0.6	1000	24.715	35.575	0.5	M5-4
43	0	0	0	0	0	0	0.6	1000	24.715	35.575	0.5	M5-4
45	152511	158736	35082876	34924140	152768	257	0.6	1000	24.715	35.575	0.5	M5-4
46	1	1	3	2	1	0	0.6	1000	24.715	35.575	0.5	M5-4
48	231602	233022	59508595	59275573	231664	62	0.6	1000	24.715	35.575	0.5	M5-4
50	0	0	0	0	0	0	0.6	1000	24.715	35.575	0.5	M5-4
51	257761	261406	69225261	68963855	258061	300	0.6	1000	24.715	35.575	0.5	M5-4
53	0	0	0	0	0	0	0.6	1000	24.715	35.575	0.5	M5-4
54	317620	320429	70834753	70514324	318022	402	0.6	1000	24.715	35.575	0.5	M5-4
55	0	0	15	15	0	0	0.6	1000	24.715	35.575	0.5	M5-4
57	389187	400461	63455745	63055284	390871	1684	0.6	1000	24.715	35.575	0.5	M5-4
58	1	1	1	0	1	0	0.6	1000	24.715	35.575	0.5	M5-4
59	1	3	6	3	1	0	0.6	1000	24.715	35.575	0.5	M5-4
60	285288	288440	44589846	44301406	285311	23	0.6	1000	24.715	35.575	0.5	M5-4
61	0	0	0	0	0	0	0.6	1000	24.715	35.575	0.5	M5-4
63	288117	290269	39298545	39008276	288326	209	0.6	1000	24.715	35.575	0.5	M5-4
65	0	0	0	0	0	0	0.6	1000	24.715	35.575	0.5	M5-4
66	238002	240244	28076271	27836027	238009	7	0.6	1000	24.715	35.575	0.5	M5-4
67	10	10	36	26	10	0	0.6	1000	24.715	35.575	0.5	M5-4
69	160963	162726	15975378	15812652	160978	15	0.6	1000	24.715	35.575	0.5	M5-4
72	201141	203047	11460078	11257031	201150	9	0.6	1000	24.715	35.575	0.5	M5-4
75	37758	38105	2575315	2537210	37758	0	0.6	1000	24.715	35.575	0.5	M5-4
78	32465	33322	1704781	1671459	32466	1	0.6	1000	24.715	35.575	0.5	M5-4
81	95329	96031	1565565	1469534	95329	0	0.6	1000	24.715	35.575	0.5	M5-4
84	1194	1237	72390	71153	1194	0	0.6	1000	24.715	35.575	0.5	M5-4
87	7124	7124	62481	55357	7124	0	0.6	1000	24.715	35.575	0.5	M5-4
90	3869	3976	28441	24465	3869	0	0.6	1000	24.715	35.575	0.5	M5-4
2	0	0	0	0	0	0	0.6	1000	24.729	38.019	1.0	M5-9
24	177	177	6786	6609	183	6	0.6	1000	24.729	38.019	1.0	M5-9
27	725	737	23871	23134	725	0	0.6	1000	24.729	38.019	1.0	M5-9
30	6565	6576	241165	234589	6575	10	0.6	1000	24.729	38.019	1.0	M5-9
33	200529	201488	2189278	1987790	200535	6	0.6	1000	24.729	38.019	1.0	M5-9
36	56644	57215	3491403	3434188	56652	8	0.6	1000	24.729	38.019	1.0	M5-9
37	0	0	0	0	0	0	0.6	1000	24.729	38.019	1.0	M5-9
39	32690	36069	7378561	7342492	32697	7	0.6	1000	24.729	38.019	1.0	M5-9
42	133438	137222	23780856	23643634	133835	397	0.6	1000	24.729	38.019	1.0	M5-9
44	0	0	0	0	0	0	0.6	1000	24.729	38.019	1.0	M5-9
45	99376	104239	35604141	35499902	99468	92	0.6	1000	24.729	38.019	1.0	M5-9
48	213866	216627	55762080	55545453	213899	33	0.6	1000	24.729	38.019	1.0	M5-9
49	0	0	0	0	0	0	0.6	1000	24.729	38.019	1.0	M5-9
50	190	190	210	20	190	0	0.6	1000	24.729	38.019	1.0	M5-9
51	437009	441159	87615703	87174544	437191	182	0.6	1000	24.729	38.019	1.0	M5-9
52	3	3	15	12	3	0	0.6	1000	24.729	38.019	1.0	M5-9
54	329104	332560	79046451	78713891	329225	121	0.6	1000	24.729	38.019	1.0	M5-9
55	0	0	0	0	0	0	0.6	1000	24.729	38.019	1.0	M5-9
57	226682	239552	57111328	56871776	227378	696	0.6	1000	24.729	38.019	1.0	M5-9
60	718858	725573	75885040	75159467	718901	43	0.6	1000	24.729	38.019	1.0	M5-9
63	178042	178994	30862296	30683302	179496	1454	0.6	1000	24.729	38.019	1.0	M5-9
64	1	1	1	0	1	0	0.6	1000	24.729	38.019	1.0	M5-9
65	0	0	0	0	0	0	0.6	1000	24.729	38.019	1.0	M5-9
66	277176	278881	26082253	25803372	277176	0	0.6	1000	24.729	38.019	1.0	M5-9
67	0	0	0	0	0	0	0.6	1000	24.729	38.019	1.0	M5-9
68	0	0	0	0	0	0	0.6	1000	24.729	38.019	1.0	M5-9
69	118749	121659	11231430	11109771	118782	33	0.6	1000	24.729	38.019	1.0	M5-9
71	0	0	0	0	0	0	0.6	1000	24.729	38.019	1.0	M5-9
72	184949	185224	11768526	11583302	184953	4	0.6	1000	24.729	38.019	1.0	M5-9
75	38157	38610	3121251	3082641	38158	1	0.6	1000	24.729	38.019	1.0	M5-9
78	29830	29894	1483503	1453609	29830	0	0.6	1000	24.729	38.019	1.0	M5-9
79	2278	2278	2278	0	2278	0	0.6	1000	24.729	38.019	1.0	M5-9
81	64663	64982	1242676	1177694	64663	0	0.6	1000	24.729	38.019	1.0	M5-9
82	1	1	1	0	1	0	0.6	1000	24.729	38.019	1.0	M5-9
83	0	0	1	1	0	0	0.6	1000	24.729	38.019	1.0	M5-9
84	3502	3530	134940	131410	3502	0	0.6	1000	24.729	38.019	1.0	M5-9
87	3860	3861	67528	63667	3860	0	0.6	1000	24.729	38.019	1.0	M5-9
90	3033	3033	28441	25408	3033	0	0.6	1000	24.729	38.019	1.0	M5-9
3	0	0	1	1	1	1	0.6	1000	25.281	33.605	0.5	M2-5
6	0	0	0	0	0	0	0.6	1000	25.281	33.605	0.5	M2-5
21	0	0	0	0	0	0	0.6	1000	25.281	33.605	0.5	M2-5
24	79	79	14878	14799	89	10	0.6	1000	25.281	33.605	0.5	M2-5
27	341	341	31375	31034	363	22	0.6	1000	25.281	33.605	0.5	M2-5
29	0	0	0	0	0	0	0.6	1000	25.281	33.605	0.5	M2-5
30	1950	1952	144991	143039	1978	28	0.6	1000	25.281	33.605	0.5	M2-5
33	568	582	456490	455908	594	26	0.6	1000	25.281	33.605	0.5	M2-5
36	959	975	1390278	1389303	1012	53	0.6	1000	25.281	33.605	0.5	M2-5
39	19824	20025	4766328	4746303	19860	36	0.6	1000	25.281	33.605	0.5	M2-5
42	14600	14738	8729931	8715193	14837	237	0.6	1000	25.281	33.605	0.5	M2-5
43	0	0	0	0	0	0	0.6	1000	25.281	33.605	0.5	M2-5
45	11056	11227	14228445	14217218	11375	319	0.6	1000	25.281	33.605	0.5	M2-5
48	10061	10242	20972526	20962284	10276	215	0.6	1000	25.281	33.605	0.5	M2-5
50	0	0	1	1	0	0	0.6	1000	25.281	33.605	0.5	M2-5
51	55650	55910	26038936	25983026	55918	268	0.6	1000	25.281	33.605	0.5	M2-5
54	12830	12924	20444815	20431891	12885	55	0.6	1000	25.281	33.605	0.5	M2-5
57	25973	27415	23553816	23526401	26422	449	0.6	1000	25.281	33.605	0.5	M2-5
59	0	0	0	0	0	0	0.6	1000	25.281	33.605	0.5	M2-5
60	20045	20205	18063055	18042850	20128	83	0.6	1000	25.281	33.605	0.5	M2-5
62	0	0	0	0	0	0	0.6	1000	25.281	33.605	0.5	M2-5
63	48389	48491	13694761	13646270	48438	49	0.6	1000	25.281	33.605	0.5	M2-5
65	1	1	1	0	1	0	0.6	1000	25.281	33.605	0.5	M2-5
66	5915	6063	8600878	8594815	5936	21	0.6	1000	25.281	33.605	0.5	M2-5
69	21439	21721	6317235	6295514	21501	62	0.6	1000	25.281	33.605	0.5	M2-5
70	0	0	0	0	0	0	0.6	1000	25.281	33.605	0.5	M2-5
72	167080	167137	4937653	4770516	167102	22	0.6	1000	25.281	33.605	0.5	M2-5
73	0	0	0	0	0	0	0.6	1000	25.281	33.605	0.5	M2-5
75	5228	5280	1261666	1256386	5327	99	0.6	1000	25.281	33.605	0.5	M2-5
77	0	0	0	0	0	0	0.6	1000	25.281	33.605	0.5	M2-5
78	5042	5048	623286	618238	5054	12	0.6	1000	25.281	33.605	0.5	M2-5
81	620	620	277140	276520	622	2	0.6	1000	25.281	33.605	0.5	M2-5
84	125	125	83028	82903	125	0	0.6	1000	25.281	33.605	0.5	M2-5
87	652	652	41041	40389	653	1	0.6	1000	25.281	33.605	0.5	M2-5
89	0	0	0	0	0	0	0.6	1000	25.281	33.605	0.5	M2-5
90	10	10	12880	12870	10	0	0.6	1000	25.281	33.605	0.5	M2-5
3	0	0	3	3	3	3	0.6	1000	25.589	34.622	1.0	M2-3
18	0	0	0	0	0	0	0.6	1000	25.589	34.622	1.0	M2-3
24	79	81	17205	17124	90	11	0.6	1000	25.589	34.622	1.0	M2-3
27	95	95	32385	32290	129	34	0.6	1000	25.589	34.622	1.0	M2-3
30	256	256	73920	73664	285	29	0.6	1000	25.589	34.622	1.0	M2-3
33	4273	4281	524800	520519	4295	22	0.6	1000	25.589	34.622	1.0	M2-3
36	3148	3184	1449253	1446069	3189	41	0.6	1000	25.589	34.622	1.0	M2-3
39	21427	21847	5189031	5167184	21449	22	0.6	1000	25.589	34.622	1.0	M2-3
42	7979	8039	10656036	10647997	8503	524	0.6	1000	25.589	34.622	1.0	M2-3
45	18690	18762	15615666	15596904	19150	460	0.6	1000	25.589	34.622	1.0	M2-3
48	20275	20667	21362916	21342249	20415	140	0.6	1000	25.589	34.622	1.0	M2-3
49	0	0	0	0	0	0	0.6	1000	25.589	34.622	1.0	M2-3
51	21204	21389	27598735	27577346	21426	222	0.6	1000	25.589	34.622	1.0	M2-3
54	15380	15480	20778681	20763201	15487	107	0.6	1000	25.589	34.622	1.0	M2-3
55	0	0	6	6	0	0	0.6	1000	25.589	34.622	1.0	M2-3
56	0	0	0	0	0	0	0.6	1000	25.589	34.622	1.0	M2-3
57	12150	12319	19980681	19968362	12762	612	0.6	1000	25.589	34.622	1.0	M2-3
58	0	0	0	0	0	0	0.6	1000	25.589	34.622	1.0	M2-3
60	34887	35327	20272528	20237201	34945	58	0.6	1000	25.589	34.622	1.0	M2-3
62	0	0	0	0	0	0	0.6	1000	25.589	34.622	1.0	M2-3
63	31633	31663	14658405	14626742	31755	122	0.6	1000	25.589	34.622	1.0	M2-3
65	0	0	1	1	0	0	0.6	1000	25.589	34.622	1.0	M2-3
66	7802	7934	8256016	8248082	7824	22	0.6	1000	25.589	34.622	1.0	M2-3
69	47650	47737	6285285	6237548	47791	141	0.6	1000	25.589	34.622	1.0	M2-3
70	0	0	0	0	0	0	0.6	1000	25.589	34.622	1.0	M2-3
71	0	0	0	0	0	0	0.6	1000	25.589	34.622	1.0	M2-3
72	25374	25428	4238416	4212988	25384	10	0.6	1000	25.589	34.622	1.0	M2-3
75	2925	2941	1059240	1056299	2934	9	0.6	1000	25.589	34.622	1.0	M2-3
76	0	0	0	0	0	0	0.6	1000	25.589	34.622	1.0	M2-3
78	527	529	423660	423131	536	9	0.6	1000	25.589	34.622	1.0	M2-3
81	3750	3750	349030	345280	3750	0	0.6	1000	25.589	34.622	1.0	M2-3
84	881	881	125250	124369	881	0	0.6	1000	25.589	34.622	1.0	M2-3
87	363	363	31626	31263	363	0	0.6	1000	25.589	34.622	1.0	M2-3
90	19	19	11476	11457	19	0	0.6	1000	25.589	34.622	1.0	M2-3
24	869	893	18915	18022	869	0	0.6	1000	26.14	35.848	1.0	M5-7
27	3180	3180	45451	42271	3224	44	0.6	1000	26.14	35.848	1.0	M5-7
30	6598	7335	248160	240825	6708	110	0.6	1000	26.14	35.848	1.0	M5-7
33	9462	9512	743590	734078	9467	5	0.6	1000	26.14	35.848	1.0	M5-7
34	0	0	0	0	0	0	0.6	1000	26.14	35.848	1.0	M5-7
36	47835	48756	3004926	2956170	47875	40	0.6	1000	26.14	35.848	1.0	M5-7
38	0	0	0	0	0	0	0.6	1000	26.14	35.848	1.0	M5-7
39	322322	337132	15354111	15016979	322346	24	0.6	1000	26.14	35.848	1.0	M5-7
41	1	1	1	0	1	0	0.6	1000	26.14	35.848	1.0	M5-7
42	340708	350257	30011878	29661621	340828	120	0.6	1000	26.14	35.848	1.0	M5-7
43	0	0	0	0	0	0	0.6	1000	26.14	35.848	1.0	M5-7
45	177666	179480	41975703	41796223	178590	924	0.6	1000	26.14	35.848	1.0	M5-7
48	194029	199870	53877390	53677520	194065	36	0.6	1000	26.14	35.848	1.0	M5-7
49	3	3	3	0	3	0	0.6	1000	26.14	35.848	1.0	M5-7
51	312558	319118	74951646	74632528	312886	328	0.6	1000	26.14	35.848	1.0	M5-7
52	2	2	10	8	2	0	0.6	1000	26.14	35.848	1.0	M5-7
53	0	0	0	0	0	0	0.6	1000	26.14	35.848	1.0	M5-7
54	346132	348872	70051366	69702494	346435	303	0.6	1000	26.14	35.848	1.0	M5-7
55	0	0	1	1	0	0	0.6	1000	26.14	35.848	1.0	M5-7
56	3	3	3	0	3	0	0.6	1000	26.14	35.848	1.0	M5-7
57	354894	358240	65763246	65405006	355558	664	0.6	1000	26.14	35.848	1.0	M5-7
59	0	0	0	0	0	0	0.6	1000	26.14	35.848	1.0	M5-7
60	132735	133351	38645236	38511885	132797	62	0.6	1000	26.14	35.848	1.0	M5-7
61	0	0	0	0	0	0	0.6	1000	26.14	35.848	1.0	M5-7
62	3	3	10	7	3	0	0.6	1000	26.14	35.848	1.0	M5-7
63	192405	196867	36984300	36787433	192414	9	0.6	1000	26.14	35.848	1.0	M5-7
64	1	1	6	5	1	0	0.6	1000	26.14	35.848	1.0	M5-7
66	203844	205243	23953581	23748338	203850	6	0.6	1000	26.14	35.848	1.0	M5-7
67	1	1	6	5	1	0	0.6	1000	26.14	35.848	1.0	M5-7
69	210076	213269	17249001	17035732	210079	3	0.6	1000	26.14	35.848	1.0	M5-7
70	0	0	0	0	0	0	0.6	1000	26.14	35.848	1.0	M5-7
72	106617	107768	8830503	8722735	106620	3	0.6	1000	26.14	35.848	1.0	M5-7
75	194950	195618	4887501	4691883	194956	6	0.6	1000	26.14	35.848	1.0	M5-7
78	103880	103947	2364225	2260278	103880	0	0.6	1000	26.14	35.848	1.0	M5-7
80	0	0	0	0	0	0	0.6	1000	26.14	35.848	1.0	M5-7
81	4652	4671	307720	303049	4652	0	0.6	1000	26.14	35.848	1.0	M5-7
84	18626	18644	351541	332897	18626	0	0.6	1000	26.14	35.848	1.0	M5-7
85	0	0	0	0	0	0	0.6	1000	26.14	35.848	1.0	M5-7
87	529	529	23653	23124	529	0	0.6	1000	26.14	35.848	1.0	M5-7
90	41892	41911	314821	272910	41892	0	0.6	1000	26.14	35.848	1.0	M5-7
3	0	0	0	0	0	0	0.6	1000	26.473	33.403	1.0	M2-7
6	0	0	0	0	0	0	0.6	1000	26.473	33.403	1.0	M2-7
9	0	0	0	0	0	0	0.6	1000	26.473	33.403	1.0	M2-7
24	387	387	11175	10788	393	6	0.6	1000	26.473	33.403	1.0	M2-7
27	271	271	17020	16749	303	32	0.6	1000	26.473	33.403	1.0	M2-7
30	1103	1105	112101	110996	1119	16	0.6	1000	26.473	33.403	1.0	M2-7
32	0	0	0	0	0	0	0.6	1000	26.473	33.403	1.0	M2-7
33	11034	11046	559153	548107	11061	27	0.6	1000	26.473	33.403	1.0	M2-7
36	7654	7699	1704781	1697082	7704	50	0.6	1000	26.473	33.403	1.0	M2-7
38	0	0	0	0	0	0	0.6	1000	26.473	33.403	1.0	M2-7
39	20361	20406	4981746	4961340	20400	39	0.6	1000	26.473	33.403	1.0	M2-7
40	0	0	0	0	0	0	0.6	1000	26.473	33.403	1.0	M2-7
42	3081	3199	7990003	7986804	3257	176	0.6	1000	26.473	33.403	1.0	M2-7
43	0	0	0	0	0	0	0.6	1000	26.473	33.403	1.0	M2-7
44	0	0	0	0	0	0	0.6	1000	26.473	33.403	1.0	M2-7
45	172942	173085	17520240	17347155	173246	304	0.6	1000	26.473	33.403	1.0	M2-7
48	23153	23450	24286965	24263515	23586	433	0.6	1000	26.473	33.403	1.0	M2-7
49	0	0	0	0	0	0	0.6	1000	26.473	33.403	1.0	M2-7
50	0	0	0	0	0	0	0.6	1000	26.473	33.403	1.0	M2-7
51	36280	36524	25959615	25923091	36511	231	0.6	1000	26.473	33.403	1.0	M2-7
52	0	0	0	0	0	0	0.6	1000	26.473	33.403	1.0	M2-7
53	0	0	0	0	0	0	0.6	1000	26.473	33.403	1.0	M2-7
54	14737	14798	22663278	22648480	14908	171	0.6	1000	26.473	33.403	1.0	M2-7
55	0	0	0	0	0	0	0.6	1000	26.473	33.403	1.0	M2-7
57	13750	13861	22028203	22014342	14192	442	0.6	1000	26.473	33.403	1.0	M2-7
58	0	0	1	1	0	0	0.6	1000	26.473	33.403	1.0	M2-7
60	29736	29971	16293486	16263515	29804	68	0.6	1000	26.473	33.403	1.0	M2-7
63	9400	9454	13439520	13430066	9495	95	0.6	1000	26.473	33.403	1.0	M2-7
64	0	0	1	1	0	0	0.6	1000	26.473	33.403	1.0	M2-7
65	0	0	0	0	0	0	0.6	1000	26.473	33.403	1.0	M2-7
66	8762	8892	8600878	8591986	8779	17	0.6	1000	26.473	33.403	1.0	M2-7
69	65236	65664	8174946	8109282	65268	32	0.6	1000	26.473	33.403	1.0	M2-7
71	0	0	0	0	0	0	0.6	1000	26.473	33.403	1.0	M2-7
72	4983	5030	2946378	2941348	5007	24	0.6	1000	26.473	33.403	1.0	M2-7
75	533	550	905185	904635	540	7	0.6	1000	26.473	33.403	1.0	M2-7
78	487	511	371953	371442	488	1	0.6	1000	26.473	33.403	1.0	M2-7
81	692	697	219453	218756	692	0	0.6	1000	26.473	33.403	1.0	M2-7
84	542	546	97461	96915	542	0	0.6	1000	26.473	33.403	1.0	M2-7
87	376	376	21736	21360	376	0	0.6	1000	26.473	33.403	1.0	M2-7
90	44	44	4950	4906	44	0	0.6	1000	26.473	33.403	1.0	M2-7
3	0	0	1	1	1	1	0.6	1000	26.636	35.127	1.0	M2-5
6	0	0	0	0	0	0	0.6	1000	26.636	35.127	1.0	M2-5
21	0	0	0	0	0	0	0.6	1000	26.636	35.127	1.0	M2-5
24	79	79	14878	14799	89	10	0.6	1000	26.636	35.127	1.0	M2-5
27	341	341	31375	31034	363	22	0.6	1000	26.636	35.127	1.0	M2-5
29	0	0	0	0	0	0	0.6	1000	26.636	35.127	1.0	M2-5
30	1950	1952	144991	143039	1978	28	0.6	1000	26.636	35.127	1.0	M2-5
33	568	582	456490	455908	594	26	0.6	1000	26.636	35.127	1.0	M2-5
36	970	975	1390278	1389303	1024	54	0.6	1000	26.636	35.127	1.0	M2-5
39	19806	20025	4766328	4746303	19859	53	0.6	1000	26.636	35.127	1.0	M2-5
42	14649	14738	8729931	8715193	14912	263	0.6	1000	26.636	35.127	1.0	M2-5
43	0	0	0	0	0	0	0.6	1000	26.636	35.127	1.0	M2-5
45	11010	11227	14228445	14217218	11347	337	0.6	1000	26.636	35.127	1.0	M2-5
48	10117	10242	20972526	20962284	10305	188	0.6	1000	26.636	35.127	1.0	M2-5
50	0	0	1	1	0	0	0.6	1000	26.636	35.127	1.0	M2-5
51	55695	55910	26038936	25983026	55978	283	0.6	1000	26.636	35.127	1.0	M2-5
54	12858	12924	20444815	20431891	12924	66	0.6	1000	26.636	35.127	1.0	M2-5
57	27141	27415	23553816	23526401	27595	454	0.6	1000	26.636	35.127	1.0	M2-5
59	0	0	0	0	0	0	0.6	1000	26.636	35.127	1.0	M2-5
60	20062	20205	18063055	18042850	20146	84	0.6	1000	26.636	35.127	1.0	M2-5
62	0	0	0	0	0	0	0.6	1000	26.636	35.127	1.0	M2-5
63	48436	48491	13694761	13646270	48485	49	0.6	1000	26.636	35.127	1.0	M2-5
65	1	1	1	0	1	0	0.6	1000	26.636	35.127	1.0	M2-5
66	5961	6063	8600878	8594815	5981	20	0.6	1000	26.636	35.127	1.0	M2-5
69	21457	21721	6317235	6295514	21525	68	0.6	1000	26.636	35.127	1.0	M2-5
70	0	0	0	0	0	0	0.6	1000	26.636	35.127	1.0	M2-5
72	167104	167137	4937653	4770516	167137	33	0.6	1000	26.636	35.127	1.0	M2-5
73	0	0	0	0	0	0	0.6	1000	26.636	35.127	1.0	M2-5
75	5265	5280	1261666	1256386	5347	82	0.6	1000	26.636	35.127	1.0	M2-5
77	0	0	0	0	0	0	0.6	1000	26.636	35.127	1.0	M2-5
78	5042	5048	623286	618238	5054	12	0.6	1000	26.636	35.127	1.0	M2-5
81	620	620	277140	276520	622	2	0.6	1000	26.636	35.127	1.0	M2-5
84	125	125	83028	82903	125	0	0.6	1000	26.636	35.127	1.0	M2-5
87	652	652	41041	40389	653	1	0.6	1000	26.636	35.127	1.0	M2-5
89	0	0	0	0	0	0	0.6	1000	26.636	35.127	1.0	M2-5
90	10	10	12880	12870	10	0	0.6	1000	26.636	35.127	1.0	M2-5
3	0	0	1	1	1	1	0.6	1000	26.639	33.71	1.0	M2-6
9	0	0	0	0	0	0	0.6	1000	26.639	33.71	1.0	M2-6
21	0	0	0	0	0	0	0.6	1000	26.639	33.71	1.0	M2-6
24	230	230	21528	21298	298	68	0.6	1000	26.639	33.71	1.0	M2-6
25	0	0	0	0	0	0	0.6	1000	26.639	33.71	1.0	M2-6
27	123	123	24090	23967	143	20	0.6	1000	26.639	33.71	1.0	M2-6
30	985	988	86736	85748	993	8	0.6	1000	26.639	33.71	1.0	M2-6
33	6386	6394	393828	387434	6422	36	0.6	1000	26.639	33.71	1.0	M2-6
36	1286	1338	1046181	1044843	1319	33	0.6	1000	26.639	33.71	1.0	M2-6
39	11512	11574	4477528	4465954	11550	38	0.6	1000	26.639	33.71	1.0	M2-6
42	36271	36757	12199330	12162573	37376	1105	0.6	1000	26.639	33.71	1.0	M2-6
45	9288	9465	13799631	13790166	9546	258	0.6	1000	26.639	33.71	1.0	M2-6
46	0	0	0	0	0	0	0.6	1000	26.639	33.71	1.0	M2-6
47	0	0	1	1	0	0	0.6	1000	26.639	33.71	1.0	M2-6
48	33310	33667	21988396	21954729	33553	243	0.6	1000	26.639	33.71	1.0	M2-6
49	0	0	1	1	0	0	0.6	1000	26.639	33.71	1.0	M2-6
50	0	0	0	0	0	0	0.6	1000	26.639	33.71	1.0	M2-6
51	12986	13071	23718828	23705757	13289	303	0.6	1000	26.639	33.71	1.0	M2-6
54	52878	52975	23505796	23452821	53052	174	0.6	1000	26.639	33.71	1.0	M2-6
57	12883	13056	19198306	19185250	13429	546	0.6	1000	26.639	33.71	1.0	M2-6
60	12315	12478	17668540	17656062	12400	85	0.6	1000	26.639	33.71	1.0	M2-6
63	22508	27271	13778625	13751354	22562	54	0.6	1000	26.639	33.71	1.0	M2-6
66	6094	6121	7463316	7457195	6117	23	0.6	1000	26.639	33.71	1.0	M2-6
67	3	3	3	0	3	0	0.6	1000	26.639	33.71	1.0	M2-6
68	1	1	3	2	1	0	0.6	1000	26.639	33.71	1.0	M2-6
69	170707	170803	8931651	8760848	170766	59	0.6	1000	26.639	33.71	1.0	M2-6
72	4731	4790	3280641	3275851	4811	80	0.6	1000	26.639	33.71	1.0	M2-6
75	17632	17641	1352190	1334549	17652	20	0.6	1000	26.639	33.71	1.0	M2-6
78	1274	1279	592416	591137	1280	6	0.6	1000	26.639	33.71	1.0	M2-6
81	3999	4005	263901	259896	4002	3	0.6	1000	26.639	33.71	1.0	M2-6
84	411	411	124750	124339	411	0	0.6	1000	26.639	33.71	1.0	M2-6
87	120	120	26796	26676	120	0	0.6	1000	26.639	33.71	1.0	M2-6
90	223	224	21321	21097	223	0	0.6	1000	26.639	33.71	1.0	M2-6
98	0	0	0	0	0	0	0.6	1000	26.639	33.71	1.0	M2-6
3	0	0	1	1	1	1	0.6	1000	26.755	33.763	1.0	M2-2
6	0	0	1	1	0	0	0.6	1000	26.755	33.763	1.0	M2-2
18	0	0	0	0	0	0	0.6	1000	26.755	33.763	1.0	M2-2
24	111	111	16471	16360	125	14	0.6	1000	26.755	33.763	1.0	M2-2
27	160	160	14535	14375	160	0	0.6	1000	26.755	33.763	1.0	M2-2
30	173	174	92665	92491	198	25	0.6	1000	26.755	33.763	1.0	M2-2
33	936	936	392055	391119	1015	79	0.6	1000	26.755	33.763	1.0	M2-2
36	7286	7409	1684530	1677121	7527	241	0.6	1000	26.755	33.763	1.0	M2-2
39	22107	22134	4713985	4691851	22132	25	0.6	1000	26.755	33.763	1.0	M2-2
42	5214	5340	10818226	10812886	5391	177	0.6	1000	26.755	33.763	1.0	M2-2
44	1	1	1	0	1	0	0.6	1000	26.755	33.763	1.0	M2-2
45	16811	17051	17026530	17009479	16928	117	0.6	1000	26.755	33.763	1.0	M2-2
46	0	0	0	0	0	0	0.6	1000	26.755	33.763	1.0	M2-2
48	30958	31132	24559536	24528404	31165	207	0.6	1000	26.755	33.763	1.0	M2-2
49	0	0	0	0	0	0	0.6	1000	26.755	33.763	1.0	M2-2
51	17019	17184	25300941	25283757	17286	267	0.6	1000	26.755	33.763	1.0	M2-2
52	0	0	0	0	0	0	0.6	1000	26.755	33.763	1.0	M2-2
53	0	0	1	1	0	0	0.6	1000	26.755	33.763	1.0	M2-2
54	10179	10321	21264981	21254660	10295	116	0.6	1000	26.755	33.763	1.0	M2-2
57	183660	184015	26060590	25876575	184969	1309	0.6	1000	26.755	33.763	1.0	M2-2
58	0	0	1	1	0	0	0.6	1000	26.755	33.763	1.0	M2-2
59	0	0	0	0	0	0	0.6	1000	26.755	33.763	1.0	M2-2
60	25808	26102	16863528	16837426	25861	53	0.6	1000	26.755	33.763	1.0	M2-2
63	9921	10197	13957686	13947489	10063	142	0.6	1000	26.755	33.763	1.0	M2-2
66	17973	18242	8382465	8364223	18099	126	0.6	1000	26.755	33.763	1.0	M2-2
67	0	0	0	0	0	0	0.6	1000	26.755	33.763	1.0	M2-2
69	3917	3945	5737578	5733633	3957	40	0.6	1000	26.755	33.763	1.0	M2-2
70	0	0	0	0	0	0	0.6	1000	26.755	33.763	1.0	M2-2
72	57641	57705	4323270	4265565	57644	3	0.6	1000	26.755	33.763	1.0	M2-2
74	0	0	1	1	0	0	0.6	1000	26.755	33.763	1.0	M2-2
75	5234	5400	1507716	1502316	5249	15	0.6	1000	26.755	33.763	1.0	M2-2
76	0	0	0	0	0	0	0.6	1000	26.755	33.763	1.0	M2-2
78	418	418	375411	374993	419	1	0.6	1000	26.755	33.763	1.0	M2-2
81	5165	5167	260281	255114	5169	4	0.6	1000	26.755	33.763	1.0	M2-2
84	223	223	87990	87767	224	1	0.6	1000	26.755	33.763	1.0	M2-2
87	299	299	35778	35479	299	0	0.6	1000	26.755	33.763	1.0	M2-2
90	39	40	17205	17165	39	0	0.6	1000	26.755	33.763	1.0	M2-2
3	1	1	1	0	1	0	0.6	1000	26.772	35.552	1.0	M2-10
9	0	0	0	0	0	0	0.6	1000	26.772	35.552	1.0	M2-10
19	0	0	0	0	0	0	0.6	1000	26.772	35.552	1.0	M2-10
24	33	33	8001	7968	41	8	0.6	1000	26.772	35.552	1.0	M2-10
27	541	541	31125	30584	558	17	0.6	1000	26.772	35.552	1.0	M2-10
30	111	111	61425	61314	113	2	0.6	1000	26.772	35.552	1.0	M2-10
33	623	633	440391	439758	659	36	0.6	1000	26.772	35.552	1.0	M2-10
36	14251	14296	1486950	1472654	14331	80	0.6	1000	26.772	35.552	1.0	M2-10
39	5997	6050	4680270	4674220	6018	21	0.6	1000	26.772	35.552	1.0	M2-10
41	0	0	0	0	0	0	0.6	1000	26.772	35.552	1.0	M2-10
42	6981	7127	9311770	9304643	7286	305	0.6	1000	26.772	35.552	1.0	M2-10
44	0	0	0	0	0	0	0.6	1000	26.772	35.552	1.0	M2-10
45	24604	24931	16316328	16291397	24872	268	0.6	1000	26.772	35.552	1.0	M2-10
46	1	1	1	0	1	0	0.6	1000	26.772	35.552	1.0	M2-10
48	10507	10625	22967253	22956628	10668	161	0.6	1000	26.772	35.552	1.0	M2-10
49	0	0	0	0	0	0	0.6	1000	26.772	35.552	1.0	M2-10
51	176670	176809	31311741	31134932	176969	299	0.6	1000	26.772	35.552	1.0	M2-10
54	62133	62208	24489501	24427293	62273	140	0.6	1000	26.772	35.552	1.0	M2-10
56	0	0	0	0	0	0	0.6	1000	26.772	35.552	1.0	M2-10
57	11596	11673	18274035	18262362	12272	676	0.6	1000	26.772	35.552	1.0	M2-10
60	20840	21036	16944931	16923895	20892	52	0.6	1000	26.772	35.552	1.0	M2-10
62	0	0	0	0	0	0	0.6	1000	26.772	35.552	1.0	M2-10
63	10322	10526	13007550	12997024	10434	112	0.6	1000	26.772	35.552	1.0	M2-10
66	9949	10022	9721845	9711823	9959	10	0.6	1000	26.772	35.552	1.0	M2-10
69	46415	46472	7478778	7432306	46472	57	0.6	1000	26.772	35.552	1.0	M2-10
72	1918	1948	2648451	2646503	1992	74	0.6	1000	26.772	35.552	1.0	M2-10
73	0	0	0	0	0	0	0.6	1000	26.772	35.552	1.0	M2-10
75	17684	17696	1433971	1416275	17695	11	0.6	1000	26.772	35.552	1.0	M2-10
78	640	645	536130	535485	655	15	0.6	1000	26.772	35.552	1.0	M2-10
79	0	0	0	0	0	0	0.6	1000	26.772	35.552	1.0	M2-10
81	962	970	323610	322640	965	3	0.6	1000	26.772	35.552	1.0	M2-10
84	117	120	83436	83316	117	0	0.6	1000	26.772	35.552	1.0	M2-10
87	231	232	27966	27734	231	0	0.6	1000	26.772	35.552	1.0	M2-10
90	1297	1297	17020	15723	1297	0	0.6	1000	26.772	35.552	1.0	M2-10
3	0	0	0	0	0	0	0.6	1000	26.862	33.615	1.0	M2-9
6	0	0	1	1	0	0	0.6	1000	26.862	33.615	1.0	M2-9
24	209	209	20910	20701	217	8	0.6	1000	26.862	33.615	1.0	M2-9
27	36	36	17205	17169	68	32	0.6	1000	26.862	33.615	1.0	M2-9
30	48	51	61075	61024	63	15	0.6	1000	26.862	33.615	1.0	M2-9
33	2563	2574	590241	587667	2578	15	0.6	1000	26.862	33.615	1.0	M2-9
36	18165	18529	1418770	1400241	18250	85	0.6	1000	26.862	33.615	1.0	M2-9
39	3930	4104	3766140	3762036	3960	30	0.6	1000	26.862	33.615	1.0	M2-9
41	0	0	0	0	0	0	0.6	1000	26.862	33.615	1.0	M2-9
42	24756	25026	10476753	10451727	25063	307	0.6	1000	26.862	33.615	1.0	M2-9
44	0	0	0	0	0	0	0.6	1000	26.862	33.615	1.0	M2-9
45	18223	18311	16730220	16711909	18459	236	0.6	1000	26.862	33.615	1.0	M2-9
48	7628	7820	22147840	22140020	7766	138	0.6	1000	26.862	33.615	1.0	M2-9
49	0	0	0	0	0	0	0.6	1000	26.862	33.615	1.0	M2-9
51	35157	36066	26415546	26379480	35492	335	0.6	1000	26.862	33.615	1.0	M2-9
52	0	0	0	0	0	0	0.6	1000	26.862	33.615	1.0	M2-9
54	36352	36466	24608620	24572154	36536	184	0.6	1000	26.862	33.615	1.0	M2-9
55	0	0	1	1	0	0	0.6	1000	26.862	33.615	1.0	M2-9
57	30026	30222	22028203	21997981	30542	516	0.6	1000	26.862	33.615	1.0	M2-9
59	0	0	0	0	0	0	0.6	1000	26.862	33.615	1.0	M2-9
60	15157	15311	16476670	16461359	15204	47	0.6	1000	26.862	33.615	1.0	M2-9
61	0	0	3	3	0	0	0.6	1000	26.862	33.615	1.0	M2-9
63	8099	8154	11899881	11891727	8119	20	0.6	1000	26.862	33.615	1.0	M2-9
66	54201	54409	9899025	9844616	54210	9	0.6	1000	26.862	33.615	1.0	M2-9
69	4999	5033	5260146	5255113	5047	48	0.6	1000	26.862	33.615	1.0	M2-9
72	7537	7701	2995128	2987427	7648	111	0.6	1000	26.862	33.615	1.0	M2-9
75	2011	2025	1343980	1341955	2023	12	0.6	1000	26.862	33.615	1.0	M2-9
78	650	651	435711	435060	654	4	0.6	1000	26.862	33.615	1.0	M2-9
81	801	803	208335	207532	802	1	0.6	1000	26.862	33.615	1.0	M2-9
84	1170	1170	133386	132216	1172	2	0.6	1000	26.862	33.615	1.0	M2-9
87	200	200	21945	21745	200	0	0.6	1000	26.862	33.615	1.0	M2-9
90	127	127	16471	16344	128	1	0.6	1000	26.862	33.615	1.0	M2-9
3	0	0	0	0	0	0	0.6	1000	26.956	44.453	1.0	M2-1
12	1	1	1	0	1	0	0.6	1000	26.956	44.453	1.0	M2-1
15	0	0	0	0	0	0	0.6	1000	26.956	44.453	1.0	M2-1
24	80	80	17391	17311	132	52	0.6	1000	26.956	44.453	1.0	M2-1
27	58	58	20706	20648	65	7	0.6	1000	26.956	44.453	1.0	M2-1
30	316	317	102831	102514	326	10	0.6	1000	26.956	44.453	1.0	M2-1
33	760	781	571915	571134	808	48	0.6	1000	26.956	44.453	1.0	M2-1
36	1468	1518	1530375	1528857	1543	75	0.6	1000	26.956	44.453	1.0	M2-1
39	13325	13402	4501500	4488098	13394	69	0.6	1000	26.956	44.453	1.0	M2-1
41	0	0	0	0	0	0	0.6	1000	26.956	44.453	1.0	M2-1
42	28486	28588	10010575	9981987	28725	239	0.6	1000	26.956	44.453	1.0	M2-1
43	0	0	1	1	0	0	0.6	1000	26.956	44.453	1.0	M2-1
45	14838	15621	16522626	16507005	15079	241	0.6	1000	26.956	44.453	1.0	M2-1
46	0	0	1	1	0	0	0.6	1000	26.956	44.453	1.0	M2-1
48	32137	32345	24398605	24366260	32345	208	0.6	1000	26.956	44.453	1.0	M2-1
51	13967	14167	23988201	23974034	14271	304	0.6	1000	26.956	44.453	1.0	M2-1
52	0	0	0	0	0	0	0.6	1000	26.956	44.453	1.0	M2-1
54	33934	34863	24217320	24182457	34092	158	0.6	1000	26.956	44.453	1.0	M2-1
55	0	0	0	0	0	0	0.6	1000	26.956	44.453	1.0	M2-1
57	28314	28771	23932821	23904050	29174	860	0.6	1000	26.956	44.453	1.0	M2-1
58	0	0	0	0	0	0	0.6	1000	26.956	44.453	1.0	M2-1
59	0	0	1	1	0	0	0.6	1000	26.956	44.453	1.0	M2-1
60	13941	14059	16869336	16855277	14021	80	0.6	1000	26.956	44.453	1.0	M2-1
61	0	0	0	0	0	0	0.6	1000	26.956	44.453	1.0	M2-1
62	0	0	0	0	0	0	0.6	1000	26.956	44.453	1.0	M2-1
63	19815	19873	11608971	11589098	19878	63	0.6	1000	26.956	44.453	1.0	M2-1
64	0	0	0	0	0	0	0.6	1000	26.956	44.453	1.0	M2-1
66	42504	42563	7755891	7713328	42518	14	0.6	1000	26.956	44.453	1.0	M2-1
68	0	0	0	0	0	0	0.6	1000	26.956	44.453	1.0	M2-1
69	2685	2772	4928230	4925458	2722	37	0.6	1000	26.956	44.453	1.0	M2-1
72	2703	2716	2248260	2245544	2720	17	0.6	1000	26.956	44.453	1.0	M2-1
73	0	0	1	1	0	0	0.6	1000	26.956	44.453	1.0	M2-1
75	166287	166303	2494261	2327958	166292	5	0.6	1000	26.956	44.453	1.0	M2-1
78	606	617	541320	540703	626	20	0.6	1000	26.956	44.453	1.0	M2-1
81	18083	18097	402753	384656	18083	0	0.6	1000	26.956	44.453	1.0	M2-1
84	295	296	95703	95407	295	0	0.6	1000	26.956	44.453	1.0	M2-1
87	93	102	20100	19998	93	0	0.6	1000	26.956	44.453	1.0	M2-1
90	2	2	9045	9043	2	0	0.6	1000	26.956	44.453	1.0	M2-1
3	0	0	0	0	0	0	0.6	1000	27.96	33.1	1.0	M2-8
6	0	0	0	0	0	0	0.6	1000	27.96	33.1	1.0	M2-8
8	0	0	0	0	0	0	0.6	1000	27.96	33.1	1.0	M2-8
12	0	0	0	0	0	0	0.6	1000	27.96	33.1	1.0	M2-8
15	0	0	0	0	0	0	0.6	1000	27.96	33.1	1.0	M2-8
18	0	0	1	1	0	0	0.6	1000	27.96	33.1	1.0	M2-8
24	53	53	17578	17525	62	9	0.6	1000	27.96	33.1	1.0	M2-8
27	11	11	21528	21517	37	26	0.6	1000	27.96	33.1	1.0	M2-8
28	0	0	0	0	0	0	0.6	1000	27.96	33.1	1.0	M2-8
30	262	263	58653	58390	266	4	0.6	1000	27.96	33.1	1.0	M2-8
32	0	0	0	0	0	0	0.6	1000	27.96	33.1	1.0	M2-8
33	1467	1514	578350	576836	1485	18	0.6	1000	27.96	33.1	1.0	M2-8
36	15344	15366	1853775	1838409	15380	36	0.6	1000	27.96	33.1	1.0	M2-8
38	0	0	1	1	0	0	0.6	1000	27.96	33.1	1.0	M2-8
39	5802	6403	4450636	4444233	5829	27	0.6	1000	27.96	33.1	1.0	M2-8
40	0	0	0	0	0	0	0.6	1000	27.96	33.1	1.0	M2-8
42	23754	23875	10131751	10107876	24318	564	0.6	1000	27.96	33.1	1.0	M2-8
45	6353	6498	13543410	13536912	6553	200	0.6	1000	27.96	33.1	1.0	M2-8
46	0	0	0	0	0	0	0.6	1000	27.96	33.1	1.0	M2-8
48	10587	10669	22408165	22397496	10762	175	0.6	1000	27.96	33.1	1.0	M2-8
49	0	0	1	1	0	0	0.6	1000	27.96	33.1	1.0	M2-8
51	9792	9914	22636356	22626442	10057	265	0.6	1000	27.96	33.1	1.0	M2-8
52	0	0	1	1	0	0	0.6	1000	27.96	33.1	1.0	M2-8
54	15849	16473	21849355	21832882	15954	105	0.6	1000	27.96	33.1	1.0	M2-8
55	0	0	0	0	0	0	0.6	1000	27.96	33.1	1.0	M2-8
57	16182	16371	21803106	21786735	16671	489	0.6	1000	27.96	33.1	1.0	M2-8
58	0	0	0	0	0	0	0.6	1000	27.96	33.1	1.0	M2-8
59	0	0	0	0	0	0	0.6	1000	27.96	33.1	1.0	M2-8
60	12737	12784	16921653	16908869	12784	47	0.6	1000	27.96	33.1	1.0	M2-8
62	0	0	0	0	0	0	0.6	1000	27.96	33.1	1.0	M2-8
63	27118	27543	13984116	13956573	27178	60	0.6	1000	27.96	33.1	1.0	M2-8
65	0	0	1	1	0	0	0.6	1000	27.96	33.1	1.0	M2-8
66	35755	36059	11565645	11529586	35766	11	0.6	1000	27.96	33.1	1.0	M2-8
68	0	0	0	0	0	0	0.6	1000	27.96	33.1	1.0	M2-8
69	9182	9212	6144265	6135053	9226	44	0.6	1000	27.96	33.1	1.0	M2-8
70	0	0	0	0	0	0	0.6	1000	27.96	33.1	1.0	M2-8
72	27005	27532	3128751	3101219	27415	410	0.6	1000	27.96	33.1	1.0	M2-8
73	0	0	0	0	0	0	0.6	1000	27.96	33.1	1.0	M2-8
75	2614	2645	1226961	1224316	2623	9	0.6	1000	27.96	33.1	1.0	M2-8
78	1796	1802	671061	669259	1811	15	0.6	1000	27.96	33.1	1.0	M2-8
81	5308	5308	299151	293843	5309	1	0.6	1000	27.96	33.1	1.0	M2-8
84	243	243	96141	95898	245	2	0.6	1000	27.96	33.1	1.0	M2-8
87	702	703	61776	61073	702	0	0.6	1000	27.96	33.1	1.0	M2-8
90	425	428	14365	13937	425	0	0.6	1000	27.96	33.1	1.0	M2-8
3	0	0	1	1	1	1	0.6	1000	28.04	33.593	1.0	M2-4
24	10	10	7750	7740	16	6	0.6	1000	28.04	33.593	1.0	M2-4
27	41	41	15576	15535	81	40	0.6	1000	28.04	33.593	1.0	M2-4
28	0	0	0	0	0	0	0.6	1000	28.04	33.593	1.0	M2-4
30	755	755	77028	76273	762	7	0.6	1000	28.04	33.593	1.0	M2-4
33	792	809	342378	341569	812	20	0.6	1000	28.04	33.593	1.0	M2-4
35	0	0	0	0	0	0	0.6	1000	28.04	33.593	1.0	M2-4
36	1160	1198	1407003	1405805	1184	24	0.6	1000	28.04	33.593	1.0	M2-4
39	30216	30320	5067336	5037016	30369	153	0.6	1000	28.04	33.593	1.0	M2-4
42	21200	21266	10312611	10291345	21366	166	0.6	1000	28.04	33.593	1.0	M2-4
45	11981	12313	15337491	15325178	12371	390	0.6	1000	28.04	33.593	1.0	M2-4
46	0	0	3	3	0	0	0.6	1000	28.04	33.593	1.0	M2-4
48	12803	12943	21776700	21763757	13008	205	0.6	1000	28.04	33.593	1.0	M2-4
49	0	0	0	0	0	0	0.6	1000	28.04	33.593	1.0	M2-4
51	75268	75341	30431701	30356360	75825	557	0.6	1000	28.04	33.593	1.0	M2-4
54	10842	10917	21730528	21719611	10951	109	0.6	1000	28.04	33.593	1.0	M2-4
56	0	0	0	0	0	0	0.6	1000	28.04	33.593	1.0	M2-4
57	25614	25962	23574411	23548449	25996	382	0.6	1000	28.04	33.593	1.0	M2-4
58	0	0	0	0	0	0	0.6	1000	28.04	33.593	1.0	M2-4
59	0	0	0	0	0	0	0.6	1000	28.04	33.593	1.0	M2-4
60	29141	29883	18614151	18584268	29228	87	0.6	1000	28.04	33.593	1.0	M2-4
63	4981	5094	12442566	12437472	5033	52	0.6	1000	28.04	33.593	1.0	M2-4
64	0	0	0	0	0	0	0.6	1000	28.04	33.593	1.0	M2-4
65	0	0	0	0	0	0	0.6	1000	28.04	33.593	1.0	M2-4
66	6582	6683	7791378	7784695	6588	6	0.6	1000	28.04	33.593	1.0	M2-4
69	13768	13794	5516181	5502387	13789	21	0.6	1000	28.04	33.593	1.0	M2-4
72	23324	23734	3746953	3723219	23356	32	0.6	1000	28.04	33.593	1.0	M2-4
75	6139	6228	1343980	1337752	6144	5	0.6	1000	28.04	33.593	1.0	M2-4
78	563	574	397386	396812	582	19	0.6	1000	28.04	33.593	1.0	M2-4
81	1191	1218	327645	326427	1192	1	0.6	1000	28.04	33.593	1.0	M2-4
84	100	100	64980	64880	100	0	0.6	1000	28.04	33.593	1.0	M2-4
87	353	366	43071	42705	353	0	0.6	1000	28.04	33.593	1.0	M2-4
90	344	344	21945	21601	348	4	0.6	1000	28.04	33.593	1.0	M2-4
3	0	0	1	1	0	0	0.6	1000	30.323	50.863	1.0	M5-5
24	6037	10078	57291	47213	6057	20	0.6	1000	30.323	50.863	1.0	M5-5
27	1746	1747	18528	16781	1765	19	0.6	1000	30.323	50.863	1.0	M5-5
29	0	0	0	0	0	0	0.6	1000	30.323	50.863	1.0	M5-5
30	5098	5147	212226	207079	5619	521	0.6	1000	30.323	50.863	1.0	M5-5
32	0	0	0	0	0	0	0.6	1000	30.323	50.863	1.0	M5-5
33	43556	45315	1771903	1726588	43614	58	0.6	1000	30.323	50.863	1.0	M5-5
36	72233	86887	5282875	5195988	72252	19	0.6	1000	30.323	50.863	1.0	M5-5
39	197889	203840	14935845	14732005	197893	4	0.6	1000	30.323	50.863	1.0	M5-5
42	380939	384044	34999161	34615117	381065	126	0.6	1000	30.323	50.863	1.0	M5-5
45	380602	384335	49237926	48853591	380668	66	0.6	1000	30.323	50.863	1.0	M5-5
47	1	1	1	0	1	0	0.6	1000	30.323	50.863	1.0	M5-5
48	313702	316394	67738980	67422586	313985	283	0.6	1000	30.323	50.863	1.0	M5-5
49	0	0	1	1	0	0	0.6	1000	30.323	50.863	1.0	M5-5
50	0	0	0	0	0	0	0.6	1000	30.323	50.863	1.0	M5-5
51	140886	142966	58509153	58366187	141120	234	0.6	1000	30.323	50.863	1.0	M5-5
53	0	0	0	0	0	0	0.6	1000	30.323	50.863	1.0	M5-5
54	592123	608203	66857266	66249063	592286	163	0.6	1000	30.323	50.863	1.0	M5-5
55	0	0	1	1	0	0	0.6	1000	30.323	50.863	1.0	M5-5
56	0	0	0	0	0	0	0.6	1000	30.323	50.863	1.0	M5-5
57	194874	198194	56716575	56518381	199385	4511	0.6	1000	30.323	50.863	1.0	M5-5
58	210	210	210	0	210	0	0.6	1000	30.323	50.863	1.0	M5-5
59	4	9	21	12	4	0	0.6	1000	30.323	50.863	1.0	M5-5
60	225787	231970	41546170	41314200	225797	10	0.6	1000	30.323	50.863	1.0	M5-5
61	0	0	0	0	0	0	0.6	1000	30.323	50.863	1.0	M5-5
62	0	0	0	0	0	0	0.6	1000	30.323	50.863	1.0	M5-5
63	119945	129043	32453596	32324553	119974	29	0.6	1000	30.323	50.863	1.0	M5-5
64	0	0	1	1	0	0	0.6	1000	30.323	50.863	1.0	M5-5
66	176754	178578	24454521	24275943	176758	4	0.6	1000	30.323	50.863	1.0	M5-5
67	0	0	0	0	0	0	0.6	1000	30.323	50.863	1.0	M5-5
69	207334	214049	22906296	22692247	207343	9	0.6	1000	30.323	50.863	1.0	M5-5
70	0	0	0	0	0	0	0.6	1000	30.323	50.863	1.0	M5-5
72	138808	139273	8957028	8817755	139048	240	0.6	1000	30.323	50.863	1.0	M5-5
73	1	1	3	2	1	0	0.6	1000	30.323	50.863	1.0	M5-5
74	0	0	0	0	0	0	0.6	1000	30.323	50.863	1.0	M5-5
75	51371	51646	4394130	4342484	51415	44	0.6	1000	30.323	50.863	1.0	M5-5
78	19119	19451	1023165	1003714	19119	0	0.6	1000	30.323	50.863	1.0	M5-5
81	21179	21248	727821	706573	21179	0	0.6	1000	30.323	50.863	1.0	M5-5
84	10703	10715	200661	189946	10703	0	0.6	1000	30.323	50.863	1.0	M5-5
87	6286	6313	99681	93368	6286	0	0.6	1000	30.323	50.863	1.0	M5-5
90	8355	9423	70125	60702	8355	0	0.6	1000	30.323	50.863	1.0	M5-5
2	0	0	0	0	0	0	0.6	1000	37.241	48.409	1.0	M5-6
9	0	0	0	0	0	0	0.6	1000	37.241	48.409	1.0	M5-6
12	0	0	0	0	0	0	0.6	1000	37.241	48.409	1.0	M5-6
14	0	0	0	0	0	0	0.6	1000	37.241	48.409	1.0	M5-6
23	0	0	0	0	0	0	0.6	1000	37.241	48.409	1.0	M5-6
24	6138	6139	39340	33201	6144	6	0.6	1000	37.241	48.409	1.0	M5-6
27	1247	1253	28203	26950	1257	10	0.6	1000	37.241	48.409	1.0	M5-6
28	0	0	0	0	0	0	0.6	1000	37.241	48.409	1.0	M5-6
30	9186	9392	330891	321499	9274	88	0.6	1000	37.241	48.409	1.0	M5-6
33	15373	15548	975106	959558	15380	7	0.6	1000	37.241	48.409	1.0	M5-6
36	24926	25335	3242331	3216996	24934	8	0.6	1000	37.241	48.409	1.0	M5-6
39	246279	291631	14207115	13915484	246279	0	0.6	1000	37.241	48.409	1.0	M5-6
40	0	0	0	0	0	0	0.6	1000	37.241	48.409	1.0	M5-6
41	0	0	1	1	0	0	0.6	1000	37.241	48.409	1.0	M5-6
42	261216	264231	32833356	32569125	261555	339	0.6	1000	37.241	48.409	1.0	M5-6
45	416861	422919	59759778	59336859	417058	197	0.6	1000	37.241	48.409	1.0	M5-6
48	511318	512948	73441140	72928192	511473	155	0.6	1000	37.241	48.409	1.0	M5-6
49	0	0	0	0	0	0	0.6	1000	37.241	48.409	1.0	M5-6
50	1	1	3	2	1	0	0.6	1000	37.241	48.409	1.0	M5-6
51	325934	336587	71670378	71333791	331128	5194	0.6	1000	37.241	48.409	1.0	M5-6
52	0	0	1	1	0	0	0.6	1000	37.241	48.409	1.0	M5-6
53	0	0	0	0	0	0	0.6	1000	37.241	48.409	1.0	M5-6
54	291999	302607	65054121	64751514	292173	174	0.6	1000	37.241	48.409	1.0	M5-6
56	0	0	1	1	0	0	0.6	1000	37.241	48.409	1.0	M5-6
57	141471	146321	47292675	47146354	142924	1453	0.6	1000	37.241	48.409	1.0	M5-6
58	0	0	1	1	0	0	0.6	1000	37.241	48.409	1.0	M5-6
59	0	0	0	0	0	0	0.6	1000	37.241	48.409	1.0	M5-6
60	286012	293561	49625703	49332142	286213	201	0.6	1000	37.241	48.409	1.0	M5-6
62	0	0	0	0	0	0	0.6	1000	37.241	48.409	1.0	M5-6
63	429478	464512	45120250	44655738	429524	46	0.6	1000	37.241	48.409	1.0	M5-6
64	0	0	3	3	0	0	0.6	1000	37.241	48.409	1.0	M5-6
65	0	0	0	0	0	0	0.6	1000	37.241	48.409	1.0	M5-6
66	142439	145281	21069786	20924505	142445	6	0.6	1000	37.241	48.409	1.0	M5-6
68	0	0	1	1	0	0	0.6	1000	37.241	48.409	1.0	M5-6
69	61535	62053	12647935	12585882	61544	9	0.6	1000	37.241	48.409	1.0	M5-6
71	0	0	0	0	0	0	0.6	1000	37.241	48.409	1.0	M5-6
72	81439	82032	9607536	9525504	81443	4	0.6	1000	37.241	48.409	1.0	M5-6
75	66707	67076	4261740	4194664	66707	0	0.6	1000	37.241	48.409	1.0	M5-6
78	29735	29908	1514670	1484762	29737	2	0.6	1000	37.241	48.409	1.0	M5-6
80	0	0	0	0	0	0	0.6	1000	37.241	48.409	1.0	M5-6
81	17566	17584	406351	388767	17566	0	0.6	1000	37.241	48.409	1.0	M5-6
83	0	0	0	0	0	0	0.6	1000	37.241	48.409	1.0	M5-6
84	4674	4779	160461	155682	4674	0	0.6	1000	37.241	48.409	1.0	M5-6
87	16514	16514	77815	61301	16514	0	0.6	1000	37.241	48.409	1.0	M5-6
90	643	644	9870	9226	643	0	0.6	1000	37.241	48.409	1.0	M5-6
3	0	0	1	1	1	1	0.6	1000	37.543	40.664	1.0	M5-4
6	0	0	0	0	0	0	0.6	1000	37.543	40.664	1.0	M5-4
24	7097	7097	53956	46859	7097	0	0.6	1000	37.543	40.664	1.0	M5-4
25	0	0	0	0	0	0	0.6	1000	37.543	40.664	1.0	M5-4
27	3684	3684	61075	57391	3766	82	0.6	1000	37.543	40.664	1.0	M5-4
30	100119	100170	435711	335541	100129	10	0.6	1000	37.543	40.664	1.0	M5-4
33	32722	35009	1511191	1476182	33106	384	0.6	1000	37.543	40.664	1.0	M5-4
36	132784	133535	4965976	4832441	132811	27	0.6	1000	37.543	40.664	1.0	M5-4
39	74775	77207	9080191	9002984	74788	13	0.6	1000	37.543	40.664	1.0	M5-4
42	347103	352180	29533455	29181275	347437	334	0.6	1000	37.543	40.664	1.0	M5-4
43	0	0	0	0	0	0	0.6	1000	37.543	40.664	1.0	M5-4
45	154912	158736	35082876	34924140	155547	635	0.6	1000	37.543	40.664	1.0	M5-4
46	1	1	3	2	1	0	0.6	1000	37.543	40.664	1.0	M5-4
48	231278	233022	59508595	59275573	231337	59	0.6	1000	37.543	40.664	1.0	M5-4
50	0	0	0	0	0	0	0.6	1000	37.543	40.664	1.0	M5-4
51	257516	261406	69225261	68963855	257812	296	0.6	1000	37.543	40.664	1.0	M5-4
53	0	0	0	0	0	0	0.6	1000	37.543	40.664	1.0	M5-4
54	317221	320429	70834753	70514324	317625	404	0.6	1000	37.543	40.664	1.0	M5-4
55	0	0	15	15	0	0	0.6	1000	37.543	40.664	1.0	M5-4
57	388766	400461	63455745	63055284	390434	1668	0.6	1000	37.543	40.664	1.0	M5-4
58	1	1	1	0	1	0	0.6	1000	37.543	40.664	1.0	M5-4
59	1	3	6	3	1	0	0.6	1000	37.543	40.664	1.0	M5-4
60	285315	288440	44589846	44301406	285337	22	0.6	1000	37.543	40.664	1.0	M5-4
61	0	0	0	0	0	0	0.6	1000	37.543	40.664	1.0	M5-4
63	288235	290269	39298545	39008276	288444	209	0.6	1000	37.543	40.664	1.0	M5-4
65	0	0	0	0	0	0	0.6	1000	37.543	40.664	1.0	M5-4
66	238148	240244	28076271	27836027	238156	8	0.6	1000	37.543	40.664	1.0	M5-4
67	10	10	36	26	10	0	0.6	1000	37.543	40.664	1.0	M5-4
69	161621	162726	15975378	15812652	161636	15	0.6	1000	37.543	40.664	1.0	M5-4
72	202564	203047	11460078	11257031	202573	9	0.6	1000	37.543	40.664	1.0	M5-4
75	37931	38105	2575315	2537210	37931	0	0.6	1000	37.543	40.664	1.0	M5-4
78	33086	33322	1704781	1671459	33087	1	0.6	1000	37.543	40.664	1.0	M5-4
81	89115	96031	1565565	1469534	89115	0	0.6	1000	37.543	40.664	1.0	M5-4
84	1194	1237	72390	71153	1194	0	0.6	1000	37.543	40.664	1.0	M5-4
87	7124	7124	62481	55357	7124	0	0.6	1000	37.543	40.664	1.0	M5-4
90	3869	3976	28441	24465	3869	0	0.6	1000	37.543	40.664	1.0	M5-4
18	0	0	0	0	0	0	0.6	1000	6.013	15.164	0.1	M3-5
24	1033	1033	4278	3245	1033	0	0.6	1000	6.013	15.164	0.1	M3-5
27	103	103	946	843	103	0	0.6	1000	6.013	15.164	0.1	M3-5
30	1009	1033	14365	13332	1009	0	0.6	1000	6.013	15.164	0.1	M3-5
33	11861	12015	101926	89911	11861	0	0.6	1000	6.013	15.164	0.1	M3-5
36	7286499	7286653	13585078	6298425	7286499	0	0.6	1000	6.013	15.164	0.1	M3-5
39	70922	70949	973710	902761	70922	0	0.6	1000	6.013	15.164	0.1	M3-5
42	40759	40785	2023066	1982281	40763	4	0.6	1000	6.013	15.164	0.1	M3-5
45	313689	314956	6285285	5970329	313689	0	0.6	1000	6.013	15.164	0.1	M3-5
48	428217	429758	12224040	11794282	429206	989	0.6	1000	6.013	15.164	0.1	M3-5
51	575603	575911	13279281	12703370	575603	0	0.6	1000	6.013	15.164	0.1	M3-5
54	439793	440796	15354111	14913315	439793	0	0.6	1000	6.013	15.164	0.1	M3-5
55	0	0	0	0	0	0	0.6	1000	6.013	15.164	0.1	M3-5
57	215375	216884	7085730	6868846	215380	5	0.6	1000	6.013	15.164	0.1	M3-5
60	60383	66095	3407355	3341260	60383	0	0.6	1000	6.013	15.164	0.1	M3-5
63	441448	441450	3494046	3052596	441565	117	0.6	1000	6.013	15.164	0.1	M3-5
66	68013	68628	1785105	1716477	68013	0	0.6	1000	6.013	15.164	0.1	M3-5
69	305424	305441	2648451	2343010	305424	0	0.6	1000	6.013	15.164	0.1	M3-5
72	375423	375425	1569106	1193681	375430	7	0.6	1000	6.013	15.164	0.1	M3-5
75	24397	24501	434778	410277	24397	0	0.6	1000	6.013	15.164	0.1	M3-5
78	109686	109739	419986	310247	109686	0	0.6	1000	6.013	15.164	0.1	M3-5
81	356474	356474	579426	222952	356474	0	0.6	1000	6.013	15.164	0.1	M3-5
84	4559	4559	30876	26317	4559	0	0.6	1000	6.013	15.164	0.1	M3-5
87	33	33	1225	1192	33	0	0.6	1000	6.013	15.164	0.1	M3-5
90	18	18	325	307	18	0	0.6	1000	6.013	15.164	0.1	M3-5
18	0	0	0	0	0	0	0.6	1000	6.212	15.259	0.5	M3-5
24	1033	1033	4278	3245	1033	0	0.6	1000	6.212	15.259	0.5	M3-5
27	103	103	946	843	103	0	0.6	1000	6.212	15.259	0.5	M3-5
30	1009	1033	14365	13332	1009	0	0.6	1000	6.212	15.259	0.5	M3-5
33	11861	12015	101926	89911	11861	0	0.6	1000	6.212	15.259	0.5	M3-5
36	7286499	7286653	13585078	6298425	7286499	0	0.6	1000	6.212	15.259	0.5	M3-5
39	70922	70949	973710	902761	70922	0	0.6	1000	6.212	15.259	0.5	M3-5
42	40759	40785	2023066	1982281	40763	4	0.6	1000	6.212	15.259	0.5	M3-5
45	313268	314956	6285285	5970329	313270	2	0.6	1000	6.212	15.259	0.5	M3-5
48	428386	429758	12224040	11794282	429375	989	0.6	1000	6.212	15.259	0.5	M3-5
51	575711	575911	13279281	12703370	575711	0	0.6	1000	6.212	15.259	0.5	M3-5
54	440104	440796	15354111	14913315	440104	0	0.6	1000	6.212	15.259	0.5	M3-5
55	0	0	0	0	0	0	0.6	1000	6.212	15.259	0.5	M3-5
57	216638	216884	7085730	6868846	216651	13	0.6	1000	6.212	15.259	0.5	M3-5
60	65791	66095	3407355	3341260	65791	0	0.6	1000	6.212	15.259	0.5	M3-5
63	441448	441450	3494046	3052596	441565	117	0.6	1000	6.212	15.259	0.5	M3-5
66	68013	68628	1785105	1716477	68013	0	0.6	1000	6.212	15.259	0.5	M3-5
69	305424	305441	2648451	2343010	305424	0	0.6	1000	6.212	15.259	0.5	M3-5
72	375423	375425	1569106	1193681	375430	7	0.6	1000	6.212	15.259	0.5	M3-5
75	24397	24501	434778	410277	24397	0	0.6	1000	6.212	15.259	0.5	M3-5
78	109686	109739	419986	310247	109686	0	0.6	1000	6.212	15.259	0.5	M3-5
81	356474	356474	579426	222952	356474	0	0.6	1000	6.212	15.259	0.5	M3-5
84	4559	4559	30876	26317	4559	0	0.6	1000	6.212	15.259	0.5	M3-5
87	33	33	1225	1192	33	0	0.6	1000	6.212	15.259	0.5	M3-5
90	18	18	325	307	18	0	0.6	1000	6.212	15.259	0.5	M3-5
18	0	0	0	0	0	0	0.6	1000	6.257	15.107	0.3	M3-5
24	1033	1033	4278	3245	1033	0	0.6	1000	6.257	15.107	0.3	M3-5
27	103	103	946	843	103	0	0.6	1000	6.257	15.107	0.3	M3-5
30	1009	1033	14365	13332	1009	0	0.6	1000	6.257	15.107	0.3	M3-5
33	11861	12015	101926	89911	11861	0	0.6	1000	6.257	15.107	0.3	M3-5
36	7286499	7286653	13585078	6298425	7286499	0	0.6	1000	6.257	15.107	0.3	M3-5
39	70922	70949	973710	902761	70922	0	0.6	1000	6.257	15.107	0.3	M3-5
42	40759	40785	2023066	1982281	40763	4	0.6	1000	6.257	15.107	0.3	M3-5
45	199621	314956	6285285	5970329	199623	2	0.6	1000	6.257	15.107	0.3	M3-5
48	428401	429758	12224040	11794282	429391	990	0.6	1000	6.257	15.107	0.3	M3-5
51	575745	575911	13279281	12703370	575745	0	0.6	1000	6.257	15.107	0.3	M3-5
54	440054	440796	15354111	14913315	440054	0	0.6	1000	6.257	15.107	0.3	M3-5
55	0	0	0	0	0	0	0.6	1000	6.257	15.107	0.3	M3-5
57	215433	216884	7085730	6868846	215446	13	0.6	1000	6.257	15.107	0.3	M3-5
60	60390	66095	3407355	3341260	60390	0	0.6	1000	6.257	15.107	0.3	M3-5
63	441448	441450	3494046	3052596	441565	117	0.6	1000	6.257	15.107	0.3	M3-5
66	68013	68628	1785105	1716477	68013	0	0.6	1000	6.257	15.107	0.3	M3-5
69	305424	305441	2648451	2343010	305424	0	0.6	1000	6.257	15.107	0.3	M3-5
72	375423	375425	1569106	1193681	375430	7	0.6	1000	6.257	15.107	0.3	M3-5
75	24397	24501	434778	410277	24397	0	0.6	1000	6.257	15.107	0.3	M3-5
78	109686	109739	419986	310247	109686	0	0.6	1000	6.257	15.107	0.3	M3-5
81	356474	356474	579426	222952	356474	0	0.6	1000	6.257	15.107	0.3	M3-5
84	4559	4559	30876	26317	4559	0	0.6	1000	6.257	15.107	0.3	M3-5
87	33	33	1225	1192	33	0	0.6	1000	6.257	15.107	0.3	M3-5
90	18	18	325	307	18	0	0.6	1000	6.257	15.107	0.3	M3-5
6	0	0	0	0	0	0	0.6	1000	6.377	13.777	0.3	M3-8
24	7	7	378	371	7	0	0.6	1000	6.377	13.777	0.3	M3-8
27	266	266	2346	2080	266	0	0.6	1000	6.377	13.777	0.3	M3-8
30	1988	1988	12880	10892	1988	0	0.6	1000	6.377	13.777	0.3	M3-8
33	15311	15370	177310	161940	15311	0	0.6	1000	6.377	13.777	0.3	M3-8
36	10785	10823	267546	256723	10785	0	0.6	1000	6.377	13.777	0.3	M3-8
39	254223	256230	2168403	1912173	254223	0	0.6	1000	6.377	13.777	0.3	M3-8
42	158734	158736	2463090	2304354	158736	2	0.6	1000	6.377	13.777	0.3	M3-8
45	183828	184826	5486328	5301502	183834	6	0.6	1000	6.377	13.777	0.3	M3-8
48	338354	338517	9088716	8750199	338355	1	0.6	1000	6.377	13.777	0.3	M3-8
51	401599	402211	7165005	6762794	401607	8	0.6	1000	6.377	13.777	0.3	M3-8
54	7428126	7436616	37027315	29590699	7428138	12	0.6	1000	6.377	13.777	0.3	M3-8
57	696544	699737	11014471	10314734	696558	14	0.6	1000	6.377	13.777	0.3	M3-8
60	396661	397042	6806205	6409163	396661	0	0.6	1000	6.377	13.777	0.3	M3-8
62	0	0	0	0	0	0	0.6	1000	6.377	13.777	0.3	M3-8
63	43778	43868	2563980	2520112	43778	0	0.6	1000	6.377	13.777	0.3	M3-8
66	60343	60505	1876953	1816448	60343	0	0.6	1000	6.377	13.777	0.3	M3-8
69	58293	58299	1284003	1225704	58337	44	0.6	1000	6.377	13.777	0.3	M3-8
71	45	45	45	0	45	0	0.6	1000	6.377	13.777	0.3	M3-8
72	368351	370034	1563796	1193762	368351	0	0.6	1000	6.377	13.777	0.3	M3-8
74	0	0	0	0	0	0	0.6	1000	6.377	13.777	0.3	M3-8
75	76958	76959	717003	640044	76958	0	0.6	1000	6.377	13.777	0.3	M3-8
78	26142	26142	280875	254733	26142	0	0.6	1000	6.377	13.777	0.3	M3-8
81	64892	64897	177310	112413	64892	0	0.6	1000	6.377	13.777	0.3	M3-8
84	385	385	4851	4466	385	0	0.6	1000	6.377	13.777	0.3	M3-8
87	400434	400434	464166	63732	400434	0	0.6	1000	6.377	13.777	0.3	M3-8
90	13	13	378	365	13	0	0.6	1000	6.377	13.777	0.3	M3-8
24	632	632	3321	2689	632	0	0.6	1000	6.414	13.268	0.1	M3-4
27	10319	10319	35245	24926	10397	78	0.6	1000	6.414	13.268	0.1	M3-4
30	5108	5108	22578	17470	5108	0	0.6	1000	6.414	13.268	0.1	M3-4
33	16090	16097	141778	125681	16090	0	0.6	1000	6.414	13.268	0.1	M3-4
36	160877	160877	1197378	1036501	160877	0	0.6	1000	6.414	13.268	0.1	M3-4
39	98329	98426	1422141	1323715	98329	0	0.6	1000	6.414	13.268	0.1	M3-4
42	224154	224171	3854476	3630305	224157	3	0.6	1000	6.414	13.268	0.1	M3-4
45	132855	133768	4108411	3974643	132862	7	0.6	1000	6.414	13.268	0.1	M3-4
48	39504	40393	3977610	3937217	39512	8	0.6	1000	6.414	13.268	0.1	M3-4
51	485478	489072	12482506	11993434	485503	25	0.6	1000	6.414	13.268	0.1	M3-4
53	0	0	0	0	0	0	0.6	1000	6.414	13.268	0.1	M3-4
54	227286	228390	7521381	7292991	227286	0	0.6	1000	6.414	13.268	0.1	M3-4
57	395363	396164	6806205	6410041	395415	52	0.6	1000	6.414	13.268	0.1	M3-4
60	196300	197294	3552445	3355151	196325	25	0.6	1000	6.414	13.268	0.1	M3-4
63	91673	91976	4068378	3976402	91673	0	0.6	1000	6.414	13.268	0.1	M3-4
66	60111	60139	1873080	1812941	60117	6	0.6	1000	6.414	13.268	0.1	M3-4
69	238948	239588	3186550	2946962	238948	0	0.6	1000	6.414	13.268	0.1	M3-4
72	12882	12975	425503	412528	12882	0	0.6	1000	6.414	13.268	0.1	M3-4
75	436794	436794	1834570	1397776	436794	0	0.6	1000	6.414	13.268	0.1	M3-4
78	52233	52233	319600	267367	52233	0	0.6	1000	6.414	13.268	0.1	M3-4
81	401110	402004	660675	258671	401110	0	0.6	1000	6.414	13.268	0.1	M3-4
84	985	985	11325	10340	985	0	0.6	1000	6.414	13.268	0.1	M3-4
87	9977	9977	47586	37609	9977	0	0.6	1000	6.414	13.268	0.1	M3-4
90	309	309	1326	1017	309	0	0.6	1000	6.414	13.268	0.1	M3-4
9	0	0	0	0	0	0	0.6	1000	6.464	10.606	0.1	M3-2
24	71	71	903	832	71	0	0.6	1000	6.464	10.606	0.1	M3-2
27	135	138	2016	1878	135	0	0.6	1000	6.464	10.606	0.1	M3-2
30	30	30	2775	2745	30	0	0.6	1000	6.464	10.606	0.1	M3-2
33	16245	16245	177310	161065	16245	0	0.6	1000	6.464	10.606	0.1	M3-2
36	5334	5335	147153	141818	5352	18	0.6	1000	6.464	10.606	0.1	M3-2
39	101417	101962	1546161	1444199	101418	1	0.6	1000	6.464	10.606	0.1	M3-2
42	879494	885326	12120426	11235100	879494	0	0.6	1000	6.464	10.606	0.1	M3-2
45	38674	38684	2463090	2424406	38676	2	0.6	1000	6.464	10.606	0.1	M3-2
47	0	0	0	0	0	0	0.6	1000	6.464	10.606	0.1	M3-2
48	394456	395976	12338028	11942052	394461	5	0.6	1000	6.464	10.606	0.1	M3-2
50	0	0	0	0	0	0	0.6	1000	6.464	10.606	0.1	M3-2
51	56587	57346	4134250	4076904	56587	0	0.6	1000	6.464	10.606	0.1	M3-2
54	464276	465607	8759205	8293598	464277	1	0.6	1000	6.464	10.606	0.1	M3-2
57	439368	439803	8042055	7602252	439391	23	0.6	1000	6.464	10.606	0.1	M3-2
60	458952	459534	7842780	7383246	458968	16	0.6	1000	6.464	10.606	0.1	M3-2
61	0	0	0	0	0	0	0.6	1000	6.464	10.606	0.1	M3-2
63	645953	646083	8876791	8230708	645953	0	0.6	1000	6.464	10.606	0.1	M3-2
66	293552	294164	5328480	5034316	293552	0	0.6	1000	6.464	10.606	0.1	M3-2
69	26824	27174	1054878	1027704	26824	0	0.6	1000	6.464	10.606	0.1	M3-2
72	44173	44186	565516	521330	44186	13	0.6	1000	6.464	10.606	0.1	M3-2
74	0	0	0	0	0	0	0.6	1000	6.464	10.606	0.1	M3-2
75	10165	10173	222111	211938	10165	0	0.6	1000	6.464	10.606	0.1	M3-2
78	45204	45206	226128	180922	45204	0	0.6	1000	6.464	10.606	0.1	M3-2
81	25848	26035	183315	157280	25848	0	0.6	1000	6.464	10.606	0.1	M3-2
84	2141	2141	28203	26062	2141	0	0.6	1000	6.464	10.606	0.1	M3-2
87	32	32	630	598	32	0	0.6	1000	6.464	10.606	0.1	M3-2
90	3402	3402	10440	7038	3402	0	0.6	1000	6.464	10.606	0.1	M3-2
3	0	0	0	0	0	0	0.6	1000	6.541	11.865	0.3	M3-6
24	234	234	1431	1197	234	0	0.6	1000	6.541	11.865	0.3	M3-6
27	495	495	2211	1716	495	0	0.6	1000	6.541	11.865	0.3	M3-6
30	920	920	19306	18386	943	23	0.6	1000	6.541	11.865	0.3	M3-6
33	122870	124053	649230	525177	122872	2	0.6	1000	6.541	11.865	0.3	M3-6
36	39614	39710	622170	582460	39614	0	0.6	1000	6.541	11.865	0.3	M3-6
39	406287	407197	1734453	1327256	406287	0	0.6	1000	6.541	11.865	0.3	M3-6
42	483740	484061	6431491	5947430	483747	7	0.6	1000	6.541	11.865	0.3	M3-6
43	0	0	0	0	0	0	0.6	1000	6.541	11.865	0.3	M3-6
45	977955	1029235	18877440	17848205	977957	2	0.6	1000	6.541	11.865	0.3	M3-6
48	111705	112030	5263390	5151360	111787	82	0.6	1000	6.541	11.865	0.3	M3-6
51	382168	384916	10711506	10326590	382208	40	0.6	1000	6.541	11.865	0.3	M3-6
54	383619	392938	6517855	6124917	383619	0	0.6	1000	6.541	11.865	0.3	M3-6
57	170466	170846	6619341	6448495	170469	3	0.6	1000	6.541	11.865	0.3	M3-6
60	30581	30901	2436528	2405627	30581	0	0.6	1000	6.541	11.865	0.3	M3-6
63	7502223	7503221	27324528	19821307	7502223	0	0.6	1000	6.541	11.865	0.3	M3-6
66	254322	254831	2476425	2221594	254325	3	0.6	1000	6.541	11.865	0.3	M3-6
69	132999	133536	1611910	1478374	133005	6	0.6	1000	6.541	11.865	0.3	M3-6
72	33574	33574	779376	745802	33576	2	0.6	1000	6.541	11.865	0.3	M3-6
75	18976	18983	468996	450013	18982	6	0.6	1000	6.541	11.865	0.3	M3-6
78	5204	5204	113526	108322	5204	0	0.6	1000	6.541	11.865	0.3	M3-6
81	209	209	14028	13819	209	0	0.6	1000	6.541	11.865	0.3	M3-6
84	205	205	3916	3711	205	0	0.6	1000	6.541	11.865	0.3	M3-6
87	63	63	1431	1368	63	0	0.6	1000	6.541	11.865	0.3	M3-6
90	169	169	1035	866	169	0	0.6	1000	6.541	11.865	0.3	M3-6
24	95	106	903	797	95	0	0.6	1000	6.555	11.728	0.3	M3-7
27	17	17	496	479	17	0	0.6	1000	6.555	11.728	0.3	M3-7
30	1763	1787	18721	16934	1763	0	0.6	1000	6.555	11.728	0.3	M3-7
33	6692	6692	44253	37561	6692	0	0.6	1000	6.555	11.728	0.3	M3-7
36	9314	9383	288420	279037	9315	1	0.6	1000	6.555	11.728	0.3	M3-7
39	108971	110298	1554966	1444668	108971	0	0.6	1000	6.555	11.728	0.3	M3-7
42	251765	251827	2941525	2689698	251765	0	0.6	1000	6.555	11.728	0.3	M3-7
45	238012	239318	6295926	6056608	238022	10	0.6	1000	6.555	11.728	0.3	M3-7
48	500375	500553	7642095	7141542	500376	1	0.6	1000	6.555	11.728	0.3	M3-7
51	371971	372695	10490490	10117795	371971	0	0.6	1000	6.555	11.728	0.3	M3-7
54	569454	570085	10888111	10318026	569454	0	0.6	1000	6.555	11.728	0.3	M3-7
57	384277	384932	6670378	6285446	384412	135	0.6	1000	6.555	11.728	0.3	M3-7
59	0	0	0	0	0	0	0.6	1000	6.555	11.728	0.3	M3-7
60	471214	475605	9533161	9057556	471215	1	0.6	1000	6.555	11.728	0.3	M3-7
63	86703	88349	3451878	3363529	86703	0	0.6	1000	6.555	11.728	0.3	M3-7
66	3054554	7276149	16230753	8954604	3054554	0	0.6	1000	6.555	11.728	0.3	M3-7
67	0	0	0	0	0	0	0.6	1000	6.555	11.728	0.3	M3-7
68	0	0	0	0	0	0	0.6	1000	6.555	11.728	0.3	M3-7
69	20227	20244	770661	750417	20227	0	0.6	1000	6.555	11.728	0.3	M3-7
72	244156	244276	1439056	1194780	244156	0	0.6	1000	6.555	11.728	0.3	M3-7
73	0	0	0	0	0	0	0.6	1000	6.555	11.728	0.3	M3-7
75	4467	4468	159330	154862	4467	0	0.6	1000	6.555	11.728	0.3	M3-7
78	47268	47558	391170	343612	47268	0	0.6	1000	6.555	11.728	0.3	M3-7
81	11221	11221	72390	61169	11221	0	0.6	1000	6.555	11.728	0.3	M3-7
84	3356	3356	23653	20297	3356	0	0.6	1000	6.555	11.728	0.3	M3-7
87	120753	120753	407253	286500	120753	0	0.6	1000	6.555	11.728	0.3	M3-7
90	6114	6114	9453	3339	6114	0	0.6	1000	6.555	11.728	0.3	M3-7
3	0	0	0	0	0	0	0.6	1000	6.797	12.41	0.1	M3-6
24	234	234	1431	1197	234	0	0.6	1000	6.797	12.41	0.1	M3-6
27	495	495	2211	1716	495	0	0.6	1000	6.797	12.41	0.1	M3-6
30	920	920	19306	18386	943	23	0.6	1000	6.797	12.41	0.1	M3-6
33	122870	124053	649230	525177	122872	2	0.6	1000	6.797	12.41	0.1	M3-6
36	39614	39710	622170	582460	39614	0	0.6	1000	6.797	12.41	0.1	M3-6
39	406287	407197	1734453	1327256	406287	0	0.6	1000	6.797	12.41	0.1	M3-6
42	483740	484061	6431491	5947430	483747	7	0.6	1000	6.797	12.41	0.1	M3-6
43	0	0	0	0	0	0	0.6	1000	6.797	12.41	0.1	M3-6
45	975781	1029235	18877440	17848205	975783	2	0.6	1000	6.797	12.41	0.1	M3-6
48	111445	112030	5263390	5151360	111527	82	0.6	1000	6.797	12.41	0.1	M3-6
51	382755	384916	10711506	10326590	382757	2	0.6	1000	6.797	12.41	0.1	M3-6
54	381227	392938	6517855	6124917	381227	0	0.6	1000	6.797	12.41	0.1	M3-6
57	170461	170846	6619341	6448495	170464	3	0.6	1000	6.797	12.41	0.1	M3-6
60	30675	30901	2436528	2405627	30675	0	0.6	1000	6.797	12.41	0.1	M3-6
63	4475576	7503221	27324528	19821307	4475576	0	0.6	1000	6.797	12.41	0.1	M3-6
66	254322	254831	2476425	2221594	254325	3	0.6	1000	6.797	12.41	0.1	M3-6
69	132999	133536	1611910	1478374	133005	6	0.6	1000	6.797	12.41	0.1	M3-6
72	33574	33574	779376	745802	33576	2	0.6	1000	6.797	12.41	0.1	M3-6
75	18976	18983	468996	450013	18982	6	0.6	1000	6.797	12.41	0.1	M3-6
78	5204	5204	113526	108322	5204	0	0.6	1000	6.797	12.41	0.1	M3-6
81	209	209	14028	13819	209	0	0.6	1000	6.797	12.41	0.1	M3-6
84	205	205	3916	3711	205	0	0.6	1000	6.797	12.41	0.1	M3-6
87	63	63	1431	1368	63	0	0.6	1000	6.797	12.41	0.1	M3-6
90	169	169	1035	866	169	0	0.6	1000	6.797	12.41	0.1	M3-6
3	0	0	0	0	0	0	0.6	1000	6.884	16.437	0.5	M3-6
24	234	234	1431	1197	234	0	0.6	1000	6.884	16.437	0.5	M3-6
27	495	495	2211	1716	495	0	0.6	1000	6.884	16.437	0.5	M3-6
30	920	920	19306	18386	943	23	0.6	1000	6.884	16.437	0.5	M3-6
33	122870	124053	649230	525177	122872	2	0.6	1000	6.884	16.437	0.5	M3-6
36	39614	39710	622170	582460	39614	0	0.6	1000	6.884	16.437	0.5	M3-6
39	406287	407197	1734453	1327256	406287	0	0.6	1000	6.884	16.437	0.5	M3-6
42	483740	484061	6431491	5947430	483747	7	0.6	1000	6.884	16.437	0.5	M3-6
43	0	0	0	0	0	0	0.6	1000	6.884	16.437	0.5	M3-6
45	975075	1029235	18877440	17848205	975077	2	0.6	1000	6.884	16.437	0.5	M3-6
48	111721	112030	5263390	5151360	111803	82	0.6	1000	6.884	16.437	0.5	M3-6
51	382849	384916	10711506	10326590	382851	2	0.6	1000	6.884	16.437	0.5	M3-6
54	381417	392938	6517855	6124917	381417	0	0.6	1000	6.884	16.437	0.5	M3-6
57	170359	170846	6619341	6448495	170362	3	0.6	1000	6.884	16.437	0.5	M3-6
60	30643	30901	2436528	2405627	30643	0	0.6	1000	6.884	16.437	0.5	M3-6
63	7502237	7503221	27324528	19821307	7502237	0	0.6	1000	6.884	16.437	0.5	M3-6
66	254322	254831	2476425	2221594	254325	3	0.6	1000	6.884	16.437	0.5	M3-6
69	132999	133536	1611910	1478374	133005	6	0.6	1000	6.884	16.437	0.5	M3-6
72	33574	33574	779376	745802	33576	2	0.6	1000	6.884	16.437	0.5	M3-6
75	18976	18983	468996	450013	18982	6	0.6	1000	6.884	16.437	0.5	M3-6
78	5204	5204	113526	108322	5204	0	0.6	1000	6.884	16.437	0.5	M3-6
81	209	209	14028	13819	209	0	0.6	1000	6.884	16.437	0.5	M3-6
84	205	205	3916	3711	205	0	0.6	1000	6.884	16.437	0.5	M3-6
87	63	63	1431	1368	63	0	0.6	1000	6.884	16.437	0.5	M3-6
90	169	169	1035	866	169	0	0.6	1000	6.884	16.437	0.5	M3-6
24	632	632	3321	2689	632	0	0.6	1000	7.038	14.581	0.5	M3-4
27	10319	10319	35245	24926	10397	78	0.6	1000	7.038	14.581	0.5	M3-4
30	5108	5108	22578	17470	5108	0	0.6	1000	7.038	14.581	0.5	M3-4
33	16090	16097	141778	125681	16090	0	0.6	1000	7.038	14.581	0.5	M3-4
36	160877	160877	1197378	1036501	160877	0	0.6	1000	7.038	14.581	0.5	M3-4
39	98329	98426	1422141	1323715	98329	0	0.6	1000	7.038	14.581	0.5	M3-4
42	224154	224171	3854476	3630305	224157	3	0.6	1000	7.038	14.581	0.5	M3-4
45	133073	133768	4108411	3974643	133080	7	0.6	1000	7.038	14.581	0.5	M3-4
48	39668	40393	3977610	3937217	39675	7	0.6	1000	7.038	14.581	0.5	M3-4
51	485730	489072	12482506	11993434	485755	25	0.6	1000	7.038	14.581	0.5	M3-4
53	0	0	0	0	0	0	0.6	1000	7.038	14.581	0.5	M3-4
54	227540	228390	7521381	7292991	227540	0	0.6	1000	7.038	14.581	0.5	M3-4
57	395664	396164	6806205	6410041	395717	53	0.6	1000	7.038	14.581	0.5	M3-4
60	196560	197294	3552445	3355151	196589	29	0.6	1000	7.038	14.581	0.5	M3-4
63	91914	91976	4068378	3976402	91914	0	0.6	1000	7.038	14.581	0.5	M3-4
66	60111	60139	1873080	1812941	60117	6	0.6	1000	7.038	14.581	0.5	M3-4
69	238948	239588	3186550	2946962	238948	0	0.6	1000	7.038	14.581	0.5	M3-4
72	12882	12975	425503	412528	12882	0	0.6	1000	7.038	14.581	0.5	M3-4
75	436794	436794	1834570	1397776	436794	0	0.6	1000	7.038	14.581	0.5	M3-4
78	52233	52233	319600	267367	52233	0	0.6	1000	7.038	14.581	0.5	M3-4
81	401110	402004	660675	258671	401110	0	0.6	1000	7.038	14.581	0.5	M3-4
84	985	985	11325	10340	985	0	0.6	1000	7.038	14.581	0.5	M3-4
87	9977	9977	47586	37609	9977	0	0.6	1000	7.038	14.581	0.5	M3-4
90	309	309	1326	1017	309	0	0.6	1000	7.038	14.581	0.5	M3-4
6	0	0	0	0	0	0	0.6	1000	7.094	13.088	0.1	M3-8
24	7	7	378	371	7	0	0.6	1000	7.094	13.088	0.1	M3-8
27	266	266	2346	2080	266	0	0.6	1000	7.094	13.088	0.1	M3-8
30	1988	1988	12880	10892	1988	0	0.6	1000	7.094	13.088	0.1	M3-8
33	15311	15370	177310	161940	15311	0	0.6	1000	7.094	13.088	0.1	M3-8
36	10785	10823	267546	256723	10785	0	0.6	1000	7.094	13.088	0.1	M3-8
39	254223	256230	2168403	1912173	254223	0	0.6	1000	7.094	13.088	0.1	M3-8
42	158734	158736	2463090	2304354	158736	2	0.6	1000	7.094	13.088	0.1	M3-8
45	183958	184826	5486328	5301502	183964	6	0.6	1000	7.094	13.088	0.1	M3-8
48	338112	338517	9088716	8750199	338113	1	0.6	1000	7.094	13.088	0.1	M3-8
51	401592	402211	7165005	6762794	401600	8	0.6	1000	7.094	13.088	0.1	M3-8
54	7432008	7436616	37027315	29590699	7432020	12	0.6	1000	7.094	13.088	0.1	M3-8
57	696984	699737	11014471	10314734	696996	12	0.6	1000	7.094	13.088	0.1	M3-8
60	395989	397042	6806205	6409163	395989	0	0.6	1000	7.094	13.088	0.1	M3-8
62	0	0	0	0	0	0	0.6	1000	7.094	13.088	0.1	M3-8
63	43782	43868	2563980	2520112	43782	0	0.6	1000	7.094	13.088	0.1	M3-8
66	60343	60505	1876953	1816448	60343	0	0.6	1000	7.094	13.088	0.1	M3-8
69	58293	58299	1284003	1225704	58337	44	0.6	1000	7.094	13.088	0.1	M3-8
71	45	45	45	0	45	0	0.6	1000	7.094	13.088	0.1	M3-8
72	368351	370034	1563796	1193762	368351	0	0.6	1000	7.094	13.088	0.1	M3-8
74	0	0	0	0	0	0	0.6	1000	7.094	13.088	0.1	M3-8
75	76958	76959	717003	640044	76958	0	0.6	1000	7.094	13.088	0.1	M3-8
78	26142	26142	280875	254733	26142	0	0.6	1000	7.094	13.088	0.1	M3-8
81	64892	64897	177310	112413	64892	0	0.6	1000	7.094	13.088	0.1	M3-8
84	385	385	4851	4466	385	0	0.6	1000	7.094	13.088	0.1	M3-8
87	400434	400434	464166	63732	400434	0	0.6	1000	7.094	13.088	0.1	M3-8
90	13	13	378	365	13	0	0.6	1000	7.094	13.088	0.1	M3-8
9	66	66	66	0	66	0	0.6	1000	7.153	12.605	0.3	M3-10
15	0	0	0	0	0	0	0.6	1000	7.153	12.605	0.3	M3-10
24	336	336	4278	3942	336	0	0.6	1000	7.153	12.605	0.3	M3-10
27	3875	3875	8778	4903	3875	0	0.6	1000	7.153	12.605	0.3	M3-10
30	45	49	4005	3956	46	1	0.6	1000	7.153	12.605	0.3	M3-10
33	7604	7624	124251	116627	7604	0	0.6	1000	7.153	12.605	0.3	M3-10
36	1932	1933	89676	87743	1932	0	0.6	1000	7.153	12.605	0.3	M3-10
39	305019	305208	3272961	2967753	305586	567	0.6	1000	7.153	12.605	0.3	M3-10
42	563603	563605	5282875	4719270	563603	0	0.6	1000	7.153	12.605	0.3	M3-10
44	1	1	1	0	1	0	0.6	1000	7.153	12.605	0.3	M3-10
45	309955	310149	4200651	3890502	309960	5	0.6	1000	7.153	12.605	0.3	M3-10
48	7345925	7346193	28437111	21090918	7346316	391	0.6	1000	7.153	12.605	0.3	M3-10
51	114026	114586	6367096	6252510	114032	6	0.6	1000	7.153	12.605	0.3	M3-10
54	116081	117169	5747745	5630576	116083	2	0.6	1000	7.153	12.605	0.3	M3-10
55	15	21	36	15	15	0	0.6	1000	7.153	12.605	0.3	M3-10
56	703	703	703	0	703	0	0.6	1000	7.153	12.605	0.3	M3-10
57	198474	199424	7229503	7030079	198567	93	0.6	1000	7.153	12.605	0.3	M3-10
60	48572	49300	4051281	4001981	48572	0	0.6	1000	7.153	12.605	0.3	M3-10
63	284216	286195	4661931	4375736	284216	0	0.6	1000	7.153	12.605	0.3	M3-10
64	0	0	0	0	0	0	0.6	1000	7.153	12.605	0.3	M3-10
66	456672	458197	5566116	5107919	456672	0	0.6	1000	7.153	12.605	0.3	M3-10
69	117731	117732	1941435	1823703	117758	27	0.6	1000	7.153	12.605	0.3	M3-10
72	15122	15128	371953	356825	15142	20	0.6	1000	7.153	12.605	0.3	M3-10
75	247632	247632	950131	702499	247632	0	0.6	1000	7.153	12.605	0.3	M3-10
78	357763	357767	843051	485284	357763	0	0.6	1000	7.153	12.605	0.3	M3-10
81	1931	1937	30381	28444	1931	0	0.6	1000	7.153	12.605	0.3	M3-10
84	3026	3026	11935	8909	3026	0	0.6	1000	7.153	12.605	0.3	M3-10
87	129286	129286	224115	94829	129286	0	0.6	1000	7.153	12.605	0.3	M3-10
90	6	6	231	225	6	0	0.6	1000	7.153	12.605	0.3	M3-10
12	0	0	0	0	0	0	0.6	1000	7.309	11.808	0.1	M3-1
24	19	19	528	509	20	1	0.6	1000	7.309	11.808	0.1	M3-1
27	1012	1012	3403	2391	1012	0	0.6	1000	7.309	11.808	0.1	M3-1
30	2244	2244	20706	18462	2266	22	0.6	1000	7.309	11.808	0.1	M3-1
33	14453	14843	188191	173348	14453	0	0.6	1000	7.309	11.808	0.1	M3-1
36	7238877	7242680	9894576	2651896	7238881	4	0.6	1000	7.309	11.808	0.1	M3-1
39	263400	263445	2729616	2466171	263400	0	0.6	1000	7.309	11.808	0.1	M3-1
42	35711	35878	2158003	2122125	35836	125	0.6	1000	7.309	11.808	0.1	M3-1
45	54001	56285	3736011	3679726	54002	1	0.6	1000	7.309	11.808	0.1	M3-1
48	727549	728177	10776403	10048226	727557	8	0.6	1000	7.309	11.808	0.1	M3-1
51	442853	443478	10131751	9688273	442858	5	0.6	1000	7.309	11.808	0.1	M3-1
54	101180	102378	5519503	5417125	101180	0	0.6	1000	7.309	11.808	0.1	M3-1
57	99339	99788	4837605	4737817	99630	291	0.6	1000	7.309	11.808	0.1	M3-1
59	0	0	0	0	0	0	0.6	1000	7.309	11.808	0.1	M3-1
60	221378	221616	3573801	3352185	221378	0	0.6	1000	7.309	11.808	0.1	M3-1
62	0	0	0	0	0	0	0.6	1000	7.309	11.808	0.1	M3-1
63	575511	576491	9748320	9171829	575511	0	0.6	1000	7.309	11.808	0.1	M3-1
64	0	0	0	0	0	0	0.6	1000	7.309	11.808	0.1	M3-1
66	293041	293128	2492028	2198900	293041	0	0.6	1000	7.309	11.808	0.1	M3-1
68	10	10	15	5	10	0	0.6	1000	7.309	11.808	0.1	M3-1
69	359501	359725	4045590	3685865	359512	11	0.6	1000	7.309	11.808	0.1	M3-1
72	72649	75317	1553203	1477886	72649	0	0.6	1000	7.309	11.808	0.1	M3-1
75	18352	18352	328455	310103	18354	2	0.6	1000	7.309	11.808	0.1	M3-1
76	0	0	0	0	0	0	0.6	1000	7.309	11.808	0.1	M3-1
78	132571	132572	773146	640574	132571	0	0.6	1000	7.309	11.808	0.1	M3-1
81	5138	5138	36585	31447	5138	0	0.6	1000	7.309	11.808	0.1	M3-1
84	623	623	9730	9107	623	0	0.6	1000	7.309	11.808	0.1	M3-1
87	478	478	6670	6192	478	0	0.6	1000	7.309	11.808	0.1	M3-1
90	294	305	2278	1973	294	0	0.6	1000	7.309	11.808	0.1	M3-1
9	66	66	66	0	66	0	0.6	1000	7.309	18.27	0.1	M3-10
15	0	0	0	0	0	0	0.6	1000	7.309	18.27	0.1	M3-10
24	336	336	4278	3942	336	0	0.6	1000	7.309	18.27	0.1	M3-10
27	3875	3875	8778	4903	3875	0	0.6	1000	7.309	18.27	0.1	M3-10
30	45	49	4005	3956	46	1	0.6	1000	7.309	18.27	0.1	M3-10
33	7604	7624	124251	116627	7604	0	0.6	1000	7.309	18.27	0.1	M3-10
36	1932	1933	89676	87743	1932	0	0.6	1000	7.309	18.27	0.1	M3-10
39	305019	305208	3272961	2967753	305586	567	0.6	1000	7.309	18.27	0.1	M3-10
42	563603	563605	5282875	4719270	563603	0	0.6	1000	7.309	18.27	0.1	M3-10
44	1	1	1	0	1	0	0.6	1000	7.309	18.27	0.1	M3-10
45	309598	310149	4200651	3890502	309603	5	0.6	1000	7.309	18.27	0.1	M3-10
48	7345889	7346193	28437111	21090918	7346160	271	0.6	1000	7.309	18.27	0.1	M3-10
51	112398	114586	6367096	6252510	112404	6	0.6	1000	7.309	18.27	0.1	M3-10
54	115983	117169	5747745	5630576	115985	2	0.6	1000	7.309	18.27	0.1	M3-10
55	15	21	36	15	15	0	0.6	1000	7.309	18.27	0.1	M3-10
56	703	703	703	0	703	0	0.6	1000	7.309	18.27	0.1	M3-10
57	198353	199424	7229503	7030079	198459	106	0.6	1000	7.309	18.27	0.1	M3-10
60	48506	49300	4051281	4001981	48506	0	0.6	1000	7.309	18.27	0.1	M3-10
63	284258	286195	4661931	4375736	284258	0	0.6	1000	7.309	18.27	0.1	M3-10
64	0	0	0	0	0	0	0.6	1000	7.309	18.27	0.1	M3-10
66	455915	458197	5566116	5107919	455915	0	0.6	1000	7.309	18.27	0.1	M3-10
69	117731	117732	1941435	1823703	117758	27	0.6	1000	7.309	18.27	0.1	M3-10
72	15122	15128	371953	356825	15142	20	0.6	1000	7.309	18.27	0.1	M3-10
75	247632	247632	950131	702499	247632	0	0.6	1000	7.309	18.27	0.1	M3-10
78	357763	357767	843051	485284	357763	0	0.6	1000	7.309	18.27	0.1	M3-10
81	1931	1937	30381	28444	1931	0	0.6	1000	7.309	18.27	0.1	M3-10
84	3026	3026	11935	8909	3026	0	0.6	1000	7.309	18.27	0.1	M3-10
87	129286	129286	224115	94829	129286	0	0.6	1000	7.309	18.27	0.1	M3-10
90	6	6	231	225	6	0	0.6	1000	7.309	18.27	0.1	M3-10
12	0	0	0	0	0	0	0.6	1000	7.328	17.692	0.5	M3-1
24	19	19	528	509	20	1	0.6	1000	7.328	17.692	0.5	M3-1
27	1012	1012	3403	2391	1012	0	0.6	1000	7.328	17.692	0.5	M3-1
30	2244	2244	20706	18462	2266	22	0.6	1000	7.328	17.692	0.5	M3-1
33	14453	14843	188191	173348	14453	0	0.6	1000	7.328	17.692	0.5	M3-1
36	7238877	7242680	9894576	2651896	7238881	4	0.6	1000	7.328	17.692	0.5	M3-1
39	263400	263445	2729616	2466171	263400	0	0.6	1000	7.328	17.692	0.5	M3-1
42	35711	35878	2158003	2122125	35836	125	0.6	1000	7.328	17.692	0.5	M3-1
45	48044	56285	3736011	3679726	48045	1	0.6	1000	7.328	17.692	0.5	M3-1
48	727667	728177	10776403	10048226	727669	2	0.6	1000	7.328	17.692	0.5	M3-1
51	440786	443478	10131751	9688273	440793	7	0.6	1000	7.328	17.692	0.5	M3-1
54	101695	102378	5519503	5417125	101699	4	0.6	1000	7.328	17.692	0.5	M3-1
57	99397	99788	4837605	4737817	99688	291	0.6	1000	7.328	17.692	0.5	M3-1
59	0	0	0	0	0	0	0.6	1000	7.328	17.692	0.5	M3-1
60	221461	221616	3573801	3352185	221500	39	0.6	1000	7.328	17.692	0.5	M3-1
62	0	0	0	0	0	0	0.6	1000	7.328	17.692	0.5	M3-1
63	575714	576491	9748320	9171829	575714	0	0.6	1000	7.328	17.692	0.5	M3-1
64	0	0	0	0	0	0	0.6	1000	7.328	17.692	0.5	M3-1
66	293041	293128	2492028	2198900	293041	0	0.6	1000	7.328	17.692	0.5	M3-1
68	10	10	15	5	10	0	0.6	1000	7.328	17.692	0.5	M3-1
69	359636	359725	4045590	3685865	359647	11	0.6	1000	7.328	17.692	0.5	M3-1
72	72649	75317	1553203	1477886	72649	0	0.6	1000	7.328	17.692	0.5	M3-1
75	18352	18352	328455	310103	18354	2	0.6	1000	7.328	17.692	0.5	M3-1
76	0	0	0	0	0	0	0.6	1000	7.328	17.692	0.5	M3-1
78	132571	132572	773146	640574	132571	0	0.6	1000	7.328	17.692	0.5	M3-1
81	5138	5138	36585	31447	5138	0	0.6	1000	7.328	17.692	0.5	M3-1
84	623	623	9730	9107	623	0	0.6	1000	7.328	17.692	0.5	M3-1
87	478	478	6670	6192	478	0	0.6	1000	7.328	17.692	0.5	M3-1
90	294	305	2278	1973	294	0	0.6	1000	7.328	17.692	0.5	M3-1
24	95	106	903	797	95	0	0.6	1000	7.461	12.761	0.5	M3-7
27	17	17	496	479	17	0	0.6	1000	7.461	12.761	0.5	M3-7
30	1763	1787	18721	16934	1763	0	0.6	1000	7.461	12.761	0.5	M3-7
33	6692	6692	44253	37561	6692	0	0.6	1000	7.461	12.761	0.5	M3-7
36	9314	9383	288420	279037	9315	1	0.6	1000	7.461	12.761	0.5	M3-7
39	108971	110298	1554966	1444668	108971	0	0.6	1000	7.461	12.761	0.5	M3-7
42	251765	251827	2941525	2689698	251765	0	0.6	1000	7.461	12.761	0.5	M3-7
45	239220	239318	6295926	6056608	239228	8	0.6	1000	7.461	12.761	0.5	M3-7
48	500146	500553	7642095	7141542	500147	1	0.6	1000	7.461	12.761	0.5	M3-7
51	371829	372695	10490490	10117795	371829	0	0.6	1000	7.461	12.761	0.5	M3-7
54	569427	570085	10888111	10318026	569427	0	0.6	1000	7.461	12.761	0.5	M3-7
57	384344	384932	6670378	6285446	384479	135	0.6	1000	7.461	12.761	0.5	M3-7
59	0	0	0	0	0	0	0.6	1000	7.461	12.761	0.5	M3-7
60	471068	475605	9533161	9057556	471069	1	0.6	1000	7.461	12.761	0.5	M3-7
63	86802	88349	3451878	3363529	86802	0	0.6	1000	7.461	12.761	0.5	M3-7
66	3208297	7276149	16230753	8954604	3208297	0	0.6	1000	7.461	12.761	0.5	M3-7
67	0	0	0	0	0	0	0.6	1000	7.461	12.761	0.5	M3-7
68	0	0	0	0	0	0	0.6	1000	7.461	12.761	0.5	M3-7
69	20227	20244	770661	750417	20227	0	0.6	1000	7.461	12.761	0.5	M3-7
72	244156	244276	1439056	1194780	244156	0	0.6	1000	7.461	12.761	0.5	M3-7
73	0	0	0	0	0	0	0.6	1000	7.461	12.761	0.5	M3-7
75	4467	4468	159330	154862	4467	0	0.6	1000	7.461	12.761	0.5	M3-7
78	47268	47558	391170	343612	47268	0	0.6	1000	7.461	12.761	0.5	M3-7
81	11221	11221	72390	61169	11221	0	0.6	1000	7.461	12.761	0.5	M3-7
84	3356	3356	23653	20297	3356	0	0.6	1000	7.461	12.761	0.5	M3-7
87	120753	120753	407253	286500	120753	0	0.6	1000	7.461	12.761	0.5	M3-7
90	6114	6114	9453	3339	6114	0	0.6	1000	7.461	12.761	0.5	M3-7
18	0	0	0	0	0	0	0.6	1000	7.526	15.6	1.0	M3-5
24	1033	1033	4278	3245	1033	0	0.6	1000	7.526	15.6	1.0	M3-5
27	103	103	946	843	103	0	0.6	1000	7.526	15.6	1.0	M3-5
30	1009	1033	14365	13332	1009	0	0.6	1000	7.526	15.6	1.0	M3-5
33	11861	12015	101926	89911	11861	0	0.6	1000	7.526	15.6	1.0	M3-5
36	7286499	7286653	13585078	6298425	7286499	0	0.6	1000	7.526	15.6	1.0	M3-5
39	70922	70949	973710	902761	70922	0	0.6	1000	7.526	15.6	1.0	M3-5
42	40759	40785	2023066	1982281	40763	4	0.6	1000	7.526	15.6	1.0	M3-5
45	313254	314956	6285285	5970329	313256	2	0.6	1000	7.526	15.6	1.0	M3-5
48	427862	429758	12224040	11794282	428852	990	0.6	1000	7.526	15.6	1.0	M3-5
51	575096	575911	13279281	12703370	575096	0	0.6	1000	7.526	15.6	1.0	M3-5
54	439773	440796	15354111	14913315	439773	0	0.6	1000	7.526	15.6	1.0	M3-5
55	0	0	0	0	0	0	0.6	1000	7.526	15.6	1.0	M3-5
57	215926	216884	7085730	6868846	215939	13	0.6	1000	7.526	15.6	1.0	M3-5
60	65766	66095	3407355	3341260	65766	0	0.6	1000	7.526	15.6	1.0	M3-5
63	441448	441450	3494046	3052596	441565	117	0.6	1000	7.526	15.6	1.0	M3-5
66	68013	68628	1785105	1716477	68013	0	0.6	1000	7.526	15.6	1.0	M3-5
69	305424	305441	2648451	2343010	305424	0	0.6	1000	7.526	15.6	1.0	M3-5
72	375423	375425	1569106	1193681	375430	7	0.6	1000	7.526	15.6	1.0	M3-5
75	24397	24501	434778	410277	24397	0	0.6	1000	7.526	15.6	1.0	M3-5
78	109686	109739	419986	310247	109686	0	0.6	1000	7.526	15.6	1.0	M3-5
81	356474	356474	579426	222952	356474	0	0.6	1000	7.526	15.6	1.0	M3-5
84	4559	4559	30876	26317	4559	0	0.6	1000	7.526	15.6	1.0	M3-5
87	33	33	1225	1192	33	0	0.6	1000	7.526	15.6	1.0	M3-5
90	18	18	325	307	18	0	0.6	1000	7.526	15.6	1.0	M3-5
3	0	0	0	0	0	0	0.6	1000	7.723	13.107	1.0	M3-6
24	234	234	1431	1197	234	0	0.6	1000	7.723	13.107	1.0	M3-6
27	495	495	2211	1716	495	0	0.6	1000	7.723	13.107	1.0	M3-6
30	920	920	19306	18386	943	23	0.6	1000	7.723	13.107	1.0	M3-6
33	122870	124053	649230	525177	122872	2	0.6	1000	7.723	13.107	1.0	M3-6
36	39614	39710	622170	582460	39614	0	0.6	1000	7.723	13.107	1.0	M3-6
39	406287	407197	1734453	1327256	406287	0	0.6	1000	7.723	13.107	1.0	M3-6
42	483740	484061	6431491	5947430	483747	7	0.6	1000	7.723	13.107	1.0	M3-6
43	0	0	0	0	0	0	0.6	1000	7.723	13.107	1.0	M3-6
45	1023067	1029235	18877440	17848205	1023069	2	0.6	1000	7.723	13.107	1.0	M3-6
48	111740	112030	5263390	5151360	111822	82	0.6	1000	7.723	13.107	1.0	M3-6
51	381759	384916	10711506	10326590	381761	2	0.6	1000	7.723	13.107	1.0	M3-6
54	390533	392938	6517855	6124917	390533	0	0.6	1000	7.723	13.107	1.0	M3-6
57	170595	170846	6619341	6448495	170598	3	0.6	1000	7.723	13.107	1.0	M3-6
60	30783	30901	2436528	2405627	30808	25	0.6	1000	7.723	13.107	1.0	M3-6
63	7502297	7503221	27324528	19821307	7502297	0	0.6	1000	7.723	13.107	1.0	M3-6
66	254322	254831	2476425	2221594	254325	3	0.6	1000	7.723	13.107	1.0	M3-6
69	132999	133536	1611910	1478374	133005	6	0.6	1000	7.723	13.107	1.0	M3-6
72	33574	33574	779376	745802	33576	2	0.6	1000	7.723	13.107	1.0	M3-6
75	18976	18983	468996	450013	18982	6	0.6	1000	7.723	13.107	1.0	M3-6
78	5204	5204	113526	108322	5204	0	0.6	1000	7.723	13.107	1.0	M3-6
81	209	209	14028	13819	209	0	0.6	1000	7.723	13.107	1.0	M3-6
84	205	205	3916	3711	205	0	0.6	1000	7.723	13.107	1.0	M3-6
87	63	63	1431	1368	63	0	0.6	1000	7.723	13.107	1.0	M3-6
90	169	169	1035	866	169	0	0.6	1000	7.723	13.107	1.0	M3-6
24	95	106	903	797	95	0	0.6	1000	7.757	12.366	0.1	M3-7
27	17	17	496	479	17	0	0.6	1000	7.757	12.366	0.1	M3-7
30	1763	1787	18721	16934	1763	0	0.6	1000	7.757	12.366	0.1	M3-7
33	6692	6692	44253	37561	6692	0	0.6	1000	7.757	12.366	0.1	M3-7
36	9314	9383	288420	279037	9315	1	0.6	1000	7.757	12.366	0.1	M3-7
39	108971	110298	1554966	1444668	108971	0	0.6	1000	7.757	12.366	0.1	M3-7
42	251765	251827	2941525	2689698	251765	0	0.6	1000	7.757	12.366	0.1	M3-7
45	238072	239318	6295926	6056608	238072	0	0.6	1000	7.757	12.366	0.1	M3-7
48	500269	500553	7642095	7141542	500270	1	0.6	1000	7.757	12.366	0.1	M3-7
51	371669	372695	10490490	10117795	371669	0	0.6	1000	7.757	12.366	0.1	M3-7
54	569386	570085	10888111	10318026	569386	0	0.6	1000	7.757	12.366	0.1	M3-7
57	384327	384932	6670378	6285446	384454	127	0.6	1000	7.757	12.366	0.1	M3-7
59	0	0	0	0	0	0	0.6	1000	7.757	12.366	0.1	M3-7
60	471473	475605	9533161	9057556	471474	1	0.6	1000	7.757	12.366	0.1	M3-7
63	86600	88349	3451878	3363529	86600	0	0.6	1000	7.757	12.366	0.1	M3-7
66	3240412	7276149	16230753	8954604	3240412	0	0.6	1000	7.757	12.366	0.1	M3-7
67	0	0	0	0	0	0	0.6	1000	7.757	12.366	0.1	M3-7
68	0	0	0	0	0	0	0.6	1000	7.757	12.366	0.1	M3-7
69	20227	20244	770661	750417	20227	0	0.6	1000	7.757	12.366	0.1	M3-7
72	244156	244276	1439056	1194780	244156	0	0.6	1000	7.757	12.366	0.1	M3-7
73	0	0	0	0	0	0	0.6	1000	7.757	12.366	0.1	M3-7
75	4467	4468	159330	154862	4467	0	0.6	1000	7.757	12.366	0.1	M3-7
78	47268	47558	391170	343612	47268	0	0.6	1000	7.757	12.366	0.1	M3-7
81	11221	11221	72390	61169	11221	0	0.6	1000	7.757	12.366	0.1	M3-7
84	3356	3356	23653	20297	3356	0	0.6	1000	7.757	12.366	0.1	M3-7
87	120753	120753	407253	286500	120753	0	0.6	1000	7.757	12.366	0.1	M3-7
90	6114	6114	9453	3339	6114	0	0.6	1000	7.757	12.366	0.1	M3-7
6	0	0	0	0	0	0	0.6	1000	7.813	14.684	0.5	M3-8
24	7	7	378	371	7	0	0.6	1000	7.813	14.684	0.5	M3-8
27	266	266	2346	2080	266	0	0.6	1000	7.813	14.684	0.5	M3-8
30	1988	1988	12880	10892	1988	0	0.6	1000	7.813	14.684	0.5	M3-8
33	15311	15370	177310	161940	15311	0	0.6	1000	7.813	14.684	0.5	M3-8
36	10785	10823	267546	256723	10785	0	0.6	1000	7.813	14.684	0.5	M3-8
39	254223	256230	2168403	1912173	254223	0	0.6	1000	7.813	14.684	0.5	M3-8
42	158734	158736	2463090	2304354	158736	2	0.6	1000	7.813	14.684	0.5	M3-8
45	183826	184826	5486328	5301502	183832	6	0.6	1000	7.813	14.684	0.5	M3-8
48	338350	338517	9088716	8750199	338350	0	0.6	1000	7.813	14.684	0.5	M3-8
51	401653	402211	7165005	6762794	401661	8	0.6	1000	7.813	14.684	0.5	M3-8
54	7428045	7436616	37027315	29590699	7428057	12	0.6	1000	7.813	14.684	0.5	M3-8
57	695725	699737	11014471	10314734	695739	14	0.6	1000	7.813	14.684	0.5	M3-8
60	396636	397042	6806205	6409163	396636	0	0.6	1000	7.813	14.684	0.5	M3-8
62	0	0	0	0	0	0	0.6	1000	7.813	14.684	0.5	M3-8
63	43780	43868	2563980	2520112	43780	0	0.6	1000	7.813	14.684	0.5	M3-8
66	60343	60505	1876953	1816448	60343	0	0.6	1000	7.813	14.684	0.5	M3-8
69	58293	58299	1284003	1225704	58337	44	0.6	1000	7.813	14.684	0.5	M3-8
71	45	45	45	0	45	0	0.6	1000	7.813	14.684	0.5	M3-8
72	368351	370034	1563796	1193762	368351	0	0.6	1000	7.813	14.684	0.5	M3-8
74	0	0	0	0	0	0	0.6	1000	7.813	14.684	0.5	M3-8
75	76958	76959	717003	640044	76958	0	0.6	1000	7.813	14.684	0.5	M3-8
78	26142	26142	280875	254733	26142	0	0.6	1000	7.813	14.684	0.5	M3-8
81	64892	64897	177310	112413	64892	0	0.6	1000	7.813	14.684	0.5	M3-8
84	385	385	4851	4466	385	0	0.6	1000	7.813	14.684	0.5	M3-8
87	400434	400434	464166	63732	400434	0	0.6	1000	7.813	14.684	0.5	M3-8
90	13	13	378	365	13	0	0.6	1000	7.813	14.684	0.5	M3-8
24	270561	270561	301476	30915	270561	0	0.6	1000	7.931	11.727	0.5	M3-9
27	21	21	741	720	21	0	0.6	1000	7.931	11.727	0.5	M3-9
30	90534	90534	299151	208617	90534	0	0.6	1000	7.931	11.727	0.5	M3-9
33	11401	11432	196251	184819	11423	22	0.6	1000	7.931	11.727	0.5	M3-9
36	2021	2039	138601	136562	2023	2	0.6	1000	7.931	11.727	0.5	M3-9
37	0	0	0	0	0	0	0.6	1000	7.931	11.727	0.5	M3-9
39	14523	14524	634501	619977	14523	0	0.6	1000	7.931	11.727	0.5	M3-9
42	541098	543515	9367956	8824441	541101	3	0.6	1000	7.931	11.727	0.5	M3-9
45	583322	603363	7123425	6520062	583324	2	0.6	1000	7.931	11.727	0.5	M3-9
48	6281003	7681394	38935900	31254506	6281003	0	0.6	1000	7.931	11.727	0.5	M3-9
51	118723	119469	5602878	5483409	118728	5	0.6	1000	7.931	11.727	0.5	M3-9
52	0	0	0	0	0	0	0.6	1000	7.931	11.727	0.5	M3-9
53	0	0	0	0	0	0	0.6	1000	7.931	11.727	0.5	M3-9
54	121502	151345	4890628	4739283	121523	21	0.6	1000	7.931	11.727	0.5	M3-9
55	55	55	78	23	55	0	0.6	1000	7.931	11.727	0.5	M3-9
56	703	703	703	0	703	0	0.6	1000	7.931	11.727	0.5	M3-9
57	317007	318804	7130976	6812172	317007	0	0.6	1000	7.931	11.727	0.5	M3-9
60	52397	52568	3560446	3507878	52397	0	0.6	1000	7.931	11.727	0.5	M3-9
63	73128	73188	3298596	3225408	73276	148	0.6	1000	7.931	11.727	0.5	M3-9
66	94972	95155	2701650	2606495	94972	0	0.6	1000	7.931	11.727	0.5	M3-9
69	45642	45645	1381953	1336308	45642	0	0.6	1000	7.931	11.727	0.5	M3-9
72	142021	142046	1332528	1190482	142021	0	0.6	1000	7.931	11.727	0.5	M3-9
75	83432	83432	579426	495994	83433	1	0.6	1000	7.931	11.727	0.5	M3-9
78	24514	24583	165600	141017	24514	0	0.6	1000	7.931	11.727	0.5	M3-9
81	380483	380486	658378	277892	380483	0	0.6	1000	7.931	11.727	0.5	M3-9
84	2041	2043	12246	10203	2041	0	0.6	1000	7.931	11.727	0.5	M3-9
87	1044	1048	8778	7730	1044	0	0.6	1000	7.931	11.727	0.5	M3-9
90	2501	2501	5253	2752	2501	0	0.6	1000	7.931	11.727	0.5	M3-9
24	95	106	903	797	95	0	0.6	1000	7.954	18.632	1.0	M3-7
27	17	17	496	479	17	0	0.6	1000	7.954	18.632	1.0	M3-7
30	1763	1787	18721	16934	1763	0	0.6	1000	7.954	18.632	1.0	M3-7
33	6692	6692	44253	37561	6692	0	0.6	1000	7.954	18.632	1.0	M3-7
36	9314	9383	288420	279037	9315	1	0.6	1000	7.954	18.632	1.0	M3-7
39	108971	110298	1554966	1444668	108971	0	0.6	1000	7.954	18.632	1.0	M3-7
42	251765	251827	2941525	2689698	251765	0	0.6	1000	7.954	18.632	1.0	M3-7
45	238696	239318	6295926	6056608	238706	10	0.6	1000	7.954	18.632	1.0	M3-7
48	500163	500553	7642095	7141542	500164	1	0.6	1000	7.954	18.632	1.0	M3-7
51	371377	372695	10490490	10117795	371377	0	0.6	1000	7.954	18.632	1.0	M3-7
54	569521	570085	10888111	10318026	569521	0	0.6	1000	7.954	18.632	1.0	M3-7
57	384768	384932	6670378	6285446	384903	135	0.6	1000	7.954	18.632	1.0	M3-7
59	0	0	0	0	0	0	0.6	1000	7.954	18.632	1.0	M3-7
60	473248	475605	9533161	9057556	473248	0	0.6	1000	7.954	18.632	1.0	M3-7
63	88067	88349	3451878	3363529	88067	0	0.6	1000	7.954	18.632	1.0	M3-7
66	2314647	7276149	16230753	8954604	2314647	0	0.6	1000	7.954	18.632	1.0	M3-7
67	0	0	0	0	0	0	0.6	1000	7.954	18.632	1.0	M3-7
68	0	0	0	0	0	0	0.6	1000	7.954	18.632	1.0	M3-7
69	20227	20244	770661	750417	20227	0	0.6	1000	7.954	18.632	1.0	M3-7
72	244156	244276	1439056	1194780	244156	0	0.6	1000	7.954	18.632	1.0	M3-7
73	0	0	0	0	0	0	0.6	1000	7.954	18.632	1.0	M3-7
75	4467	4468	159330	154862	4467	0	0.6	1000	7.954	18.632	1.0	M3-7
78	47268	47558	391170	343612	47268	0	0.6	1000	7.954	18.632	1.0	M3-7
81	11221	11221	72390	61169	11221	0	0.6	1000	7.954	18.632	1.0	M3-7
84	3356	3356	23653	20297	3356	0	0.6	1000	7.954	18.632	1.0	M3-7
87	120753	120753	407253	286500	120753	0	0.6	1000	7.954	18.632	1.0	M3-7
90	6114	6114	9453	3339	6114	0	0.6	1000	7.954	18.632	1.0	M3-7
9	0	0	0	0	0	0	0.6	1000	8.031	11.612	0.1	M3-3
24	144	144	1176	1032	144	0	0.6	1000	8.031	11.612	0.1	M3-3
27	872	914	5151	4237	872	0	0.6	1000	8.031	11.612	0.1	M3-3
30	3659	3659	20706	17047	3659	0	0.6	1000	8.031	11.612	0.1	M3-3
33	240575	240634	578350	337716	240575	0	0.6	1000	8.031	11.612	0.1	M3-3
36	42091	42123	409060	366937	42091	0	0.6	1000	8.031	11.612	0.1	M3-3
39	3918725	7485958	21855966	14370008	3918725	0	0.6	1000	8.031	11.612	0.1	M3-3
42	393643	394519	5795310	5400791	393747	104	0.6	1000	8.031	11.612	0.1	M3-3
45	262827	263631	6474601	6210970	262827	0	0.6	1000	8.031	11.612	0.1	M3-3
48	86030	87551	4686391	4598840	86030	0	0.6	1000	8.031	11.612	0.1	M3-3
51	594819	595313	10799628	10204315	594819	0	0.6	1000	8.031	11.612	0.1	M3-3
54	431825	433368	9939111	9505743	431825	0	0.6	1000	8.031	11.612	0.1	M3-3
55	0	0	0	0	0	0	0.6	1000	8.031	11.612	0.1	M3-3
57	568013	569739	9859020	9289281	568015	2	0.6	1000	8.031	11.612	0.1	M3-3
60	155504	155747	3319176	3163429	155508	4	0.6	1000	8.031	11.612	0.1	M3-3
63	278086	279069	4723201	4444132	278086	0	0.6	1000	8.031	11.612	0.1	M3-3
64	0	0	0	0	0	0	0.6	1000	8.031	11.612	0.1	M3-3
66	188091	190118	3738745	3548627	188091	0	0.6	1000	8.031	11.612	0.1	M3-3
69	83935	83935	1853775	1769840	83935	0	0.6	1000	8.031	11.612	0.1	M3-3
70	0	0	0	0	0	0	0.6	1000	8.031	11.612	0.1	M3-3
72	164925	164925	1330896	1165971	164928	3	0.6	1000	8.031	11.612	0.1	M3-3
75	7553	7592	208981	201389	7553	0	0.6	1000	8.031	11.612	0.1	M3-3
77	0	0	0	0	0	0	0.6	1000	8.031	11.612	0.1	M3-3
78	9239	9240	172578	163338	9239	0	0.6	1000	8.031	11.612	0.1	M3-3
81	692	695	17020	16325	692	0	0.6	1000	8.031	11.612	0.1	M3-3
84	549	549	9591	9042	549	0	0.6	1000	8.031	11.612	0.1	M3-3
87	23709	24101	66430	42329	23709	0	0.6	1000	8.031	11.612	0.1	M3-3
90	20	20	351	331	20	0	0.6	1000	8.031	11.612	0.1	M3-3
9	66	66	66	0	66	0	0.6	1000	8.094	12.733	1.0	M3-10
15	0	0	0	0	0	0	0.6	1000	8.094	12.733	1.0	M3-10
24	336	336	4278	3942	336	0	0.6	1000	8.094	12.733	1.0	M3-10
27	3875	3875	8778	4903	3875	0	0.6	1000	8.094	12.733	1.0	M3-10
30	45	49	4005	3956	46	1	0.6	1000	8.094	12.733	1.0	M3-10
33	7604	7624	124251	116627	7604	0	0.6	1000	8.094	12.733	1.0	M3-10
36	1932	1933	89676	87743	1932	0	0.6	1000	8.094	12.733	1.0	M3-10
39	305019	305208	3272961	2967753	305586	567	0.6	1000	8.094	12.733	1.0	M3-10
42	563603	563605	5282875	4719270	563603	0	0.6	1000	8.094	12.733	1.0	M3-10
44	1	1	1	0	1	0	0.6	1000	8.094	12.733	1.0	M3-10
45	309927	310149	4200651	3890502	309932	5	0.6	1000	8.094	12.733	1.0	M3-10
48	6761515	7346193	28437111	21090918	6761906	391	0.6	1000	8.094	12.733	1.0	M3-10
51	114096	114586	6367096	6252510	114102	6	0.6	1000	8.094	12.733	1.0	M3-10
54	111840	117169	5747745	5630576	111841	1	0.6	1000	8.094	12.733	1.0	M3-10
55	15	21	36	15	15	0	0.6	1000	8.094	12.733	1.0	M3-10
56	703	703	703	0	703	0	0.6	1000	8.094	12.733	1.0	M3-10
57	198491	199424	7229503	7030079	198584	93	0.6	1000	8.094	12.733	1.0	M3-10
60	48615	49300	4051281	4001981	48616	1	0.6	1000	8.094	12.733	1.0	M3-10
63	284273	286195	4661931	4375736	284273	0	0.6	1000	8.094	12.733	1.0	M3-10
64	0	0	0	0	0	0	0.6	1000	8.094	12.733	1.0	M3-10
66	455704	458197	5566116	5107919	455704	0	0.6	1000	8.094	12.733	1.0	M3-10
69	117731	117732	1941435	1823703	117758	27	0.6	1000	8.094	12.733	1.0	M3-10
72	15122	15128	371953	356825	15142	20	0.6	1000	8.094	12.733	1.0	M3-10
75	247632	247632	950131	702499	247632	0	0.6	1000	8.094	12.733	1.0	M3-10
78	357763	357767	843051	485284	357763	0	0.6	1000	8.094	12.733	1.0	M3-10
81	1931	1937	30381	28444	1931	0	0.6	1000	8.094	12.733	1.0	M3-10
84	3026	3026	11935	8909	3026	0	0.6	1000	8.094	12.733	1.0	M3-10
87	129286	129286	224115	94829	129286	0	0.6	1000	8.094	12.733	1.0	M3-10
90	6	6	231	225	6	0	0.6	1000	8.094	12.733	1.0	M3-10
24	270561	270561	301476	30915	270561	0	0.6	1000	8.235	11.559	0.1	M3-9
27	21	21	741	720	21	0	0.6	1000	8.235	11.559	0.1	M3-9
30	90534	90534	299151	208617	90534	0	0.6	1000	8.235	11.559	0.1	M3-9
33	11401	11432	196251	184819	11423	22	0.6	1000	8.235	11.559	0.1	M3-9
36	2021	2039	138601	136562	2023	2	0.6	1000	8.235	11.559	0.1	M3-9
37	0	0	0	0	0	0	0.6	1000	8.235	11.559	0.1	M3-9
39	14523	14524	634501	619977	14523	0	0.6	1000	8.235	11.559	0.1	M3-9
42	540694	543515	9367956	8824441	540697	3	0.6	1000	8.235	11.559	0.1	M3-9
45	599366	603363	7123425	6520062	599380	14	0.6	1000	8.235	11.559	0.1	M3-9
48	7665860	7681394	38935900	31254506	7665861	1	0.6	1000	8.235	11.559	0.1	M3-9
51	118595	119469	5602878	5483409	118602	7	0.6	1000	8.235	11.559	0.1	M3-9
52	0	0	0	0	0	0	0.6	1000	8.235	11.559	0.1	M3-9
53	0	0	0	0	0	0	0.6	1000	8.235	11.559	0.1	M3-9
54	120082	151345	4890628	4739283	120103	21	0.6	1000	8.235	11.559	0.1	M3-9
55	55	55	78	23	55	0	0.6	1000	8.235	11.559	0.1	M3-9
56	703	703	703	0	703	0	0.6	1000	8.235	11.559	0.1	M3-9
57	317033	318804	7130976	6812172	317033	0	0.6	1000	8.235	11.559	0.1	M3-9
60	52286	52568	3560446	3507878	52286	0	0.6	1000	8.235	11.559	0.1	M3-9
63	72961	73188	3298596	3225408	73109	148	0.6	1000	8.235	11.559	0.1	M3-9
66	94895	95155	2701650	2606495	94895	0	0.6	1000	8.235	11.559	0.1	M3-9
69	45642	45645	1381953	1336308	45642	0	0.6	1000	8.235	11.559	0.1	M3-9
72	142021	142046	1332528	1190482	142021	0	0.6	1000	8.235	11.559	0.1	M3-9
75	83432	83432	579426	495994	83433	1	0.6	1000	8.235	11.559	0.1	M3-9
78	24514	24583	165600	141017	24514	0	0.6	1000	8.235	11.559	0.1	M3-9
81	380483	380486	658378	277892	380483	0	0.6	1000	8.235	11.559	0.1	M3-9
84	2041	2043	12246	10203	2041	0	0.6	1000	8.235	11.559	0.1	M3-9
87	1044	1048	8778	7730	1044	0	0.6	1000	8.235	11.559	0.1	M3-9
90	2501	2501	5253	2752	2501	0	0.6	1000	8.235	11.559	0.1	M3-9
9	0	0	0	0	0	0	0.6	1000	9.068	15.127	0.5	M3-3
24	144	144	1176	1032	144	0	0.6	1000	9.068	15.127	0.5	M3-3
27	872	914	5151	4237	872	0	0.6	1000	9.068	15.127	0.5	M3-3
30	3659	3659	20706	17047	3659	0	0.6	1000	9.068	15.127	0.5	M3-3
33	240575	240634	578350	337716	240575	0	0.6	1000	9.068	15.127	0.5	M3-3
36	42091	42123	409060	366937	42091	0	0.6	1000	9.068	15.127	0.5	M3-3
39	3509500	7485958	21855966	14370008	3509500	0	0.6	1000	9.068	15.127	0.5	M3-3
42	392952	394519	5795310	5400791	393056	104	0.6	1000	9.068	15.127	0.5	M3-3
45	262518	263631	6474601	6210970	262523	5	0.6	1000	9.068	15.127	0.5	M3-3
48	85711	87551	4686391	4598840	85711	0	0.6	1000	9.068	15.127	0.5	M3-3
51	594537	595313	10799628	10204315	594537	0	0.6	1000	9.068	15.127	0.5	M3-3
54	432649	433368	9939111	9505743	432649	0	0.6	1000	9.068	15.127	0.5	M3-3
55	0	0	0	0	0	0	0.6	1000	9.068	15.127	0.5	M3-3
57	568103	569739	9859020	9289281	568105	2	0.6	1000	9.068	15.127	0.5	M3-3
60	155451	155747	3319176	3163429	155455	4	0.6	1000	9.068	15.127	0.5	M3-3
63	278761	279069	4723201	4444132	278761	0	0.6	1000	9.068	15.127	0.5	M3-3
64	0	0	0	0	0	0	0.6	1000	9.068	15.127	0.5	M3-3
66	188426	190118	3738745	3548627	188426	0	0.6	1000	9.068	15.127	0.5	M3-3
69	83935	83935	1853775	1769840	83935	0	0.6	1000	9.068	15.127	0.5	M3-3
70	0	0	0	0	0	0	0.6	1000	9.068	15.127	0.5	M3-3
72	164925	164925	1330896	1165971	164928	3	0.6	1000	9.068	15.127	0.5	M3-3
75	7553	7592	208981	201389	7553	0	0.6	1000	9.068	15.127	0.5	M3-3
77	0	0	0	0	0	0	0.6	1000	9.068	15.127	0.5	M3-3
78	9239	9240	172578	163338	9239	0	0.6	1000	9.068	15.127	0.5	M3-3
81	692	695	17020	16325	692	0	0.6	1000	9.068	15.127	0.5	M3-3
84	549	549	9591	9042	549	0	0.6	1000	9.068	15.127	0.5	M3-3
87	23709	24101	66430	42329	23709	0	0.6	1000	9.068	15.127	0.5	M3-3
90	20	20	351	331	20	0	0.6	1000	9.068	15.127	0.5	M3-3
9	66	66	66	0	66	0	0.6	1000	9.467	16.801	0.5	M3-10
15	0	0	0	0	0	0	0.6	1000	9.467	16.801	0.5	M3-10
24	336	336	4278	3942	336	0	0.6	1000	9.467	16.801	0.5	M3-10
27	3875	3875	8778	4903	3875	0	0.6	1000	9.467	16.801	0.5	M3-10
30	45	49	4005	3956	46	1	0.6	1000	9.467	16.801	0.5	M3-10
33	7604	7624	124251	116627	7604	0	0.6	1000	9.467	16.801	0.5	M3-10
36	1932	1933	89676	87743	1932	0	0.6	1000	9.467	16.801	0.5	M3-10
39	305019	305208	3272961	2967753	305586	567	0.6	1000	9.467	16.801	0.5	M3-10
42	563603	563605	5282875	4719270	563603	0	0.6	1000	9.467	16.801	0.5	M3-10
44	1	1	1	0	1	0	0.6	1000	9.467	16.801	0.5	M3-10
45	309990	310149	4200651	3890502	309995	5	0.6	1000	9.467	16.801	0.5	M3-10
48	7346040	7346193	28437111	21090918	7346431	391	0.6	1000	9.467	16.801	0.5	M3-10
51	113853	114586	6367096	6252510	113859	6	0.6	1000	9.467	16.801	0.5	M3-10
54	111744	117169	5747745	5630576	111746	2	0.6	1000	9.467	16.801	0.5	M3-10
55	15	21	36	15	15	0	0.6	1000	9.467	16.801	0.5	M3-10
56	703	703	703	0	703	0	0.6	1000	9.467	16.801	0.5	M3-10
57	198488	199424	7229503	7030079	198593	105	0.6	1000	9.467	16.801	0.5	M3-10
60	48638	49300	4051281	4001981	48638	0	0.6	1000	9.467	16.801	0.5	M3-10
63	284674	286195	4661931	4375736	284674	0	0.6	1000	9.467	16.801	0.5	M3-10
64	0	0	0	0	0	0	0.6	1000	9.467	16.801	0.5	M3-10
66	455669	458197	5566116	5107919	455669	0	0.6	1000	9.467	16.801	0.5	M3-10
69	117731	117732	1941435	1823703	117758	27	0.6	1000	9.467	16.801	0.5	M3-10
72	15122	15128	371953	356825	15142	20	0.6	1000	9.467	16.801	0.5	M3-10
75	247632	247632	950131	702499	247632	0	0.6	1000	9.467	16.801	0.5	M3-10
78	357763	357767	843051	485284	357763	0	0.6	1000	9.467	16.801	0.5	M3-10
81	1931	1937	30381	28444	1931	0	0.6	1000	9.467	16.801	0.5	M3-10
84	3026	3026	11935	8909	3026	0	0.6	1000	9.467	16.801	0.5	M3-10
87	129286	129286	224115	94829	129286	0	0.6	1000	9.467	16.801	0.5	M3-10
90	6	6	231	225	6	0	0.6	1000	9.467	16.801	0.5	M3-10
24	632	632	3321	2689	632	0	0.6	1000	9.522	17.799	1.0	M3-4
27	10319	10319	35245	24926	10397	78	0.6	1000	9.522	17.799	1.0	M3-4
30	5108	5108	22578	17470	5108	0	0.6	1000	9.522	17.799	1.0	M3-4
33	16090	16097	141778	125681	16090	0	0.6	1000	9.522	17.799	1.0	M3-4
36	160877	160877	1197378	1036501	160877	0	0.6	1000	9.522	17.799	1.0	M3-4
39	98329	98426	1422141	1323715	98329	0	0.6	1000	9.522	17.799	1.0	M3-4
42	224154	224171	3854476	3630305	224157	3	0.6	1000	9.522	17.799	1.0	M3-4
45	133148	133768	4108411	3974643	133155	7	0.6	1000	9.522	17.799	1.0	M3-4
48	39680	40393	3977610	3937217	39687	7	0.6	1000	9.522	17.799	1.0	M3-4
51	485474	489072	12482506	11993434	485499	25	0.6	1000	9.522	17.799	1.0	M3-4
53	0	0	0	0	0	0	0.6	1000	9.522	17.799	1.0	M3-4
54	227621	228390	7521381	7292991	227621	0	0.6	1000	9.522	17.799	1.0	M3-4
57	395389	396164	6806205	6410041	395439	50	0.6	1000	9.522	17.799	1.0	M3-4
60	196613	197294	3552445	3355151	196642	29	0.6	1000	9.522	17.799	1.0	M3-4
63	91921	91976	4068378	3976402	91921	0	0.6	1000	9.522	17.799	1.0	M3-4
66	60111	60139	1873080	1812941	60117	6	0.6	1000	9.522	17.799	1.0	M3-4
69	238948	239588	3186550	2946962	238948	0	0.6	1000	9.522	17.799	1.0	M3-4
72	12882	12975	425503	412528	12882	0	0.6	1000	9.522	17.799	1.0	M3-4
75	436794	436794	1834570	1397776	436794	0	0.6	1000	9.522	17.799	1.0	M3-4
78	52233	52233	319600	267367	52233	0	0.6	1000	9.522	17.799	1.0	M3-4
81	401110	402004	660675	258671	401110	0	0.6	1000	9.522	17.799	1.0	M3-4
84	985	985	11325	10340	985	0	0.6	1000	9.522	17.799	1.0	M3-4
87	9977	9977	47586	37609	9977	0	0.6	1000	9.522	17.799	1.0	M3-4
90	309	309	1326	1017	309	0	0.6	1000	9.522	17.799	1.0	M3-4
24	632	632	3321	2689	632	0	0.6	1000	9.533	13.878	0.3	M3-4
27	10319	10319	35245	24926	10397	78	0.6	1000	9.533	13.878	0.3	M3-4
30	5108	5108	22578	17470	5108	0	0.6	1000	9.533	13.878	0.3	M3-4
33	16090	16097	141778	125681	16090	0	0.6	1000	9.533	13.878	0.3	M3-4
36	160877	160877	1197378	1036501	160877	0	0.6	1000	9.533	13.878	0.3	M3-4
39	98329	98426	1422141	1323715	98329	0	0.6	1000	9.533	13.878	0.3	M3-4
42	224154	224171	3854476	3630305	224157	3	0.6	1000	9.533	13.878	0.3	M3-4
45	132843	133768	4108411	3974643	132850	7	0.6	1000	9.533	13.878	0.3	M3-4
48	39638	40393	3977610	3937217	39646	8	0.6	1000	9.533	13.878	0.3	M3-4
51	485703	489072	12482506	11993434	485728	25	0.6	1000	9.533	13.878	0.3	M3-4
53	0	0	0	0	0	0	0.6	1000	9.533	13.878	0.3	M3-4
54	227517	228390	7521381	7292991	227517	0	0.6	1000	9.533	13.878	0.3	M3-4
57	393606	396164	6806205	6410041	393659	53	0.6	1000	9.533	13.878	0.3	M3-4
60	196545	197294	3552445	3355151	196574	29	0.6	1000	9.533	13.878	0.3	M3-4
63	91908	91976	4068378	3976402	91908	0	0.6	1000	9.533	13.878	0.3	M3-4
66	60111	60139	1873080	1812941	60117	6	0.6	1000	9.533	13.878	0.3	M3-4
69	238948	239588	3186550	2946962	238948	0	0.6	1000	9.533	13.878	0.3	M3-4
72	12882	12975	425503	412528	12882	0	0.6	1000	9.533	13.878	0.3	M3-4
75	436794	436794	1834570	1397776	436794	0	0.6	1000	9.533	13.878	0.3	M3-4
78	52233	52233	319600	267367	52233	0	0.6	1000	9.533	13.878	0.3	M3-4
81	401110	402004	660675	258671	401110	0	0.6	1000	9.533	13.878	0.3	M3-4
84	985	985	11325	10340	985	0	0.6	1000	9.533	13.878	0.3	M3-4
87	9977	9977	47586	37609	9977	0	0.6	1000	9.533	13.878	0.3	M3-4
90	309	309	1326	1017	309	0	0.6	1000	9.533	13.878	0.3	M3-4
6	0	0	0	0	0	0	0.6	1000	9.623	16.797	1.0	M3-8
24	7	7	378	371	7	0	0.6	1000	9.623	16.797	1.0	M3-8
27	266	266	2346	2080	266	0	0.6	1000	9.623	16.797	1.0	M3-8
30	1988	1988	12880	10892	1988	0	0.6	1000	9.623	16.797	1.0	M3-8
33	15311	15370	177310	161940	15311	0	0.6	1000	9.623	16.797	1.0	M3-8
36	10785	10823	267546	256723	10785	0	0.6	1000	9.623	16.797	1.0	M3-8
39	254223	256230	2168403	1912173	254223	0	0.6	1000	9.623	16.797	1.0	M3-8
42	158734	158736	2463090	2304354	158736	2	0.6	1000	9.623	16.797	1.0	M3-8
45	183854	184826	5486328	5301502	183860	6	0.6	1000	9.623	16.797	1.0	M3-8
48	338290	338517	9088716	8750199	338290	0	0.6	1000	9.623	16.797	1.0	M3-8
51	401902	402211	7165005	6762794	401910	8	0.6	1000	9.623	16.797	1.0	M3-8
54	7424307	7436616	37027315	29590699	7424347	40	0.6	1000	9.623	16.797	1.0	M3-8
57	695772	699737	11014471	10314734	695781	9	0.6	1000	9.623	16.797	1.0	M3-8
60	396684	397042	6806205	6409163	396684	0	0.6	1000	9.623	16.797	1.0	M3-8
62	0	0	0	0	0	0	0.6	1000	9.623	16.797	1.0	M3-8
63	43828	43868	2563980	2520112	43828	0	0.6	1000	9.623	16.797	1.0	M3-8
66	60343	60505	1876953	1816448	60343	0	0.6	1000	9.623	16.797	1.0	M3-8
69	58293	58299	1284003	1225704	58337	44	0.6	1000	9.623	16.797	1.0	M3-8
71	45	45	45	0	45	0	0.6	1000	9.623	16.797	1.0	M3-8
72	368351	370034	1563796	1193762	368351	0	0.6	1000	9.623	16.797	1.0	M3-8
74	0	0	0	0	0	0	0.6	1000	9.623	16.797	1.0	M3-8
75	76958	76959	717003	640044	76958	0	0.6	1000	9.623	16.797	1.0	M3-8
78	26142	26142	280875	254733	26142	0	0.6	1000	9.623	16.797	1.0	M3-8
81	64892	64897	177310	112413	64892	0	0.6	1000	9.623	16.797	1.0	M3-8
84	385	385	4851	4466	385	0	0.6	1000	9.623	16.797	1.0	M3-8
87	400434	400434	464166	63732	400434	0	0.6	1000	9.623	16.797	1.0	M3-8
90	13	13	378	365	13	0	0.6	1000	9.623	16.797	1.0	M3-8
9	0	0	0	0	0	0	0.6	1000	9.686	15.236	0.3	M3-2
24	71	71	903	832	71	0	0.6	1000	9.686	15.236	0.3	M3-2
27	135	138	2016	1878	135	0	0.6	1000	9.686	15.236	0.3	M3-2
30	30	30	2775	2745	30	0	0.6	1000	9.686	15.236	0.3	M3-2
33	16245	16245	177310	161065	16245	0	0.6	1000	9.686	15.236	0.3	M3-2
36	5334	5335	147153	141818	5352	18	0.6	1000	9.686	15.236	0.3	M3-2
39	101417	101962	1546161	1444199	101418	1	0.6	1000	9.686	15.236	0.3	M3-2
42	882601	885326	12120426	11235100	882601	0	0.6	1000	9.686	15.236	0.3	M3-2
45	38674	38684	2463090	2424406	38676	2	0.6	1000	9.686	15.236	0.3	M3-2
47	0	0	0	0	0	0	0.6	1000	9.686	15.236	0.3	M3-2
48	394291	395976	12338028	11942052	394296	5	0.6	1000	9.686	15.236	0.3	M3-2
50	0	0	0	0	0	0	0.6	1000	9.686	15.236	0.3	M3-2
51	56837	57346	4134250	4076904	56837	0	0.6	1000	9.686	15.236	0.3	M3-2
54	464386	465607	8759205	8293598	464387	1	0.6	1000	9.686	15.236	0.3	M3-2
57	439116	439803	8042055	7602252	439147	31	0.6	1000	9.686	15.236	0.3	M3-2
60	458755	459534	7842780	7383246	458775	20	0.6	1000	9.686	15.236	0.3	M3-2
61	0	0	0	0	0	0	0.6	1000	9.686	15.236	0.3	M3-2
63	645979	646083	8876791	8230708	645979	0	0.6	1000	9.686	15.236	0.3	M3-2
66	294041	294164	5328480	5034316	294176	135	0.6	1000	9.686	15.236	0.3	M3-2
69	26824	27174	1054878	1027704	26824	0	0.6	1000	9.686	15.236	0.3	M3-2
72	44173	44186	565516	521330	44186	13	0.6	1000	9.686	15.236	0.3	M3-2
74	0	0	0	0	0	0	0.6	1000	9.686	15.236	0.3	M3-2
75	10165	10173	222111	211938	10165	0	0.6	1000	9.686	15.236	0.3	M3-2
78	45204	45206	226128	180922	45204	0	0.6	1000	9.686	15.236	0.3	M3-2
81	25848	26035	183315	157280	25848	0	0.6	1000	9.686	15.236	0.3	M3-2
84	2141	2141	28203	26062	2141	0	0.6	1000	9.686	15.236	0.3	M3-2
87	32	32	630	598	32	0	0.6	1000	9.686	15.236	0.3	M3-2
90	3402	3402	10440	7038	3402	0	0.6	1000	9.686	15.236	0.3	M3-2
