junction_length	tpos	cond_pos	cond_all	cond_neg	test_pos	fpos	norm_mini	size_threshold	para_pp	para_pw	sample	radius
3	0	0	0	0	0	0	0.5	1000	222.28	25.544	M4-1	0.5
6	0	0	0	0	0	0	0.5	1000	222.28	25.544	M4-1	0.5
24	73	75	3570	3495	73	0	0.5	1000	222.28	25.544	M4-1	0.5
27	6507	6507	43071	36564	6513	6	0.5	1000	222.28	25.544	M4-1	0.5
30	709	716	40755	40039	714	5	0.5	1000	222.28	25.544	M4-1	0.5
33	33957	33984	424581	390597	33957	0	0.5	1000	222.28	25.544	M4-1	0.5
36	4978	4979	458403	453424	4984	6	0.5	1000	222.28	25.544	M4-1	0.5
39	222694	234607	6813586	6578979	222713	19	0.5	1000	222.28	25.544	M4-1	0.5
41	0	0	0	0	0	0	0.5	1000	222.28	25.544	M4-1	0.5
42	74305	74965	8559453	8484488	75444	1139	0.5	1000	222.28	25.544	M4-1	0.5
45	274750	274902	18638565	18363663	274771	21	0.5	1000	222.28	25.544	M4-1	0.5
47	0	0	0	0	0	0	0.5	1000	222.28	25.544	M4-1	0.5
48	211052	212334	24981846	24769512	211460	408	0.5	1000	222.28	25.544	M4-1	0.5
49	0	0	0	0	0	0	0.5	1000	222.28	25.544	M4-1	0.5
50	10	10	15	5	10	0	0.5	1000	222.28	25.544	M4-1	0.5
51	267974	270020	34283340	34013320	267992	18	0.5	1000	222.28	25.544	M4-1	0.5
52	0	0	0	0	0	0	0.5	1000	222.28	25.544	M4-1	0.5
53	0	0	1	1	0	0	0.5	1000	222.28	25.544	M4-1	0.5
54	249514	257003	26335653	26078650	249534	20	0.5	1000	222.28	25.544	M4-1	0.5
56	55	55	55	0	55	0	0.5	1000	222.28	25.544	M4-1	0.5
57	92013	92998	17307786	17214788	92039	26	0.5	1000	222.28	25.544	M4-1	0.5
58	0	0	0	0	0	0	0.5	1000	222.28	25.544	M4-1	0.5
60	172910	174264	15354111	15179847	172911	1	0.5	1000	222.28	25.544	M4-1	0.5
63	89460	90130	11987856	11897726	89514	54	0.5	1000	222.28	25.544	M4-1	0.5
65	0	0	0	0	0	0	0.5	1000	222.28	25.544	M4-1	0.5
66	189002	189660	8704878	8515218	189002	0	0.5	1000	222.28	25.544	M4-1	0.5
67	0	0	0	0	0	0	0.5	1000	222.28	25.544	M4-1	0.5
69	148691	148774	7634278	7485504	148697	6	0.5	1000	222.28	25.544	M4-1	0.5
72	1448191	1449473	11493615	10044142	1448196	5	0.5	1000	222.28	25.544	M4-1	0.5
73	1	1	1	0	1	0	0.5	1000	222.28	25.544	M4-1	0.5
75	18218	18309	962578	944269	18218	0	0.5	1000	222.28	25.544	M4-1	0.5
78	12180	12247	451725	439478	12180	0	0.5	1000	222.28	25.544	M4-1	0.5
81	1988	2002	126756	124754	1988	0	0.5	1000	222.28	25.544	M4-1	0.5
84	5572	5573	52650	47077	5572	0	0.5	1000	222.28	25.544	M4-1	0.5
87	620	621	12403	11782	620	0	0.5	1000	222.28	25.544	M4-1	0.5
90	218	233	4753	4520	218	0	0.5	1000	222.28	25.544	M4-1	0.5
3	0	0	0	0	0	0	0.5	1000	350.576	25.46	M2-1	0.5
12	1	1	1	0	1	0	0.5	1000	350.576	25.46	M2-1	0.5
15	0	0	0	0	0	0	0.5	1000	350.576	25.46	M2-1	0.5
24	80	80	17391	17311	132	52	0.5	1000	350.576	25.46	M2-1	0.5
27	58	58	20706	20648	65	7	0.5	1000	350.576	25.46	M2-1	0.5
30	316	317	102831	102514	326	10	0.5	1000	350.576	25.46	M2-1	0.5
33	760	781	571915	571134	808	48	0.5	1000	350.576	25.46	M2-1	0.5
36	1498	1518	1530375	1528857	1574	76	0.5	1000	350.576	25.46	M2-1	0.5
39	13363	13402	4501500	4488098	13413	50	0.5	1000	350.576	25.46	M2-1	0.5
41	0	0	0	0	0	0	0.5	1000	350.576	25.46	M2-1	0.5
42	28567	28588	10010575	9981987	28870	303	0.5	1000	350.576	25.46	M2-1	0.5
43	0	0	1	1	0	0	0.5	1000	350.576	25.46	M2-1	0.5
45	15442	15621	16522626	16507005	15716	274	0.5	1000	350.576	25.46	M2-1	0.5
46	0	0	1	1	0	0	0.5	1000	350.576	25.46	M2-1	0.5
48	32169	32345	24398605	24366260	32337	168	0.5	1000	350.576	25.46	M2-1	0.5
51	13999	14167	23988201	23974034	14263	264	0.5	1000	350.576	25.46	M2-1	0.5
52	0	0	0	0	0	0	0.5	1000	350.576	25.46	M2-1	0.5
54	34036	34863	24217320	24182457	34150	114	0.5	1000	350.576	25.46	M2-1	0.5
55	0	0	0	0	0	0	0.5	1000	350.576	25.46	M2-1	0.5
57	28373	28771	23932821	23904050	29223	850	0.5	1000	350.576	25.46	M2-1	0.5
58	0	0	0	0	0	0	0.5	1000	350.576	25.46	M2-1	0.5
59	0	0	1	1	0	0	0.5	1000	350.576	25.46	M2-1	0.5
60	13993	14059	16869336	16855277	14085	92	0.5	1000	350.576	25.46	M2-1	0.5
61	0	0	0	0	0	0	0.5	1000	350.576	25.46	M2-1	0.5
62	0	0	0	0	0	0	0.5	1000	350.576	25.46	M2-1	0.5
63	19819	19873	11608971	11589098	19881	62	0.5	1000	350.576	25.46	M2-1	0.5
64	0	0	0	0	0	0	0.5	1000	350.576	25.46	M2-1	0.5
66	42509	42563	7755891	7713328	42526	17	0.5	1000	350.576	25.46	M2-1	0.5
68	0	0	0	0	0	0	0.5	1000	350.576	25.46	M2-1	0.5
69	2709	2772	4928230	4925458	2748	39	0.5	1000	350.576	25.46	M2-1	0.5
72	2708	2716	2248260	2245544	2727	19	0.5	1000	350.576	25.46	M2-1	0.5
73	0	0	1	1	0	0	0.5	1000	350.576	25.46	M2-1	0.5
75	166295	166303	2494261	2327958	166300	5	0.5	1000	350.576	25.46	M2-1	0.5
78	606	617	541320	540703	626	20	0.5	1000	350.576	25.46	M2-1	0.5
81	18083	18097	402753	384656	18083	0	0.5	1000	350.576	25.46	M2-1	0.5
84	295	296	95703	95407	295	0	0.5	1000	350.576	25.46	M2-1	0.5
87	93	102	20100	19998	93	0	0.5	1000	350.576	25.46	M2-1	0.5
90	2	2	9045	9043	2	0	0.5	1000	350.576	25.46	M2-1	0.5
6	0	0	0	0	0	0	0.5	1000	353.956	33.798	M5-1	0.5
8	3	6	6	0	3	0	0.5	1000	353.956	33.798	M5-1	0.5
9	28	28	28	0	28	0	0.5	1000	353.956	33.798	M5-1	0.5
24	9161	9286	76636	67350	9282	121	0.5	1000	353.956	33.798	M5-1	0.5
27	9928	11312	53956	42644	9928	0	0.5	1000	353.956	33.798	M5-1	0.5
30	84740	84807	512578	427771	84741	1	0.5	1000	353.956	33.798	M5-1	0.5
33	15278	16399	1097421	1081022	15288	10	0.5	1000	353.956	33.798	M5-1	0.5
35	0	0	0	0	0	0	0.5	1000	353.956	33.798	M5-1	0.5
36	38415	38513	3324331	3285818	38445	30	0.5	1000	353.956	33.798	M5-1	0.5
37	0	0	0	0	0	0	0.5	1000	353.956	33.798	M5-1	0.5
39	76503	78081	8914753	8836672	76506	3	0.5	1000	353.956	33.798	M5-1	0.5
40	0	0	0	0	0	0	0.5	1000	353.956	33.798	M5-1	0.5
42	167660	168038	24440536	24272498	168058	398	0.5	1000	353.956	33.798	M5-1	0.5
45	189861	190901	46527481	46336580	190109	248	0.5	1000	353.956	33.798	M5-1	0.5
47	0	0	0	0	0	0	0.5	1000	353.956	33.798	M5-1	0.5
48	425431	430088	84142878	83712790	425928	497	0.5	1000	353.956	33.798	M5-1	0.5
49	0	0	0	0	0	0	0.5	1000	353.956	33.798	M5-1	0.5
51	279115	283513	65259600	64976087	280933	1818	0.5	1000	353.956	33.798	M5-1	0.5
54	393148	394658	62826445	62431787	393265	117	0.5	1000	353.956	33.798	M5-1	0.5
55	1	1	1	0	1	0	0.5	1000	353.956	33.798	M5-1	0.5
57	400763	402140	60077241	59675101	401026	263	0.5	1000	353.956	33.798	M5-1	0.5
58	0	0	0	0	0	0	0.5	1000	353.956	33.798	M5-1	0.5
59	0	0	0	0	0	0	0.5	1000	353.956	33.798	M5-1	0.5
60	138985	141584	42878430	42736846	139305	320	0.5	1000	353.956	33.798	M5-1	0.5
61	0	1	1	0	0	0	0.5	1000	353.956	33.798	M5-1	0.5
62	3	3	6	3	3	0	0.5	1000	353.956	33.798	M5-1	0.5
63	282518	283443	33020001	32736558	282581	63	0.5	1000	353.956	33.798	M5-1	0.5
64	0	0	0	0	0	0	0.5	1000	353.956	33.798	M5-1	0.5
66	145565	146922	23225520	23078598	145565	0	0.5	1000	353.956	33.798	M5-1	0.5
69	210314	210783	17877210	17666427	210350	36	0.5	1000	353.956	33.798	M5-1	0.5
72	197710	198785	11005086	10806301	197886	176	0.5	1000	353.956	33.798	M5-1	0.5
75	27022	27401	2809635	2782234	27026	4	0.5	1000	353.956	33.798	M5-1	0.5
76	0	0	0	0	0	0	0.5	1000	353.956	33.798	M5-1	0.5
78	57390	58159	2273778	2215619	57390	0	0.5	1000	353.956	33.798	M5-1	0.5
81	14868	14958	644680	629722	14868	0	0.5	1000	353.956	33.798	M5-1	0.5
84	29235	29526	328455	298929	29235	0	0.5	1000	353.956	33.798	M5-1	0.5
87	4182	4182	52650	48468	4185	3	0.5	1000	353.956	33.798	M5-1	0.5
90	2090	2090	18721	16631	2090	0	0.5	1000	353.956	33.798	M5-1	0.5
12	0	0	0	0	0	0	0.5	1000	61.865	15.792	M3-1	0.5
24	19	19	528	509	20	1	0.5	1000	61.865	15.792	M3-1	0.5
27	1012	1012	3403	2391	1012	0	0.5	1000	61.865	15.792	M3-1	0.5
30	2244	2244	20706	18462	2266	22	0.5	1000	61.865	15.792	M3-1	0.5
33	14453	14843	188191	173348	14453	0	0.5	1000	61.865	15.792	M3-1	0.5
36	7238877	7242680	9894576	2651896	7238881	4	0.5	1000	61.865	15.792	M3-1	0.5
39	263400	263445	2729616	2466171	263400	0	0.5	1000	61.865	15.792	M3-1	0.5
42	35711	35878	2158003	2122125	35836	125	0.5	1000	61.865	15.792	M3-1	0.5
45	54792	56285	3736011	3679726	54795	3	0.5	1000	61.865	15.792	M3-1	0.5
48	728014	728177	10776403	10048226	728024	10	0.5	1000	61.865	15.792	M3-1	0.5
51	443288	443478	10131751	9688273	443295	7	0.5	1000	61.865	15.792	M3-1	0.5
54	102009	102378	5519503	5417125	102013	4	0.5	1000	61.865	15.792	M3-1	0.5
57	99630	99788	4837605	4737817	99921	291	0.5	1000	61.865	15.792	M3-1	0.5
59	0	0	0	0	0	0	0.5	1000	61.865	15.792	M3-1	0.5
60	221501	221616	3573801	3352185	221501	0	0.5	1000	61.865	15.792	M3-1	0.5
62	0	0	0	0	0	0	0.5	1000	61.865	15.792	M3-1	0.5
63	576222	576491	9748320	9171829	576222	0	0.5	1000	61.865	15.792	M3-1	0.5
64	0	0	0	0	0	0	0.5	1000	61.865	15.792	M3-1	0.5
66	293041	293128	2492028	2198900	293041	0	0.5	1000	61.865	15.792	M3-1	0.5
68	10	10	15	5	10	0	0.5	1000	61.865	15.792	M3-1	0.5
69	359721	359725	4045590	3685865	359732	11	0.5	1000	61.865	15.792	M3-1	0.5
72	72649	75317	1553203	1477886	72649	0	0.5	1000	61.865	15.792	M3-1	0.5
75	18352	18352	328455	310103	18354	2	0.5	1000	61.865	15.792	M3-1	0.5
76	0	0	0	0	0	0	0.5	1000	61.865	15.792	M3-1	0.5
78	132571	132572	773146	640574	132571	0	0.5	1000	61.865	15.792	M3-1	0.5
81	5138	5138	36585	31447	5138	0	0.5	1000	61.865	15.792	M3-1	0.5
84	623	623	9730	9107	623	0	0.5	1000	61.865	15.792	M3-1	0.5
87	478	478	6670	6192	478	0	0.5	1000	61.865	15.792	M3-1	0.5
90	294	305	2278	1973	294	0	0.5	1000	61.865	15.792	M3-1	0.5
3	0	0	0	0	0	0	0.5	2000	187.022	36.346	M4-1	0.5
6	0	0	0	0	0	0	0.5	2000	187.022	36.346	M4-1	0.5
24	73	75	3570	3495	73	0	0.5	2000	187.022	36.346	M4-1	0.5
27	6507	6507	43071	36564	6513	6	0.5	2000	187.022	36.346	M4-1	0.5
30	709	716	40755	40039	714	5	0.5	2000	187.022	36.346	M4-1	0.5
33	33957	33984	424581	390597	33957	0	0.5	2000	187.022	36.346	M4-1	0.5
36	4978	4979	458403	453424	4984	6	0.5	2000	187.022	36.346	M4-1	0.5
39	222875	234607	6813586	6578979	222894	19	0.5	2000	187.022	36.346	M4-1	0.5
41	0	0	0	0	0	0	0.5	2000	187.022	36.346	M4-1	0.5
42	74305	74965	8559453	8484488	75444	1139	0.5	2000	187.022	36.346	M4-1	0.5
45	274750	274902	18638565	18363663	274771	21	0.5	2000	187.022	36.346	M4-1	0.5
47	0	0	0	0	0	0	0.5	2000	187.022	36.346	M4-1	0.5
48	211052	212334	24981846	24769512	211460	408	0.5	2000	187.022	36.346	M4-1	0.5
49	0	0	0	0	0	0	0.5	2000	187.022	36.346	M4-1	0.5
50	10	10	15	5	10	0	0.5	2000	187.022	36.346	M4-1	0.5
51	267974	270020	34283340	34013320	267992	18	0.5	2000	187.022	36.346	M4-1	0.5
52	0	0	0	0	0	0	0.5	2000	187.022	36.346	M4-1	0.5
53	0	0	1	1	0	0	0.5	2000	187.022	36.346	M4-1	0.5
54	249514	257003	26335653	26078650	249534	20	0.5	2000	187.022	36.346	M4-1	0.5
56	55	55	55	0	55	0	0.5	2000	187.022	36.346	M4-1	0.5
57	92013	92998	17307786	17214788	92039	26	0.5	2000	187.022	36.346	M4-1	0.5
58	0	0	0	0	0	0	0.5	2000	187.022	36.346	M4-1	0.5
60	172910	174264	15354111	15179847	172911	1	0.5	2000	187.022	36.346	M4-1	0.5
63	89460	90130	11987856	11897726	89514	54	0.5	2000	187.022	36.346	M4-1	0.5
65	0	0	0	0	0	0	0.5	2000	187.022	36.346	M4-1	0.5
66	189002	189660	8704878	8515218	189002	0	0.5	2000	187.022	36.346	M4-1	0.5
67	0	0	0	0	0	0	0.5	2000	187.022	36.346	M4-1	0.5
69	148691	148774	7634278	7485504	148697	6	0.5	2000	187.022	36.346	M4-1	0.5
72	1448191	1449473	11493615	10044142	1448196	5	0.5	2000	187.022	36.346	M4-1	0.5
73	1	1	1	0	1	0	0.5	2000	187.022	36.346	M4-1	0.5
75	18218	18309	962578	944269	18218	0	0.5	2000	187.022	36.346	M4-1	0.5
78	12180	12247	451725	439478	12180	0	0.5	2000	187.022	36.346	M4-1	0.5
81	1988	2002	126756	124754	1988	0	0.5	2000	187.022	36.346	M4-1	0.5
84	5572	5573	52650	47077	5572	0	0.5	2000	187.022	36.346	M4-1	0.5
87	620	621	12403	11782	620	0	0.5	2000	187.022	36.346	M4-1	0.5
90	218	233	4753	4520	218	0	0.5	2000	187.022	36.346	M4-1	0.5
3	0	0	0	0	0	0	0.5	2000	284.008	34.059	M2-1	0.5
12	1	1	1	0	1	0	0.5	2000	284.008	34.059	M2-1	0.5
15	0	0	0	0	0	0	0.5	2000	284.008	34.059	M2-1	0.5
24	80	80	17391	17311	132	52	0.5	2000	284.008	34.059	M2-1	0.5
27	58	58	20706	20648	65	7	0.5	2000	284.008	34.059	M2-1	0.5
30	316	317	102831	102514	326	10	0.5	2000	284.008	34.059	M2-1	0.5
33	760	781	571915	571134	808	48	0.5	2000	284.008	34.059	M2-1	0.5
36	1513	1518	1530375	1528857	1626	113	0.5	2000	284.008	34.059	M2-1	0.5
39	13363	13402	4501500	4488098	13413	50	0.5	2000	284.008	34.059	M2-1	0.5
41	0	0	0	0	0	0	0.5	2000	284.008	34.059	M2-1	0.5
42	28567	28588	10010575	9981987	28870	303	0.5	2000	284.008	34.059	M2-1	0.5
43	0	0	1	1	0	0	0.5	2000	284.008	34.059	M2-1	0.5
45	15442	15621	16522626	16507005	15716	274	0.5	2000	284.008	34.059	M2-1	0.5
46	0	0	1	1	0	0	0.5	2000	284.008	34.059	M2-1	0.5
48	32169	32345	24398605	24366260	32337	168	0.5	2000	284.008	34.059	M2-1	0.5
51	13999	14167	23988201	23974034	14263	264	0.5	2000	284.008	34.059	M2-1	0.5
52	0	0	0	0	0	0	0.5	2000	284.008	34.059	M2-1	0.5
54	34036	34863	24217320	24182457	34150	114	0.5	2000	284.008	34.059	M2-1	0.5
55	0	0	0	0	0	0	0.5	2000	284.008	34.059	M2-1	0.5
57	28373	28771	23932821	23904050	29223	850	0.5	2000	284.008	34.059	M2-1	0.5
58	0	0	0	0	0	0	0.5	2000	284.008	34.059	M2-1	0.5
59	0	0	1	1	0	0	0.5	2000	284.008	34.059	M2-1	0.5
60	13993	14059	16869336	16855277	14085	92	0.5	2000	284.008	34.059	M2-1	0.5
61	0	0	0	0	0	0	0.5	2000	284.008	34.059	M2-1	0.5
62	0	0	0	0	0	0	0.5	2000	284.008	34.059	M2-1	0.5
63	19819	19873	11608971	11589098	19881	62	0.5	2000	284.008	34.059	M2-1	0.5
64	0	0	0	0	0	0	0.5	2000	284.008	34.059	M2-1	0.5
66	42509	42563	7755891	7713328	42526	17	0.5	2000	284.008	34.059	M2-1	0.5
68	0	0	0	0	0	0	0.5	2000	284.008	34.059	M2-1	0.5
69	2709	2772	4928230	4925458	2748	39	0.5	2000	284.008	34.059	M2-1	0.5
72	2708	2716	2248260	2245544	2739	31	0.5	2000	284.008	34.059	M2-1	0.5
73	0	0	1	1	0	0	0.5	2000	284.008	34.059	M2-1	0.5
75	166295	166303	2494261	2327958	166302	7	0.5	2000	284.008	34.059	M2-1	0.5
78	606	617	541320	540703	626	20	0.5	2000	284.008	34.059	M2-1	0.5
81	18083	18097	402753	384656	18083	0	0.5	2000	284.008	34.059	M2-1	0.5
84	295	296	95703	95407	295	0	0.5	2000	284.008	34.059	M2-1	0.5
87	93	102	20100	19998	93	0	0.5	2000	284.008	34.059	M2-1	0.5
90	2	2	9045	9043	2	0	0.5	2000	284.008	34.059	M2-1	0.5
12	0	0	0	0	0	0	0.5	2000	3.32	28.714	M3-1	0.5
24	19	19	528	509	20	1	0.5	2000	3.32	28.714	M3-1	0.5
27	1012	1012	3403	2391	1012	0	0.5	2000	3.32	28.714	M3-1	0.5
30	2244	2244	20706	18462	2266	22	0.5	2000	3.32	28.714	M3-1	0.5
33	14453	14843	188191	173348	14453	0	0.5	2000	3.32	28.714	M3-1	0.5
36	7238877	7242680	9894576	2651896	7238881	4	0.5	2000	3.32	28.714	M3-1	0.5
39	263400	263445	2729616	2466171	263400	0	0.5	2000	3.32	28.714	M3-1	0.5
42	35711	35878	2158003	2122125	35836	125	0.5	2000	3.32	28.714	M3-1	0.5
45	55347	56285	3736011	3679726	55350	3	0.5	2000	3.32	28.714	M3-1	0.5
48	728017	728177	10776403	10048226	728027	10	0.5	2000	3.32	28.714	M3-1	0.5
51	443289	443478	10131751	9688273	443296	7	0.5	2000	3.32	28.714	M3-1	0.5
54	102022	102378	5519503	5417125	102027	5	0.5	2000	3.32	28.714	M3-1	0.5
57	99636	99788	4837605	4737817	99927	291	0.5	2000	3.32	28.714	M3-1	0.5
59	0	0	0	0	0	0	0.5	2000	3.32	28.714	M3-1	0.5
60	221502	221616	3573801	3352185	221541	39	0.5	2000	3.32	28.714	M3-1	0.5
62	0	0	0	0	0	0	0.5	2000	3.32	28.714	M3-1	0.5
63	576245	576491	9748320	9171829	576245	0	0.5	2000	3.32	28.714	M3-1	0.5
64	0	0	0	0	0	0	0.5	2000	3.32	28.714	M3-1	0.5
66	293041	293128	2492028	2198900	293041	0	0.5	2000	3.32	28.714	M3-1	0.5
68	10	10	15	5	10	0	0.5	2000	3.32	28.714	M3-1	0.5
69	359721	359725	4045590	3685865	359732	11	0.5	2000	3.32	28.714	M3-1	0.5
72	72649	75317	1553203	1477886	72649	0	0.5	2000	3.32	28.714	M3-1	0.5
75	18352	18352	328455	310103	18354	2	0.5	2000	3.32	28.714	M3-1	0.5
76	0	0	0	0	0	0	0.5	2000	3.32	28.714	M3-1	0.5
78	132571	132572	773146	640574	132571	0	0.5	2000	3.32	28.714	M3-1	0.5
81	5138	5138	36585	31447	5138	0	0.5	2000	3.32	28.714	M3-1	0.5
84	623	623	9730	9107	623	0	0.5	2000	3.32	28.714	M3-1	0.5
87	478	478	6670	6192	478	0	0.5	2000	3.32	28.714	M3-1	0.5
90	294	305	2278	1973	294	0	0.5	2000	3.32	28.714	M3-1	0.5
6	0	0	0	0	0	0	0.5	2000	313.666	37.532	M5-1	0.5
8	3	6	6	0	3	0	0.5	2000	313.666	37.532	M5-1	0.5
9	28	28	28	0	28	0	0.5	2000	313.666	37.532	M5-1	0.5
24	9161	9286	76636	67350	9282	121	0.5	2000	313.666	37.532	M5-1	0.5
27	9928	11312	53956	42644	9928	0	0.5	2000	313.666	37.532	M5-1	0.5
30	84740	84807	512578	427771	84741	1	0.5	2000	313.666	37.532	M5-1	0.5
33	15278	16399	1097421	1081022	15288	10	0.5	2000	313.666	37.532	M5-1	0.5
35	0	0	0	0	0	0	0.5	2000	313.666	37.532	M5-1	0.5
36	38436	38513	3324331	3285818	38468	32	0.5	2000	313.666	37.532	M5-1	0.5
37	0	0	0	0	0	0	0.5	2000	313.666	37.532	M5-1	0.5
39	76503	78081	8914753	8836672	76506	3	0.5	2000	313.666	37.532	M5-1	0.5
40	0	0	0	0	0	0	0.5	2000	313.666	37.532	M5-1	0.5
42	167660	168038	24440536	24272498	168058	398	0.5	2000	313.666	37.532	M5-1	0.5
45	189861	190901	46527481	46336580	190109	248	0.5	2000	313.666	37.532	M5-1	0.5
47	0	0	0	0	0	0	0.5	2000	313.666	37.532	M5-1	0.5
48	425431	430088	84142878	83712790	425928	497	0.5	2000	313.666	37.532	M5-1	0.5
49	0	0	0	0	0	0	0.5	2000	313.666	37.532	M5-1	0.5
51	279115	283513	65259600	64976087	280933	1818	0.5	2000	313.666	37.532	M5-1	0.5
54	393148	394658	62826445	62431787	393265	117	0.5	2000	313.666	37.532	M5-1	0.5
55	1	1	1	0	1	0	0.5	2000	313.666	37.532	M5-1	0.5
57	400763	402140	60077241	59675101	401026	263	0.5	2000	313.666	37.532	M5-1	0.5
58	0	0	0	0	0	0	0.5	2000	313.666	37.532	M5-1	0.5
59	0	0	0	0	0	0	0.5	2000	313.666	37.532	M5-1	0.5
60	138985	141584	42878430	42736846	139305	320	0.5	2000	313.666	37.532	M5-1	0.5
61	0	1	1	0	0	0	0.5	2000	313.666	37.532	M5-1	0.5
62	3	3	6	3	3	0	0.5	2000	313.666	37.532	M5-1	0.5
63	282518	283443	33020001	32736558	282581	63	0.5	2000	313.666	37.532	M5-1	0.5
64	0	0	0	0	0	0	0.5	2000	313.666	37.532	M5-1	0.5
66	145565	146922	23225520	23078598	145565	0	0.5	2000	313.666	37.532	M5-1	0.5
69	210314	210783	17877210	17666427	210350	36	0.5	2000	313.666	37.532	M5-1	0.5
72	197710	198785	11005086	10806301	197886	176	0.5	2000	313.666	37.532	M5-1	0.5
75	27238	27401	2809635	2782234	27242	4	0.5	2000	313.666	37.532	M5-1	0.5
76	0	0	0	0	0	0	0.5	2000	313.666	37.532	M5-1	0.5
78	57391	58159	2273778	2215619	57391	0	0.5	2000	313.666	37.532	M5-1	0.5
81	14868	14958	644680	629722	14868	0	0.5	2000	313.666	37.532	M5-1	0.5
84	29235	29526	328455	298929	29235	0	0.5	2000	313.666	37.532	M5-1	0.5
87	4182	4182	52650	48468	4185	3	0.5	2000	313.666	37.532	M5-1	0.5
90	2090	2090	18721	16631	2090	0	0.5	2000	313.666	37.532	M5-1	0.5
3	0	0	0	0	0	0	0.5	3000	118.802	74.91	M4-1	0.5
6	0	0	0	0	0	0	0.5	3000	118.802	74.91	M4-1	0.5
24	73	75	3570	3495	73	0	0.5	3000	118.802	74.91	M4-1	0.5
27	6507	6507	43071	36564	6513	6	0.5	3000	118.802	74.91	M4-1	0.5
30	709	716	40755	40039	714	5	0.5	3000	118.802	74.91	M4-1	0.5
33	33957	33984	424581	390597	33957	0	0.5	3000	118.802	74.91	M4-1	0.5
36	4978	4979	458403	453424	4984	6	0.5	3000	118.802	74.91	M4-1	0.5
39	222875	234607	6813586	6578979	222894	19	0.5	3000	118.802	74.91	M4-1	0.5
41	0	0	0	0	0	0	0.5	3000	118.802	74.91	M4-1	0.5
42	74372	74965	8559453	8484488	75520	1148	0.5	3000	118.802	74.91	M4-1	0.5
45	274768	274902	18638565	18363663	274789	21	0.5	3000	118.802	74.91	M4-1	0.5
47	0	0	0	0	0	0	0.5	3000	118.802	74.91	M4-1	0.5
48	211052	212334	24981846	24769512	211460	408	0.5	3000	118.802	74.91	M4-1	0.5
49	0	0	0	0	0	0	0.5	3000	118.802	74.91	M4-1	0.5
50	10	10	15	5	10	0	0.5	3000	118.802	74.91	M4-1	0.5
51	267974	270020	34283340	34013320	267992	18	0.5	3000	118.802	74.91	M4-1	0.5
52	0	0	0	0	0	0	0.5	3000	118.802	74.91	M4-1	0.5
53	0	0	1	1	0	0	0.5	3000	118.802	74.91	M4-1	0.5
54	249514	257003	26335653	26078650	249534	20	0.5	3000	118.802	74.91	M4-1	0.5
56	55	55	55	0	55	0	0.5	3000	118.802	74.91	M4-1	0.5
57	92013	92998	17307786	17214788	92039	26	0.5	3000	118.802	74.91	M4-1	0.5
58	0	0	0	0	0	0	0.5	3000	118.802	74.91	M4-1	0.5
60	172947	174264	15354111	15179847	172948	1	0.5	3000	118.802	74.91	M4-1	0.5
63	89734	90130	11987856	11897726	89788	54	0.5	3000	118.802	74.91	M4-1	0.5
65	0	0	0	0	0	0	0.5	3000	118.802	74.91	M4-1	0.5
66	189006	189660	8704878	8515218	189008	2	0.5	3000	118.802	74.91	M4-1	0.5
67	0	0	0	0	0	0	0.5	3000	118.802	74.91	M4-1	0.5
69	148691	148774	7634278	7485504	148697	6	0.5	3000	118.802	74.91	M4-1	0.5
72	1448204	1449473	11493615	10044142	1448209	5	0.5	3000	118.802	74.91	M4-1	0.5
73	1	1	1	0	1	0	0.5	3000	118.802	74.91	M4-1	0.5
75	18218	18309	962578	944269	18218	0	0.5	3000	118.802	74.91	M4-1	0.5
78	12180	12247	451725	439478	12180	0	0.5	3000	118.802	74.91	M4-1	0.5
81	1988	2002	126756	124754	1988	0	0.5	3000	118.802	74.91	M4-1	0.5
84	5572	5573	52650	47077	5572	0	0.5	3000	118.802	74.91	M4-1	0.5
87	620	621	12403	11782	620	0	0.5	3000	118.802	74.91	M4-1	0.5
90	218	233	4753	4520	218	0	0.5	3000	118.802	74.91	M4-1	0.5
3	0	0	0	0	0	0	0.5	3000	253.427	55.569	M2-1	0.5
12	1	1	1	0	1	0	0.5	3000	253.427	55.569	M2-1	0.5
15	0	0	0	0	0	0	0.5	3000	253.427	55.569	M2-1	0.5
24	80	80	17391	17311	132	52	0.5	3000	253.427	55.569	M2-1	0.5
27	58	58	20706	20648	65	7	0.5	3000	253.427	55.569	M2-1	0.5
30	316	317	102831	102514	326	10	0.5	3000	253.427	55.569	M2-1	0.5
33	760	781	571915	571134	808	48	0.5	3000	253.427	55.569	M2-1	0.5
36	1513	1518	1530375	1528857	1626	113	0.5	3000	253.427	55.569	M2-1	0.5
39	13374	13402	4501500	4488098	13454	80	0.5	3000	253.427	55.569	M2-1	0.5
41	0	0	0	0	0	0	0.5	3000	253.427	55.569	M2-1	0.5
42	28567	28588	10010575	9981987	28870	303	0.5	3000	253.427	55.569	M2-1	0.5
43	0	0	1	1	0	0	0.5	3000	253.427	55.569	M2-1	0.5
45	15442	15621	16522626	16507005	15716	274	0.5	3000	253.427	55.569	M2-1	0.5
46	0	0	1	1	0	0	0.5	3000	253.427	55.569	M2-1	0.5
48	32169	32345	24398605	24366260	32337	168	0.5	3000	253.427	55.569	M2-1	0.5
51	13999	14167	23988201	23974034	14263	264	0.5	3000	253.427	55.569	M2-1	0.5
52	0	0	0	0	0	0	0.5	3000	253.427	55.569	M2-1	0.5
54	34036	34863	24217320	24182457	34150	114	0.5	3000	253.427	55.569	M2-1	0.5
55	0	0	0	0	0	0	0.5	3000	253.427	55.569	M2-1	0.5
57	28373	28771	23932821	23904050	29223	850	0.5	3000	253.427	55.569	M2-1	0.5
58	0	0	0	0	0	0	0.5	3000	253.427	55.569	M2-1	0.5
59	0	0	1	1	0	0	0.5	3000	253.427	55.569	M2-1	0.5
60	13993	14059	16869336	16855277	14085	92	0.5	3000	253.427	55.569	M2-1	0.5
61	0	0	0	0	0	0	0.5	3000	253.427	55.569	M2-1	0.5
62	0	0	0	0	0	0	0.5	3000	253.427	55.569	M2-1	0.5
63	19819	19873	11608971	11589098	19881	62	0.5	3000	253.427	55.569	M2-1	0.5
64	0	0	0	0	0	0	0.5	3000	253.427	55.569	M2-1	0.5
66	42509	42563	7755891	7713328	42526	17	0.5	3000	253.427	55.569	M2-1	0.5
68	0	0	0	0	0	0	0.5	3000	253.427	55.569	M2-1	0.5
69	2709	2772	4928230	4925458	2756	47	0.5	3000	253.427	55.569	M2-1	0.5
72	2708	2716	2248260	2245544	2739	31	0.5	3000	253.427	55.569	M2-1	0.5
73	0	0	1	1	0	0	0.5	3000	253.427	55.569	M2-1	0.5
75	166295	166303	2494261	2327958	166302	7	0.5	3000	253.427	55.569	M2-1	0.5
78	606	617	541320	540703	626	20	0.5	3000	253.427	55.569	M2-1	0.5
81	18083	18097	402753	384656	18083	0	0.5	3000	253.427	55.569	M2-1	0.5
84	295	296	95703	95407	295	0	0.5	3000	253.427	55.569	M2-1	0.5
87	93	102	20100	19998	93	0	0.5	3000	253.427	55.569	M2-1	0.5
90	2	2	9045	9043	2	0	0.5	3000	253.427	55.569	M2-1	0.5
12	0	0	0	0	0	0	0.5	3000	3.123	28.178	M3-1	0.5
24	19	19	528	509	20	1	0.5	3000	3.123	28.178	M3-1	0.5
27	1012	1012	3403	2391	1012	0	0.5	3000	3.123	28.178	M3-1	0.5
30	2244	2244	20706	18462	2266	22	0.5	3000	3.123	28.178	M3-1	0.5
33	14453	14843	188191	173348	14453	0	0.5	3000	3.123	28.178	M3-1	0.5
36	7238877	7242680	9894576	2651896	7238881	4	0.5	3000	3.123	28.178	M3-1	0.5
39	263400	263445	2729616	2466171	263400	0	0.5	3000	3.123	28.178	M3-1	0.5
42	35711	35878	2158003	2122125	35836	125	0.5	3000	3.123	28.178	M3-1	0.5
45	55347	56285	3736011	3679726	55350	3	0.5	3000	3.123	28.178	M3-1	0.5
48	728017	728177	10776403	10048226	728027	10	0.5	3000	3.123	28.178	M3-1	0.5
51	443289	443478	10131751	9688273	443296	7	0.5	3000	3.123	28.178	M3-1	0.5
54	102022	102378	5519503	5417125	102027	5	0.5	3000	3.123	28.178	M3-1	0.5
57	99636	99788	4837605	4737817	99927	291	0.5	3000	3.123	28.178	M3-1	0.5
59	0	0	0	0	0	0	0.5	3000	3.123	28.178	M3-1	0.5
60	221502	221616	3573801	3352185	221541	39	0.5	3000	3.123	28.178	M3-1	0.5
62	0	0	0	0	0	0	0.5	3000	3.123	28.178	M3-1	0.5
63	576245	576491	9748320	9171829	576245	0	0.5	3000	3.123	28.178	M3-1	0.5
64	0	0	0	0	0	0	0.5	3000	3.123	28.178	M3-1	0.5
66	293041	293128	2492028	2198900	293041	0	0.5	3000	3.123	28.178	M3-1	0.5
68	10	10	15	5	10	0	0.5	3000	3.123	28.178	M3-1	0.5
69	359721	359725	4045590	3685865	359732	11	0.5	3000	3.123	28.178	M3-1	0.5
72	72649	75317	1553203	1477886	72649	0	0.5	3000	3.123	28.178	M3-1	0.5
75	18352	18352	328455	310103	18354	2	0.5	3000	3.123	28.178	M3-1	0.5
76	0	0	0	0	0	0	0.5	3000	3.123	28.178	M3-1	0.5
78	132571	132572	773146	640574	132571	0	0.5	3000	3.123	28.178	M3-1	0.5
81	5138	5138	36585	31447	5138	0	0.5	3000	3.123	28.178	M3-1	0.5
84	623	623	9730	9107	623	0	0.5	3000	3.123	28.178	M3-1	0.5
87	478	478	6670	6192	478	0	0.5	3000	3.123	28.178	M3-1	0.5
90	294	305	2278	1973	294	0	0.5	3000	3.123	28.178	M3-1	0.5
6	0	0	0	0	0	0	0.5	3000	303.436	55.231	M5-1	0.5
8	3	6	6	0	3	0	0.5	3000	303.436	55.231	M5-1	0.5
9	28	28	28	0	28	0	0.5	3000	303.436	55.231	M5-1	0.5
24	9161	9286	76636	67350	9282	121	0.5	3000	303.436	55.231	M5-1	0.5
27	9928	11312	53956	42644	9928	0	0.5	3000	303.436	55.231	M5-1	0.5
30	84740	84807	512578	427771	84741	1	0.5	3000	303.436	55.231	M5-1	0.5
33	15278	16399	1097421	1081022	15288	10	0.5	3000	303.436	55.231	M5-1	0.5
35	0	0	0	0	0	0	0.5	3000	303.436	55.231	M5-1	0.5
36	38436	38513	3324331	3285818	38468	32	0.5	3000	303.436	55.231	M5-1	0.5
37	0	0	0	0	0	0	0.5	3000	303.436	55.231	M5-1	0.5
39	77192	78081	8914753	8836672	77195	3	0.5	3000	303.436	55.231	M5-1	0.5
40	0	0	0	0	0	0	0.5	3000	303.436	55.231	M5-1	0.5
42	167660	168038	24440536	24272498	168058	398	0.5	3000	303.436	55.231	M5-1	0.5
45	189861	190901	46527481	46336580	190109	248	0.5	3000	303.436	55.231	M5-1	0.5
47	0	0	0	0	0	0	0.5	3000	303.436	55.231	M5-1	0.5
48	425431	430088	84142878	83712790	425928	497	0.5	3000	303.436	55.231	M5-1	0.5
49	0	0	0	0	0	0	0.5	3000	303.436	55.231	M5-1	0.5
51	279115	283513	65259600	64976087	280933	1818	0.5	3000	303.436	55.231	M5-1	0.5
54	393148	394658	62826445	62431787	393265	117	0.5	3000	303.436	55.231	M5-1	0.5
55	1	1	1	0	1	0	0.5	3000	303.436	55.231	M5-1	0.5
57	400763	402140	60077241	59675101	401026	263	0.5	3000	303.436	55.231	M5-1	0.5
58	0	0	0	0	0	0	0.5	3000	303.436	55.231	M5-1	0.5
59	0	0	0	0	0	0	0.5	3000	303.436	55.231	M5-1	0.5
60	138985	141584	42878430	42736846	139305	320	0.5	3000	303.436	55.231	M5-1	0.5
61	0	1	1	0	0	0	0.5	3000	303.436	55.231	M5-1	0.5
62	3	3	6	3	3	0	0.5	3000	303.436	55.231	M5-1	0.5
63	282518	283443	33020001	32736558	282581	63	0.5	3000	303.436	55.231	M5-1	0.5
64	0	0	0	0	0	0	0.5	3000	303.436	55.231	M5-1	0.5
66	145565	146922	23225520	23078598	145565	0	0.5	3000	303.436	55.231	M5-1	0.5
69	210314	210783	17877210	17666427	210350	36	0.5	3000	303.436	55.231	M5-1	0.5
72	197745	198785	11005086	10806301	197959	214	0.5	3000	303.436	55.231	M5-1	0.5
75	27238	27401	2809635	2782234	27242	4	0.5	3000	303.436	55.231	M5-1	0.5
76	0	0	0	0	0	0	0.5	3000	303.436	55.231	M5-1	0.5
78	57391	58159	2273778	2215619	57391	0	0.5	3000	303.436	55.231	M5-1	0.5
81	14868	14958	644680	629722	14868	0	0.5	3000	303.436	55.231	M5-1	0.5
84	29235	29526	328455	298929	29235	0	0.5	3000	303.436	55.231	M5-1	0.5
87	4182	4182	52650	48468	4185	3	0.5	3000	303.436	55.231	M5-1	0.5
90	2090	2090	18721	16631	2090	0	0.5	3000	303.436	55.231	M5-1	0.5
3	0	0	0	0	0	0	0.5	4000	1.811	116.558	M4-1	0.5
6	0	0	0	0	0	0	0.5	4000	1.811	116.558	M4-1	0.5
24	73	75	3570	3495	73	0	0.5	4000	1.811	116.558	M4-1	0.5
27	6507	6507	43071	36564	6513	6	0.5	4000	1.811	116.558	M4-1	0.5
30	709	716	40755	40039	714	5	0.5	4000	1.811	116.558	M4-1	0.5
33	33957	33984	424581	390597	33957	0	0.5	4000	1.811	116.558	M4-1	0.5
36	4978	4979	458403	453424	4984	6	0.5	4000	1.811	116.558	M4-1	0.5
39	222875	234607	6813586	6578979	222894	19	0.5	4000	1.811	116.558	M4-1	0.5
41	0	0	0	0	0	0	0.5	4000	1.811	116.558	M4-1	0.5
42	74372	74965	8559453	8484488	75520	1148	0.5	4000	1.811	116.558	M4-1	0.5
45	274768	274902	18638565	18363663	274789	21	0.5	4000	1.811	116.558	M4-1	0.5
47	0	0	0	0	0	0	0.5	4000	1.811	116.558	M4-1	0.5
48	211115	212334	24981846	24769512	211523	408	0.5	4000	1.811	116.558	M4-1	0.5
49	0	0	0	0	0	0	0.5	4000	1.811	116.558	M4-1	0.5
50	10	10	15	5	10	0	0.5	4000	1.811	116.558	M4-1	0.5
51	268325	270020	34283340	34013320	268475	150	0.5	4000	1.811	116.558	M4-1	0.5
52	0	0	0	0	0	0	0.5	4000	1.811	116.558	M4-1	0.5
53	0	0	1	1	0	0	0.5	4000	1.811	116.558	M4-1	0.5
54	249528	257003	26335653	26078650	249548	20	0.5	4000	1.811	116.558	M4-1	0.5
56	55	55	55	0	55	0	0.5	4000	1.811	116.558	M4-1	0.5
57	92014	92998	17307786	17214788	92040	26	0.5	4000	1.811	116.558	M4-1	0.5
58	0	0	0	0	0	0	0.5	4000	1.811	116.558	M4-1	0.5
60	172947	174264	15354111	15179847	172948	1	0.5	4000	1.811	116.558	M4-1	0.5
63	89734	90130	11987856	11897726	89788	54	0.5	4000	1.811	116.558	M4-1	0.5
65	0	0	0	0	0	0	0.5	4000	1.811	116.558	M4-1	0.5
66	189006	189660	8704878	8515218	189008	2	0.5	4000	1.811	116.558	M4-1	0.5
67	0	0	0	0	0	0	0.5	4000	1.811	116.558	M4-1	0.5
69	148691	148774	7634278	7485504	148697	6	0.5	4000	1.811	116.558	M4-1	0.5
72	1448204	1449473	11493615	10044142	1448209	5	0.5	4000	1.811	116.558	M4-1	0.5
73	1	1	1	0	1	0	0.5	4000	1.811	116.558	M4-1	0.5
75	18218	18309	962578	944269	18218	0	0.5	4000	1.811	116.558	M4-1	0.5
78	12180	12247	451725	439478	12180	0	0.5	4000	1.811	116.558	M4-1	0.5
81	1988	2002	126756	124754	1988	0	0.5	4000	1.811	116.558	M4-1	0.5
84	5572	5573	52650	47077	5572	0	0.5	4000	1.811	116.558	M4-1	0.5
87	620	621	12403	11782	620	0	0.5	4000	1.811	116.558	M4-1	0.5
90	218	233	4753	4520	218	0	0.5	4000	1.811	116.558	M4-1	0.5
12	0	0	0	0	0	0	0.5	4000	2.998	27.87	M3-1	0.5
24	19	19	528	509	20	1	0.5	4000	2.998	27.87	M3-1	0.5
27	1012	1012	3403	2391	1012	0	0.5	4000	2.998	27.87	M3-1	0.5
30	2244	2244	20706	18462	2266	22	0.5	4000	2.998	27.87	M3-1	0.5
33	14453	14843	188191	173348	14453	0	0.5	4000	2.998	27.87	M3-1	0.5
36	7238877	7242680	9894576	2651896	7238881	4	0.5	4000	2.998	27.87	M3-1	0.5
39	263400	263445	2729616	2466171	263400	0	0.5	4000	2.998	27.87	M3-1	0.5
42	35711	35878	2158003	2122125	35836	125	0.5	4000	2.998	27.87	M3-1	0.5
45	55347	56285	3736011	3679726	55350	3	0.5	4000	2.998	27.87	M3-1	0.5
48	728017	728177	10776403	10048226	728027	10	0.5	4000	2.998	27.87	M3-1	0.5
51	443289	443478	10131751	9688273	443296	7	0.5	4000	2.998	27.87	M3-1	0.5
54	102022	102378	5519503	5417125	102027	5	0.5	4000	2.998	27.87	M3-1	0.5
57	99636	99788	4837605	4737817	99927	291	0.5	4000	2.998	27.87	M3-1	0.5
59	0	0	0	0	0	0	0.5	4000	2.998	27.87	M3-1	0.5
60	221502	221616	3573801	3352185	221541	39	0.5	4000	2.998	27.87	M3-1	0.5
62	0	0	0	0	0	0	0.5	4000	2.998	27.87	M3-1	0.5
63	576245	576491	9748320	9171829	576245	0	0.5	4000	2.998	27.87	M3-1	0.5
64	0	0	0	0	0	0	0.5	4000	2.998	27.87	M3-1	0.5
66	293041	293128	2492028	2198900	293041	0	0.5	4000	2.998	27.87	M3-1	0.5
68	10	10	15	5	10	0	0.5	4000	2.998	27.87	M3-1	0.5
69	359721	359725	4045590	3685865	359732	11	0.5	4000	2.998	27.87	M3-1	0.5
72	72649	75317	1553203	1477886	72649	0	0.5	4000	2.998	27.87	M3-1	0.5
75	18352	18352	328455	310103	18354	2	0.5	4000	2.998	27.87	M3-1	0.5
76	0	0	0	0	0	0	0.5	4000	2.998	27.87	M3-1	0.5
78	132571	132572	773146	640574	132571	0	0.5	4000	2.998	27.87	M3-1	0.5
81	5138	5138	36585	31447	5138	0	0.5	4000	2.998	27.87	M3-1	0.5
84	623	623	9730	9107	623	0	0.5	4000	2.998	27.87	M3-1	0.5
87	478	478	6670	6192	478	0	0.5	4000	2.998	27.87	M3-1	0.5
90	294	305	2278	1973	294	0	0.5	4000	2.998	27.87	M3-1	0.5
3	0	0	0	0	0	0	0.5	4000	203.338	65.717	M2-1	0.5
12	1	1	1	0	1	0	0.5	4000	203.338	65.717	M2-1	0.5
15	0	0	0	0	0	0	0.5	4000	203.338	65.717	M2-1	0.5
24	80	80	17391	17311	132	52	0.5	4000	203.338	65.717	M2-1	0.5
27	58	58	20706	20648	65	7	0.5	4000	203.338	65.717	M2-1	0.5
30	316	317	102831	102514	326	10	0.5	4000	203.338	65.717	M2-1	0.5
33	760	781	571915	571134	808	48	0.5	4000	203.338	65.717	M2-1	0.5
36	1513	1518	1530375	1528857	1626	113	0.5	4000	203.338	65.717	M2-1	0.5
39	13374	13402	4501500	4488098	13454	80	0.5	4000	203.338	65.717	M2-1	0.5
41	0	0	0	0	0	0	0.5	4000	203.338	65.717	M2-1	0.5
42	28574	28588	10010575	9981987	29028	454	0.5	4000	203.338	65.717	M2-1	0.5
43	0	0	1	1	0	0	0.5	4000	203.338	65.717	M2-1	0.5
45	15442	15621	16522626	16507005	15716	274	0.5	4000	203.338	65.717	M2-1	0.5
46	0	0	1	1	0	0	0.5	4000	203.338	65.717	M2-1	0.5
48	32169	32345	24398605	24366260	32337	168	0.5	4000	203.338	65.717	M2-1	0.5
51	13999	14167	23988201	23974034	14263	264	0.5	4000	203.338	65.717	M2-1	0.5
52	0	0	0	0	0	0	0.5	4000	203.338	65.717	M2-1	0.5
54	34036	34863	24217320	24182457	34150	114	0.5	4000	203.338	65.717	M2-1	0.5
55	0	0	0	0	0	0	0.5	4000	203.338	65.717	M2-1	0.5
57	28373	28771	23932821	23904050	29223	850	0.5	4000	203.338	65.717	M2-1	0.5
58	0	0	0	0	0	0	0.5	4000	203.338	65.717	M2-1	0.5
59	0	0	1	1	0	0	0.5	4000	203.338	65.717	M2-1	0.5
60	13993	14059	16869336	16855277	14085	92	0.5	4000	203.338	65.717	M2-1	0.5
61	0	0	0	0	0	0	0.5	4000	203.338	65.717	M2-1	0.5
62	0	0	0	0	0	0	0.5	4000	203.338	65.717	M2-1	0.5
63	19819	19873	11608971	11589098	19881	62	0.5	4000	203.338	65.717	M2-1	0.5
64	0	0	0	0	0	0	0.5	4000	203.338	65.717	M2-1	0.5
66	42511	42563	7755891	7713328	42534	23	0.5	4000	203.338	65.717	M2-1	0.5
68	0	0	0	0	0	0	0.5	4000	203.338	65.717	M2-1	0.5
69	2709	2772	4928230	4925458	2756	47	0.5	4000	203.338	65.717	M2-1	0.5
72	2708	2716	2248260	2245544	2739	31	0.5	4000	203.338	65.717	M2-1	0.5
73	0	0	1	1	0	0	0.5	4000	203.338	65.717	M2-1	0.5
75	166295	166303	2494261	2327958	166302	7	0.5	4000	203.338	65.717	M2-1	0.5
78	606	617	541320	540703	626	20	0.5	4000	203.338	65.717	M2-1	0.5
81	18083	18097	402753	384656	18083	0	0.5	4000	203.338	65.717	M2-1	0.5
84	295	296	95703	95407	295	0	0.5	4000	203.338	65.717	M2-1	0.5
87	93	102	20100	19998	93	0	0.5	4000	203.338	65.717	M2-1	0.5
90	2	2	9045	9043	2	0	0.5	4000	203.338	65.717	M2-1	0.5
6	0	0	0	0	0	0	0.5	4000	237.214	93.065	M5-1	0.5
8	3	6	6	0	3	0	0.5	4000	237.214	93.065	M5-1	0.5
9	28	28	28	0	28	0	0.5	4000	237.214	93.065	M5-1	0.5
24	9161	9286	76636	67350	9282	121	0.5	4000	237.214	93.065	M5-1	0.5
27	9928	11312	53956	42644	9928	0	0.5	4000	237.214	93.065	M5-1	0.5
30	84740	84807	512578	427771	84741	1	0.5	4000	237.214	93.065	M5-1	0.5
33	15278	16399	1097421	1081022	15288	10	0.5	4000	237.214	93.065	M5-1	0.5
35	0	0	0	0	0	0	0.5	4000	237.214	93.065	M5-1	0.5
36	38436	38513	3324331	3285818	38468	32	0.5	4000	237.214	93.065	M5-1	0.5
37	0	0	0	0	0	0	0.5	4000	237.214	93.065	M5-1	0.5
39	77192	78081	8914753	8836672	77195	3	0.5	4000	237.214	93.065	M5-1	0.5
40	0	0	0	0	0	0	0.5	4000	237.214	93.065	M5-1	0.5
42	167924	168038	24440536	24272498	168342	418	0.5	4000	237.214	93.065	M5-1	0.5
45	189861	190901	46527481	46336580	190109	248	0.5	4000	237.214	93.065	M5-1	0.5
47	0	0	0	0	0	0	0.5	4000	237.214	93.065	M5-1	0.5
48	425431	430088	84142878	83712790	425928	497	0.5	4000	237.214	93.065	M5-1	0.5
49	0	0	0	0	0	0	0.5	4000	237.214	93.065	M5-1	0.5
51	279115	283513	65259600	64976087	280933	1818	0.5	4000	237.214	93.065	M5-1	0.5
54	393148	394658	62826445	62431787	393265	117	0.5	4000	237.214	93.065	M5-1	0.5
55	1	1	1	0	1	0	0.5	4000	237.214	93.065	M5-1	0.5
57	400763	402140	60077241	59675101	401026	263	0.5	4000	237.214	93.065	M5-1	0.5
58	0	0	0	0	0	0	0.5	4000	237.214	93.065	M5-1	0.5
59	0	0	0	0	0	0	0.5	4000	237.214	93.065	M5-1	0.5
60	138985	141584	42878430	42736846	139305	320	0.5	4000	237.214	93.065	M5-1	0.5
61	0	1	1	0	0	0	0.5	4000	237.214	93.065	M5-1	0.5
62	3	3	6	3	3	0	0.5	4000	237.214	93.065	M5-1	0.5
63	282518	283443	33020001	32736558	282581	63	0.5	4000	237.214	93.065	M5-1	0.5
64	0	0	0	0	0	0	0.5	4000	237.214	93.065	M5-1	0.5
66	145574	146922	23225520	23078598	145574	0	0.5	4000	237.214	93.065	M5-1	0.5
69	210440	210783	17877210	17666427	210476	36	0.5	4000	237.214	93.065	M5-1	0.5
72	197745	198785	11005086	10806301	197959	214	0.5	4000	237.214	93.065	M5-1	0.5
75	27238	27401	2809635	2782234	27242	4	0.5	4000	237.214	93.065	M5-1	0.5
76	0	0	0	0	0	0	0.5	4000	237.214	93.065	M5-1	0.5
78	57391	58159	2273778	2215619	57391	0	0.5	4000	237.214	93.065	M5-1	0.5
81	14868	14958	644680	629722	14868	0	0.5	4000	237.214	93.065	M5-1	0.5
84	29235	29526	328455	298929	29235	0	0.5	4000	237.214	93.065	M5-1	0.5
87	4182	4182	52650	48468	4185	3	0.5	4000	237.214	93.065	M5-1	0.5
90	2090	2090	18721	16631	2090	0	0.5	4000	237.214	93.065	M5-1	0.5
3	0	0	0	0	0	0	0.5	5000	175.313	100.607	M2-1	0.5
12	1	1	1	0	1	0	0.5	5000	175.313	100.607	M2-1	0.5
15	0	0	0	0	0	0	0.5	5000	175.313	100.607	M2-1	0.5
24	80	80	17391	17311	132	52	0.5	5000	175.313	100.607	M2-1	0.5
27	58	58	20706	20648	65	7	0.5	5000	175.313	100.607	M2-1	0.5
30	316	317	102831	102514	326	10	0.5	5000	175.313	100.607	M2-1	0.5
33	760	781	571915	571134	808	48	0.5	5000	175.313	100.607	M2-1	0.5
36	1513	1518	1530375	1528857	1626	113	0.5	5000	175.313	100.607	M2-1	0.5
39	13374	13402	4501500	4488098	13454	80	0.5	5000	175.313	100.607	M2-1	0.5
41	0	0	0	0	0	0	0.5	5000	175.313	100.607	M2-1	0.5
42	28574	28588	10010575	9981987	29028	454	0.5	5000	175.313	100.607	M2-1	0.5
43	0	0	1	1	0	0	0.5	5000	175.313	100.607	M2-1	0.5
45	15556	15621	16522626	16507005	15908	352	0.5	5000	175.313	100.607	M2-1	0.5
46	0	0	1	1	0	0	0.5	5000	175.313	100.607	M2-1	0.5
48	32169	32345	24398605	24366260	32337	168	0.5	5000	175.313	100.607	M2-1	0.5
51	13999	14167	23988201	23974034	14263	264	0.5	5000	175.313	100.607	M2-1	0.5
52	0	0	0	0	0	0	0.5	5000	175.313	100.607	M2-1	0.5
54	34036	34863	24217320	24182457	34150	114	0.5	5000	175.313	100.607	M2-1	0.5
55	0	0	0	0	0	0	0.5	5000	175.313	100.607	M2-1	0.5
57	28373	28771	23932821	23904050	29223	850	0.5	5000	175.313	100.607	M2-1	0.5
58	0	0	0	0	0	0	0.5	5000	175.313	100.607	M2-1	0.5
59	0	0	1	1	0	0	0.5	5000	175.313	100.607	M2-1	0.5
60	13993	14059	16869336	16855277	14085	92	0.5	5000	175.313	100.607	M2-1	0.5
61	0	0	0	0	0	0	0.5	5000	175.313	100.607	M2-1	0.5
62	0	0	0	0	0	0	0.5	5000	175.313	100.607	M2-1	0.5
63	19819	19873	11608971	11589098	19919	100	0.5	5000	175.313	100.607	M2-1	0.5
64	0	0	0	0	0	0	0.5	5000	175.313	100.607	M2-1	0.5
66	42511	42563	7755891	7713328	42534	23	0.5	5000	175.313	100.607	M2-1	0.5
68	0	0	0	0	0	0	0.5	5000	175.313	100.607	M2-1	0.5
69	2709	2772	4928230	4925458	2756	47	0.5	5000	175.313	100.607	M2-1	0.5
72	2708	2716	2248260	2245544	2739	31	0.5	5000	175.313	100.607	M2-1	0.5
73	0	0	1	1	0	0	0.5	5000	175.313	100.607	M2-1	0.5
75	166295	166303	2494261	2327958	166302	7	0.5	5000	175.313	100.607	M2-1	0.5
78	606	617	541320	540703	626	20	0.5	5000	175.313	100.607	M2-1	0.5
81	18083	18097	402753	384656	18083	0	0.5	5000	175.313	100.607	M2-1	0.5
84	295	296	95703	95407	295	0	0.5	5000	175.313	100.607	M2-1	0.5
87	93	102	20100	19998	93	0	0.5	5000	175.313	100.607	M2-1	0.5
90	2	2	9045	9043	2	0	0.5	5000	175.313	100.607	M2-1	0.5
6	0	0	0	0	0	0	0.5	5000	179.059	120.232	M5-1	0.5
8	3	6	6	0	3	0	0.5	5000	179.059	120.232	M5-1	0.5
9	28	28	28	0	28	0	0.5	5000	179.059	120.232	M5-1	0.5
24	9161	9286	76636	67350	9282	121	0.5	5000	179.059	120.232	M5-1	0.5
27	9928	11312	53956	42644	9928	0	0.5	5000	179.059	120.232	M5-1	0.5
30	84740	84807	512578	427771	84741	1	0.5	5000	179.059	120.232	M5-1	0.5
33	15278	16399	1097421	1081022	15288	10	0.5	5000	179.059	120.232	M5-1	0.5
35	0	0	0	0	0	0	0.5	5000	179.059	120.232	M5-1	0.5
36	38436	38513	3324331	3285818	38468	32	0.5	5000	179.059	120.232	M5-1	0.5
37	0	0	0	0	0	0	0.5	5000	179.059	120.232	M5-1	0.5
39	77192	78081	8914753	8836672	77195	3	0.5	5000	179.059	120.232	M5-1	0.5
40	0	0	0	0	0	0	0.5	5000	179.059	120.232	M5-1	0.5
42	167924	168038	24440536	24272498	168342	418	0.5	5000	179.059	120.232	M5-1	0.5
45	190403	190901	46527481	46336580	190700	297	0.5	5000	179.059	120.232	M5-1	0.5
47	0	0	0	0	0	0	0.5	5000	179.059	120.232	M5-1	0.5
48	425431	430088	84142878	83712790	425928	497	0.5	5000	179.059	120.232	M5-1	0.5
49	0	0	0	0	0	0	0.5	5000	179.059	120.232	M5-1	0.5
51	279115	283513	65259600	64976087	280933	1818	0.5	5000	179.059	120.232	M5-1	0.5
54	393148	394658	62826445	62431787	393265	117	0.5	5000	179.059	120.232	M5-1	0.5
55	1	1	1	0	1	0	0.5	5000	179.059	120.232	M5-1	0.5
57	400763	402140	60077241	59675101	401026	263	0.5	5000	179.059	120.232	M5-1	0.5
58	0	0	0	0	0	0	0.5	5000	179.059	120.232	M5-1	0.5
59	0	0	0	0	0	0	0.5	5000	179.059	120.232	M5-1	0.5
60	138985	141584	42878430	42736846	139305	320	0.5	5000	179.059	120.232	M5-1	0.5
61	0	1	1	0	0	0	0.5	5000	179.059	120.232	M5-1	0.5
62	3	3	6	3	3	0	0.5	5000	179.059	120.232	M5-1	0.5
63	282636	283443	33020001	32736558	282710	74	0.5	5000	179.059	120.232	M5-1	0.5
64	0	0	0	0	0	0	0.5	5000	179.059	120.232	M5-1	0.5
66	145574	146922	23225520	23078598	145574	0	0.5	5000	179.059	120.232	M5-1	0.5
69	210440	210783	17877210	17666427	210476	36	0.5	5000	179.059	120.232	M5-1	0.5
72	197745	198785	11005086	10806301	197959	214	0.5	5000	179.059	120.232	M5-1	0.5
75	27238	27401	2809635	2782234	27242	4	0.5	5000	179.059	120.232	M5-1	0.5
76	0	0	0	0	0	0	0.5	5000	179.059	120.232	M5-1	0.5
78	57391	58159	2273778	2215619	57391	0	0.5	5000	179.059	120.232	M5-1	0.5
81	14868	14958	644680	629722	14868	0	0.5	5000	179.059	120.232	M5-1	0.5
84	29235	29526	328455	298929	29235	0	0.5	5000	179.059	120.232	M5-1	0.5
87	4182	4182	52650	48468	4185	3	0.5	5000	179.059	120.232	M5-1	0.5
90	2090	2090	18721	16631	2090	0	0.5	5000	179.059	120.232	M5-1	0.5
12	0	0	0	0	0	0	0.5	5000	3.037	27.734	M3-1	0.5
24	19	19	528	509	20	1	0.5	5000	3.037	27.734	M3-1	0.5
27	1012	1012	3403	2391	1012	0	0.5	5000	3.037	27.734	M3-1	0.5
30	2244	2244	20706	18462	2266	22	0.5	5000	3.037	27.734	M3-1	0.5
33	14453	14843	188191	173348	14453	0	0.5	5000	3.037	27.734	M3-1	0.5
36	7238877	7242680	9894576	2651896	7238881	4	0.5	5000	3.037	27.734	M3-1	0.5
39	263400	263445	2729616	2466171	263400	0	0.5	5000	3.037	27.734	M3-1	0.5
42	35711	35878	2158003	2122125	35836	125	0.5	5000	3.037	27.734	M3-1	0.5
45	55347	56285	3736011	3679726	55350	3	0.5	5000	3.037	27.734	M3-1	0.5
48	728017	728177	10776403	10048226	728027	10	0.5	5000	3.037	27.734	M3-1	0.5
51	443289	443478	10131751	9688273	443296	7	0.5	5000	3.037	27.734	M3-1	0.5
54	102022	102378	5519503	5417125	102027	5	0.5	5000	3.037	27.734	M3-1	0.5
57	99636	99788	4837605	4737817	99927	291	0.5	5000	3.037	27.734	M3-1	0.5
59	0	0	0	0	0	0	0.5	5000	3.037	27.734	M3-1	0.5
60	221502	221616	3573801	3352185	221541	39	0.5	5000	3.037	27.734	M3-1	0.5
62	0	0	0	0	0	0	0.5	5000	3.037	27.734	M3-1	0.5
63	576245	576491	9748320	9171829	576245	0	0.5	5000	3.037	27.734	M3-1	0.5
64	0	0	0	0	0	0	0.5	5000	3.037	27.734	M3-1	0.5
66	293041	293128	2492028	2198900	293041	0	0.5	5000	3.037	27.734	M3-1	0.5
68	10	10	15	5	10	0	0.5	5000	3.037	27.734	M3-1	0.5
69	359721	359725	4045590	3685865	359732	11	0.5	5000	3.037	27.734	M3-1	0.5
72	72649	75317	1553203	1477886	72649	0	0.5	5000	3.037	27.734	M3-1	0.5
75	18352	18352	328455	310103	18354	2	0.5	5000	3.037	27.734	M3-1	0.5
76	0	0	0	0	0	0	0.5	5000	3.037	27.734	M3-1	0.5
78	132571	132572	773146	640574	132571	0	0.5	5000	3.037	27.734	M3-1	0.5
81	5138	5138	36585	31447	5138	0	0.5	5000	3.037	27.734	M3-1	0.5
84	623	623	9730	9107	623	0	0.5	5000	3.037	27.734	M3-1	0.5
87	478	478	6670	6192	478	0	0.5	5000	3.037	27.734	M3-1	0.5
90	294	305	2278	1973	294	0	0.5	5000	3.037	27.734	M3-1	0.5
3	0	0	0	0	0	0	0.5	5000	3.852	116.661	M4-1	0.5
6	0	0	0	0	0	0	0.5	5000	3.852	116.661	M4-1	0.5
24	73	75	3570	3495	73	0	0.5	5000	3.852	116.661	M4-1	0.5
27	6507	6507	43071	36564	6513	6	0.5	5000	3.852	116.661	M4-1	0.5
30	709	716	40755	40039	714	5	0.5	5000	3.852	116.661	M4-1	0.5
33	33957	33984	424581	390597	33957	0	0.5	5000	3.852	116.661	M4-1	0.5
36	4978	4979	458403	453424	4984	6	0.5	5000	3.852	116.661	M4-1	0.5
39	222875	234607	6813586	6578979	222894	19	0.5	5000	3.852	116.661	M4-1	0.5
41	0	0	0	0	0	0	0.5	5000	3.852	116.661	M4-1	0.5
42	74372	74965	8559453	8484488	75520	1148	0.5	5000	3.852	116.661	M4-1	0.5
45	274768	274902	18638565	18363663	274789	21	0.5	5000	3.852	116.661	M4-1	0.5
47	0	0	0	0	0	0	0.5	5000	3.852	116.661	M4-1	0.5
48	211115	212334	24981846	24769512	211523	408	0.5	5000	3.852	116.661	M4-1	0.5
49	0	0	0	0	0	0	0.5	5000	3.852	116.661	M4-1	0.5
50	10	10	15	5	10	0	0.5	5000	3.852	116.661	M4-1	0.5
51	268325	270020	34283340	34013320	268475	150	0.5	5000	3.852	116.661	M4-1	0.5
52	0	0	0	0	0	0	0.5	5000	3.852	116.661	M4-1	0.5
53	0	0	1	1	0	0	0.5	5000	3.852	116.661	M4-1	0.5
54	249528	257003	26335653	26078650	249548	20	0.5	5000	3.852	116.661	M4-1	0.5
56	55	55	55	0	55	0	0.5	5000	3.852	116.661	M4-1	0.5
57	92014	92998	17307786	17214788	92040	26	0.5	5000	3.852	116.661	M4-1	0.5
58	0	0	0	0	0	0	0.5	5000	3.852	116.661	M4-1	0.5
60	172947	174264	15354111	15179847	172948	1	0.5	5000	3.852	116.661	M4-1	0.5
63	89734	90130	11987856	11897726	89788	54	0.5	5000	3.852	116.661	M4-1	0.5
65	0	0	0	0	0	0	0.5	5000	3.852	116.661	M4-1	0.5
66	189006	189660	8704878	8515218	189008	2	0.5	5000	3.852	116.661	M4-1	0.5
67	0	0	0	0	0	0	0.5	5000	3.852	116.661	M4-1	0.5
69	148691	148774	7634278	7485504	148697	6	0.5	5000	3.852	116.661	M4-1	0.5
72	1448204	1449473	11493615	10044142	1448209	5	0.5	5000	3.852	116.661	M4-1	0.5
73	1	1	1	0	1	0	0.5	5000	3.852	116.661	M4-1	0.5
75	18218	18309	962578	944269	18218	0	0.5	5000	3.852	116.661	M4-1	0.5
78	12180	12247	451725	439478	12180	0	0.5	5000	3.852	116.661	M4-1	0.5
81	1988	2002	126756	124754	1988	0	0.5	5000	3.852	116.661	M4-1	0.5
84	5572	5573	52650	47077	5572	0	0.5	5000	3.852	116.661	M4-1	0.5
87	620	621	12403	11782	620	0	0.5	5000	3.852	116.661	M4-1	0.5
90	218	233	4753	4520	218	0	0.5	5000	3.852	116.661	M4-1	0.5
3	0	0	0	0	0	0	0.6	1000	15.132	22.044	M4-1	0.5
6	0	0	0	0	0	0	0.6	1000	15.132	22.044	M4-1	0.5
24	73	75	3570	3495	73	0	0.6	1000	15.132	22.044	M4-1	0.5
27	6507	6507	43071	36564	6513	6	0.6	1000	15.132	22.044	M4-1	0.5
30	709	716	40755	40039	714	5	0.6	1000	15.132	22.044	M4-1	0.5
33	33957	33984	424581	390597	33957	0	0.6	1000	15.132	22.044	M4-1	0.5
36	4978	4979	458403	453424	4984	6	0.6	1000	15.132	22.044	M4-1	0.5
39	218354	234607	6813586	6578979	218373	19	0.6	1000	15.132	22.044	M4-1	0.5
41	0	0	0	0	0	0	0.6	1000	15.132	22.044	M4-1	0.5
42	70590	74965	8559453	8484488	71727	1137	0.6	1000	15.132	22.044	M4-1	0.5
45	266514	274902	18638565	18363663	266535	21	0.6	1000	15.132	22.044	M4-1	0.5
47	0	0	0	0	0	0	0.6	1000	15.132	22.044	M4-1	0.5
48	210917	212334	24981846	24769512	211324	407	0.6	1000	15.132	22.044	M4-1	0.5
49	0	0	0	0	0	0	0.6	1000	15.132	22.044	M4-1	0.5
50	10	10	15	5	10	0	0.6	1000	15.132	22.044	M4-1	0.5
51	268213	270020	34283340	34013320	268345	132	0.6	1000	15.132	22.044	M4-1	0.5
52	0	0	0	0	0	0	0.6	1000	15.132	22.044	M4-1	0.5
53	0	0	1	1	0	0	0.6	1000	15.132	22.044	M4-1	0.5
54	249358	257003	26335653	26078650	249378	20	0.6	1000	15.132	22.044	M4-1	0.5
56	55	55	55	0	55	0	0.6	1000	15.132	22.044	M4-1	0.5
57	91948	92998	17307786	17214788	91964	16	0.6	1000	15.132	22.044	M4-1	0.5
58	0	0	0	0	0	0	0.6	1000	15.132	22.044	M4-1	0.5
60	172821	174264	15354111	15179847	172822	1	0.6	1000	15.132	22.044	M4-1	0.5
63	89249	90130	11987856	11897726	89298	49	0.6	1000	15.132	22.044	M4-1	0.5
65	0	0	0	0	0	0	0.6	1000	15.132	22.044	M4-1	0.5
66	188994	189660	8704878	8515218	188994	0	0.6	1000	15.132	22.044	M4-1	0.5
67	0	0	0	0	0	0	0.6	1000	15.132	22.044	M4-1	0.5
69	148640	148774	7634278	7485504	148646	6	0.6	1000	15.132	22.044	M4-1	0.5
72	1444297	1449473	11493615	10044142	1444302	5	0.6	1000	15.132	22.044	M4-1	0.5
73	1	1	1	0	1	0	0.6	1000	15.132	22.044	M4-1	0.5
75	18218	18309	962578	944269	18218	0	0.6	1000	15.132	22.044	M4-1	0.5
78	12180	12247	451725	439478	12180	0	0.6	1000	15.132	22.044	M4-1	0.5
81	1988	2002	126756	124754	1988	0	0.6	1000	15.132	22.044	M4-1	0.5
84	5572	5573	52650	47077	5572	0	0.6	1000	15.132	22.044	M4-1	0.5
87	620	621	12403	11782	620	0	0.6	1000	15.132	22.044	M4-1	0.5
90	218	233	4753	4520	218	0	0.6	1000	15.132	22.044	M4-1	0.5
3	0	0	0	0	0	0	0.6	1000	21.24	25.927	M2-1	0.5
12	1	1	1	0	1	0	0.6	1000	21.24	25.927	M2-1	0.5
15	0	0	0	0	0	0	0.6	1000	21.24	25.927	M2-1	0.5
24	80	80	17391	17311	132	52	0.6	1000	21.24	25.927	M2-1	0.5
27	58	58	20706	20648	65	7	0.6	1000	21.24	25.927	M2-1	0.5
30	316	317	102831	102514	326	10	0.6	1000	21.24	25.927	M2-1	0.5
33	760	781	571915	571134	808	48	0.6	1000	21.24	25.927	M2-1	0.5
36	1468	1518	1530375	1528857	1543	75	0.6	1000	21.24	25.927	M2-1	0.5
39	13325	13402	4501500	4488098	13394	69	0.6	1000	21.24	25.927	M2-1	0.5
41	0	0	0	0	0	0	0.6	1000	21.24	25.927	M2-1	0.5
42	28486	28588	10010575	9981987	28725	239	0.6	1000	21.24	25.927	M2-1	0.5
43	0	0	1	1	0	0	0.6	1000	21.24	25.927	M2-1	0.5
45	14838	15621	16522626	16507005	15079	241	0.6	1000	21.24	25.927	M2-1	0.5
46	0	0	1	1	0	0	0.6	1000	21.24	25.927	M2-1	0.5
48	32137	32345	24398605	24366260	32345	208	0.6	1000	21.24	25.927	M2-1	0.5
51	13967	14167	23988201	23974034	14271	304	0.6	1000	21.24	25.927	M2-1	0.5
52	0	0	0	0	0	0	0.6	1000	21.24	25.927	M2-1	0.5
54	33934	34863	24217320	24182457	34092	158	0.6	1000	21.24	25.927	M2-1	0.5
55	0	0	0	0	0	0	0.6	1000	21.24	25.927	M2-1	0.5
57	28314	28771	23932821	23904050	29174	860	0.6	1000	21.24	25.927	M2-1	0.5
58	0	0	0	0	0	0	0.6	1000	21.24	25.927	M2-1	0.5
59	0	0	1	1	0	0	0.6	1000	21.24	25.927	M2-1	0.5
60	13941	14059	16869336	16855277	14021	80	0.6	1000	21.24	25.927	M2-1	0.5
61	0	0	0	0	0	0	0.6	1000	21.24	25.927	M2-1	0.5
62	0	0	0	0	0	0	0.6	1000	21.24	25.927	M2-1	0.5
63	19815	19873	11608971	11589098	19878	63	0.6	1000	21.24	25.927	M2-1	0.5
64	0	0	0	0	0	0	0.6	1000	21.24	25.927	M2-1	0.5
66	42504	42563	7755891	7713328	42518	14	0.6	1000	21.24	25.927	M2-1	0.5
68	0	0	0	0	0	0	0.6	1000	21.24	25.927	M2-1	0.5
69	2685	2772	4928230	4925458	2722	37	0.6	1000	21.24	25.927	M2-1	0.5
72	2703	2716	2248260	2245544	2720	17	0.6	1000	21.24	25.927	M2-1	0.5
73	0	0	1	1	0	0	0.6	1000	21.24	25.927	M2-1	0.5
75	166287	166303	2494261	2327958	166292	5	0.6	1000	21.24	25.927	M2-1	0.5
78	606	617	541320	540703	626	20	0.6	1000	21.24	25.927	M2-1	0.5
81	18083	18097	402753	384656	18083	0	0.6	1000	21.24	25.927	M2-1	0.5
84	295	296	95703	95407	295	0	0.6	1000	21.24	25.927	M2-1	0.5
87	93	102	20100	19998	93	0	0.6	1000	21.24	25.927	M2-1	0.5
90	2	2	9045	9043	2	0	0.6	1000	21.24	25.927	M2-1	0.5
6	0	0	0	0	0	0	0.6	1000	32.765	33.799	M5-1	0.5
8	3	6	6	0	3	0	0.6	1000	32.765	33.799	M5-1	0.5
9	28	28	28	0	28	0	0.6	1000	32.765	33.799	M5-1	0.5
24	9161	9286	76636	67350	9282	121	0.6	1000	32.765	33.799	M5-1	0.5
27	9928	11312	53956	42644	9928	0	0.6	1000	32.765	33.799	M5-1	0.5
30	84740	84807	512578	427771	84741	1	0.6	1000	32.765	33.799	M5-1	0.5
33	15278	16399	1097421	1081022	15288	10	0.6	1000	32.765	33.799	M5-1	0.5
35	0	0	0	0	0	0	0.6	1000	32.765	33.799	M5-1	0.5
36	38392	38513	3324331	3285818	38422	30	0.6	1000	32.765	33.799	M5-1	0.5
37	0	0	0	0	0	0	0.6	1000	32.765	33.799	M5-1	0.5
39	75263	78081	8914753	8836672	75265	2	0.6	1000	32.765	33.799	M5-1	0.5
40	0	0	0	0	0	0	0.6	1000	32.765	33.799	M5-1	0.5
42	165925	168038	24440536	24272498	166040	115	0.6	1000	32.765	33.799	M5-1	0.5
45	181392	190901	46527481	46336580	181571	179	0.6	1000	32.765	33.799	M5-1	0.5
47	0	0	0	0	0	0	0.6	1000	32.765	33.799	M5-1	0.5
48	424076	430088	84142878	83712790	424571	495	0.6	1000	32.765	33.799	M5-1	0.5
49	0	0	0	0	0	0	0.6	1000	32.765	33.799	M5-1	0.5
51	280272	283513	65259600	64976087	282047	1775	0.6	1000	32.765	33.799	M5-1	0.5
54	392839	394658	62826445	62431787	392946	107	0.6	1000	32.765	33.799	M5-1	0.5
55	1	1	1	0	1	0	0.6	1000	32.765	33.799	M5-1	0.5
57	400340	402140	60077241	59675101	400562	222	0.6	1000	32.765	33.799	M5-1	0.5
58	0	0	0	0	0	0	0.6	1000	32.765	33.799	M5-1	0.5
59	0	0	0	0	0	0	0.6	1000	32.765	33.799	M5-1	0.5
60	138715	141584	42878430	42736846	139023	308	0.6	1000	32.765	33.799	M5-1	0.5
61	0	1	1	0	0	0	0.6	1000	32.765	33.799	M5-1	0.5
62	3	3	6	3	3	0	0.6	1000	32.765	33.799	M5-1	0.5
63	282571	283443	33020001	32736558	282634	63	0.6	1000	32.765	33.799	M5-1	0.5
64	0	0	0	0	0	0	0.6	1000	32.765	33.799	M5-1	0.5
66	145514	146922	23225520	23078598	145514	0	0.6	1000	32.765	33.799	M5-1	0.5
69	209870	210783	17877210	17666427	209905	35	0.6	1000	32.765	33.799	M5-1	0.5
72	197525	198785	11005086	10806301	197707	182	0.6	1000	32.765	33.799	M5-1	0.5
75	27215	27401	2809635	2782234	27219	4	0.6	1000	32.765	33.799	M5-1	0.5
76	0	0	0	0	0	0	0.6	1000	32.765	33.799	M5-1	0.5
78	57367	58159	2273778	2215619	57367	0	0.6	1000	32.765	33.799	M5-1	0.5
81	14868	14958	644680	629722	14868	0	0.6	1000	32.765	33.799	M5-1	0.5
84	29235	29526	328455	298929	29235	0	0.6	1000	32.765	33.799	M5-1	0.5
87	4182	4182	52650	48468	4185	3	0.6	1000	32.765	33.799	M5-1	0.5
90	2090	2090	18721	16631	2090	0	0.6	1000	32.765	33.799	M5-1	0.5
12	0	0	0	0	0	0	0.6	1000	8.935	15.855	M3-1	0.5
24	19	19	528	509	20	1	0.6	1000	8.935	15.855	M3-1	0.5
27	1012	1012	3403	2391	1012	0	0.6	1000	8.935	15.855	M3-1	0.5
30	2244	2244	20706	18462	2266	22	0.6	1000	8.935	15.855	M3-1	0.5
33	14453	14843	188191	173348	14453	0	0.6	1000	8.935	15.855	M3-1	0.5
36	7238877	7242680	9894576	2651896	7238881	4	0.6	1000	8.935	15.855	M3-1	0.5
39	263400	263445	2729616	2466171	263400	0	0.6	1000	8.935	15.855	M3-1	0.5
42	35711	35878	2158003	2122125	35836	125	0.6	1000	8.935	15.855	M3-1	0.5
45	53125	56285	3736011	3679726	53126	1	0.6	1000	8.935	15.855	M3-1	0.5
48	727753	728177	10776403	10048226	727763	10	0.6	1000	8.935	15.855	M3-1	0.5
51	439964	443478	10131751	9688273	439968	4	0.6	1000	8.935	15.855	M3-1	0.5
54	101705	102378	5519503	5417125	101709	4	0.6	1000	8.935	15.855	M3-1	0.5
57	99428	99788	4837605	4737817	99719	291	0.6	1000	8.935	15.855	M3-1	0.5
59	0	0	0	0	0	0	0.6	1000	8.935	15.855	M3-1	0.5
60	220906	221616	3573801	3352185	220945	39	0.6	1000	8.935	15.855	M3-1	0.5
62	0	0	0	0	0	0	0.6	1000	8.935	15.855	M3-1	0.5
63	575533	576491	9748320	9171829	575533	0	0.6	1000	8.935	15.855	M3-1	0.5
64	0	0	0	0	0	0	0.6	1000	8.935	15.855	M3-1	0.5
66	293041	293128	2492028	2198900	293041	0	0.6	1000	8.935	15.855	M3-1	0.5
68	10	10	15	5	10	0	0.6	1000	8.935	15.855	M3-1	0.5
69	359715	359725	4045590	3685865	359726	11	0.6	1000	8.935	15.855	M3-1	0.5
72	72649	75317	1553203	1477886	72649	0	0.6	1000	8.935	15.855	M3-1	0.5
75	18352	18352	328455	310103	18354	2	0.6	1000	8.935	15.855	M3-1	0.5
76	0	0	0	0	0	0	0.6	1000	8.935	15.855	M3-1	0.5
78	132571	132572	773146	640574	132571	0	0.6	1000	8.935	15.855	M3-1	0.5
81	5138	5138	36585	31447	5138	0	0.6	1000	8.935	15.855	M3-1	0.5
84	623	623	9730	9107	623	0	0.6	1000	8.935	15.855	M3-1	0.5
87	478	478	6670	6192	478	0	0.6	1000	8.935	15.855	M3-1	0.5
90	294	305	2278	1973	294	0	0.6	1000	8.935	15.855	M3-1	0.5
3	0	0	0	0	0	0	0.6	2000	13.855	32.328	M4-1	0.5
6	0	0	0	0	0	0	0.6	2000	13.855	32.328	M4-1	0.5
24	73	75	3570	3495	73	0	0.6	2000	13.855	32.328	M4-1	0.5
27	6507	6507	43071	36564	6513	6	0.6	2000	13.855	32.328	M4-1	0.5
30	709	716	40755	40039	714	5	0.6	2000	13.855	32.328	M4-1	0.5
33	33957	33984	424581	390597	33957	0	0.6	2000	13.855	32.328	M4-1	0.5
36	4978	4979	458403	453424	4984	6	0.6	2000	13.855	32.328	M4-1	0.5
39	222875	234607	6813586	6578979	222894	19	0.6	2000	13.855	32.328	M4-1	0.5
41	0	0	0	0	0	0	0.6	2000	13.855	32.328	M4-1	0.5
42	70590	74965	8559453	8484488	71727	1137	0.6	2000	13.855	32.328	M4-1	0.5
45	266514	274902	18638565	18363663	266535	21	0.6	2000	13.855	32.328	M4-1	0.5
47	0	0	0	0	0	0	0.6	2000	13.855	32.328	M4-1	0.5
48	210917	212334	24981846	24769512	211324	407	0.6	2000	13.855	32.328	M4-1	0.5
49	0	0	0	0	0	0	0.6	2000	13.855	32.328	M4-1	0.5
50	10	10	15	5	10	0	0.6	2000	13.855	32.328	M4-1	0.5
51	268213	270020	34283340	34013320	268345	132	0.6	2000	13.855	32.328	M4-1	0.5
52	0	0	0	0	0	0	0.6	2000	13.855	32.328	M4-1	0.5
53	0	0	1	1	0	0	0.6	2000	13.855	32.328	M4-1	0.5
54	249358	257003	26335653	26078650	249378	20	0.6	2000	13.855	32.328	M4-1	0.5
56	55	55	55	0	55	0	0.6	2000	13.855	32.328	M4-1	0.5
57	91948	92998	17307786	17214788	91964	16	0.6	2000	13.855	32.328	M4-1	0.5
58	0	0	0	0	0	0	0.6	2000	13.855	32.328	M4-1	0.5
60	172821	174264	15354111	15179847	172822	1	0.6	2000	13.855	32.328	M4-1	0.5
63	89249	90130	11987856	11897726	89298	49	0.6	2000	13.855	32.328	M4-1	0.5
65	0	0	0	0	0	0	0.6	2000	13.855	32.328	M4-1	0.5
66	188994	189660	8704878	8515218	188994	0	0.6	2000	13.855	32.328	M4-1	0.5
67	0	0	0	0	0	0	0.6	2000	13.855	32.328	M4-1	0.5
69	148691	148774	7634278	7485504	148697	6	0.6	2000	13.855	32.328	M4-1	0.5
72	1444297	1449473	11493615	10044142	1444302	5	0.6	2000	13.855	32.328	M4-1	0.5
73	1	1	1	0	1	0	0.6	2000	13.855	32.328	M4-1	0.5
75	18218	18309	962578	944269	18218	0	0.6	2000	13.855	32.328	M4-1	0.5
78	12180	12247	451725	439478	12180	0	0.6	2000	13.855	32.328	M4-1	0.5
81	1988	2002	126756	124754	1988	0	0.6	2000	13.855	32.328	M4-1	0.5
84	5572	5573	52650	47077	5572	0	0.6	2000	13.855	32.328	M4-1	0.5
87	620	621	12403	11782	620	0	0.6	2000	13.855	32.328	M4-1	0.5
90	218	233	4753	4520	218	0	0.6	2000	13.855	32.328	M4-1	0.5
3	0	0	0	0	0	0	0.6	2000	16.63	41.882	M2-1	0.5
12	1	1	1	0	1	0	0.6	2000	16.63	41.882	M2-1	0.5
15	0	0	0	0	0	0	0.6	2000	16.63	41.882	M2-1	0.5
24	80	80	17391	17311	132	52	0.6	2000	16.63	41.882	M2-1	0.5
27	58	58	20706	20648	65	7	0.6	2000	16.63	41.882	M2-1	0.5
30	316	317	102831	102514	326	10	0.6	2000	16.63	41.882	M2-1	0.5
33	760	781	571915	571134	808	48	0.6	2000	16.63	41.882	M2-1	0.5
36	1513	1518	1530375	1528857	1626	113	0.6	2000	16.63	41.882	M2-1	0.5
39	13325	13402	4501500	4488098	13394	69	0.6	2000	16.63	41.882	M2-1	0.5
41	0	0	0	0	0	0	0.6	2000	16.63	41.882	M2-1	0.5
42	28486	28588	10010575	9981987	28725	239	0.6	2000	16.63	41.882	M2-1	0.5
43	0	0	1	1	0	0	0.6	2000	16.63	41.882	M2-1	0.5
45	14838	15621	16522626	16507005	15079	241	0.6	2000	16.63	41.882	M2-1	0.5
46	0	0	1	1	0	0	0.6	2000	16.63	41.882	M2-1	0.5
48	32137	32345	24398605	24366260	32345	208	0.6	2000	16.63	41.882	M2-1	0.5
51	13967	14167	23988201	23974034	14271	304	0.6	2000	16.63	41.882	M2-1	0.5
52	0	0	0	0	0	0	0.6	2000	16.63	41.882	M2-1	0.5
54	33934	34863	24217320	24182457	34092	158	0.6	2000	16.63	41.882	M2-1	0.5
55	0	0	0	0	0	0	0.6	2000	16.63	41.882	M2-1	0.5
57	28314	28771	23932821	23904050	29174	860	0.6	2000	16.63	41.882	M2-1	0.5
58	0	0	0	0	0	0	0.6	2000	16.63	41.882	M2-1	0.5
59	0	0	1	1	0	0	0.6	2000	16.63	41.882	M2-1	0.5
60	13941	14059	16869336	16855277	14021	80	0.6	2000	16.63	41.882	M2-1	0.5
61	0	0	0	0	0	0	0.6	2000	16.63	41.882	M2-1	0.5
62	0	0	0	0	0	0	0.6	2000	16.63	41.882	M2-1	0.5
63	19815	19873	11608971	11589098	19878	63	0.6	2000	16.63	41.882	M2-1	0.5
64	0	0	0	0	0	0	0.6	2000	16.63	41.882	M2-1	0.5
66	42504	42563	7755891	7713328	42518	14	0.6	2000	16.63	41.882	M2-1	0.5
68	0	0	0	0	0	0	0.6	2000	16.63	41.882	M2-1	0.5
69	2685	2772	4928230	4925458	2722	37	0.6	2000	16.63	41.882	M2-1	0.5
72	2708	2716	2248260	2245544	2739	31	0.6	2000	16.63	41.882	M2-1	0.5
73	0	0	1	1	0	0	0.6	2000	16.63	41.882	M2-1	0.5
75	166295	166303	2494261	2327958	166302	7	0.6	2000	16.63	41.882	M2-1	0.5
78	606	617	541320	540703	626	20	0.6	2000	16.63	41.882	M2-1	0.5
81	18083	18097	402753	384656	18083	0	0.6	2000	16.63	41.882	M2-1	0.5
84	295	296	95703	95407	295	0	0.6	2000	16.63	41.882	M2-1	0.5
87	93	102	20100	19998	93	0	0.6	2000	16.63	41.882	M2-1	0.5
90	2	2	9045	9043	2	0	0.6	2000	16.63	41.882	M2-1	0.5
6	0	0	0	0	0	0	0.6	2000	19.457	33.586	M5-1	0.5
8	3	6	6	0	3	0	0.6	2000	19.457	33.586	M5-1	0.5
9	28	28	28	0	28	0	0.6	2000	19.457	33.586	M5-1	0.5
24	9161	9286	76636	67350	9282	121	0.6	2000	19.457	33.586	M5-1	0.5
27	9928	11312	53956	42644	9928	0	0.6	2000	19.457	33.586	M5-1	0.5
30	84740	84807	512578	427771	84741	1	0.6	2000	19.457	33.586	M5-1	0.5
33	15278	16399	1097421	1081022	15288	10	0.6	2000	19.457	33.586	M5-1	0.5
35	0	0	0	0	0	0	0.6	2000	19.457	33.586	M5-1	0.5
36	38436	38513	3324331	3285818	38468	32	0.6	2000	19.457	33.586	M5-1	0.5
37	0	0	0	0	0	0	0.6	2000	19.457	33.586	M5-1	0.5
39	75263	78081	8914753	8836672	75265	2	0.6	2000	19.457	33.586	M5-1	0.5
40	0	0	0	0	0	0	0.6	2000	19.457	33.586	M5-1	0.5
42	165925	168038	24440536	24272498	166040	115	0.6	2000	19.457	33.586	M5-1	0.5
45	181392	190901	46527481	46336580	181571	179	0.6	2000	19.457	33.586	M5-1	0.5
47	0	0	0	0	0	0	0.6	2000	19.457	33.586	M5-1	0.5
48	424076	430088	84142878	83712790	424571	495	0.6	2000	19.457	33.586	M5-1	0.5
49	0	0	0	0	0	0	0.6	2000	19.457	33.586	M5-1	0.5
51	280272	283513	65259600	64976087	282047	1775	0.6	2000	19.457	33.586	M5-1	0.5
54	392839	394658	62826445	62431787	392946	107	0.6	2000	19.457	33.586	M5-1	0.5
55	1	1	1	0	1	0	0.6	2000	19.457	33.586	M5-1	0.5
57	400340	402140	60077241	59675101	400562	222	0.6	2000	19.457	33.586	M5-1	0.5
58	0	0	0	0	0	0	0.6	2000	19.457	33.586	M5-1	0.5
59	0	0	0	0	0	0	0.6	2000	19.457	33.586	M5-1	0.5
60	138715	141584	42878430	42736846	139023	308	0.6	2000	19.457	33.586	M5-1	0.5
61	0	1	1	0	0	0	0.6	2000	19.457	33.586	M5-1	0.5
62	3	3	6	3	3	0	0.6	2000	19.457	33.586	M5-1	0.5
63	282571	283443	33020001	32736558	282634	63	0.6	2000	19.457	33.586	M5-1	0.5
64	0	0	0	0	0	0	0.6	2000	19.457	33.586	M5-1	0.5
66	145514	146922	23225520	23078598	145514	0	0.6	2000	19.457	33.586	M5-1	0.5
69	209870	210783	17877210	17666427	209905	35	0.6	2000	19.457	33.586	M5-1	0.5
72	197525	198785	11005086	10806301	197707	182	0.6	2000	19.457	33.586	M5-1	0.5
75	27238	27401	2809635	2782234	27242	4	0.6	2000	19.457	33.586	M5-1	0.5
76	0	0	0	0	0	0	0.6	2000	19.457	33.586	M5-1	0.5
78	57391	58159	2273778	2215619	57391	0	0.6	2000	19.457	33.586	M5-1	0.5
81	14868	14958	644680	629722	14868	0	0.6	2000	19.457	33.586	M5-1	0.5
84	29235	29526	328455	298929	29235	0	0.6	2000	19.457	33.586	M5-1	0.5
87	4182	4182	52650	48468	4185	3	0.6	2000	19.457	33.586	M5-1	0.5
90	2090	2090	18721	16631	2090	0	0.6	2000	19.457	33.586	M5-1	0.5
12	0	0	0	0	0	0	0.6	2000	3.27	32.587	M3-1	0.5
24	19	19	528	509	20	1	0.6	2000	3.27	32.587	M3-1	0.5
27	1012	1012	3403	2391	1012	0	0.6	2000	3.27	32.587	M3-1	0.5
30	2244	2244	20706	18462	2266	22	0.6	2000	3.27	32.587	M3-1	0.5
33	14453	14843	188191	173348	14453	0	0.6	2000	3.27	32.587	M3-1	0.5
36	7238877	7242680	9894576	2651896	7238881	4	0.6	2000	3.27	32.587	M3-1	0.5
39	263400	263445	2729616	2466171	263400	0	0.6	2000	3.27	32.587	M3-1	0.5
42	35711	35878	2158003	2122125	35836	125	0.6	2000	3.27	32.587	M3-1	0.5
45	55347	56285	3736011	3679726	55350	3	0.6	2000	3.27	32.587	M3-1	0.5
48	728017	728177	10776403	10048226	728027	10	0.6	2000	3.27	32.587	M3-1	0.5
51	443289	443478	10131751	9688273	443296	7	0.6	2000	3.27	32.587	M3-1	0.5
54	102022	102378	5519503	5417125	102027	5	0.6	2000	3.27	32.587	M3-1	0.5
57	99636	99788	4837605	4737817	99927	291	0.6	2000	3.27	32.587	M3-1	0.5
59	0	0	0	0	0	0	0.6	2000	3.27	32.587	M3-1	0.5
60	221502	221616	3573801	3352185	221541	39	0.6	2000	3.27	32.587	M3-1	0.5
62	0	0	0	0	0	0	0.6	2000	3.27	32.587	M3-1	0.5
63	576245	576491	9748320	9171829	576245	0	0.6	2000	3.27	32.587	M3-1	0.5
64	0	0	0	0	0	0	0.6	2000	3.27	32.587	M3-1	0.5
66	293041	293128	2492028	2198900	293041	0	0.6	2000	3.27	32.587	M3-1	0.5
68	10	10	15	5	10	0	0.6	2000	3.27	32.587	M3-1	0.5
69	359721	359725	4045590	3685865	359732	11	0.6	2000	3.27	32.587	M3-1	0.5
72	72649	75317	1553203	1477886	72649	0	0.6	2000	3.27	32.587	M3-1	0.5
75	18352	18352	328455	310103	18354	2	0.6	2000	3.27	32.587	M3-1	0.5
76	0	0	0	0	0	0	0.6	2000	3.27	32.587	M3-1	0.5
78	132571	132572	773146	640574	132571	0	0.6	2000	3.27	32.587	M3-1	0.5
81	5138	5138	36585	31447	5138	0	0.6	2000	3.27	32.587	M3-1	0.5
84	623	623	9730	9107	623	0	0.6	2000	3.27	32.587	M3-1	0.5
87	478	478	6670	6192	478	0	0.6	2000	3.27	32.587	M3-1	0.5
90	294	305	2278	1973	294	0	0.6	2000	3.27	32.587	M3-1	0.5
6	0	0	0	0	0	0	0.6	3000	19.902	53.364	M5-1	0.5
8	3	6	6	0	3	0	0.6	3000	19.902	53.364	M5-1	0.5
9	28	28	28	0	28	0	0.6	3000	19.902	53.364	M5-1	0.5
24	9161	9286	76636	67350	9282	121	0.6	3000	19.902	53.364	M5-1	0.5
27	9928	11312	53956	42644	9928	0	0.6	3000	19.902	53.364	M5-1	0.5
30	84740	84807	512578	427771	84741	1	0.6	3000	19.902	53.364	M5-1	0.5
33	15278	16399	1097421	1081022	15288	10	0.6	3000	19.902	53.364	M5-1	0.5
35	0	0	0	0	0	0	0.6	3000	19.902	53.364	M5-1	0.5
36	38436	38513	3324331	3285818	38468	32	0.6	3000	19.902	53.364	M5-1	0.5
37	0	0	0	0	0	0	0.6	3000	19.902	53.364	M5-1	0.5
39	77192	78081	8914753	8836672	77195	3	0.6	3000	19.902	53.364	M5-1	0.5
40	0	0	0	0	0	0	0.6	3000	19.902	53.364	M5-1	0.5
42	165925	168038	24440536	24272498	166040	115	0.6	3000	19.902	53.364	M5-1	0.5
45	181392	190901	46527481	46336580	181571	179	0.6	3000	19.902	53.364	M5-1	0.5
47	0	0	0	0	0	0	0.6	3000	19.902	53.364	M5-1	0.5
48	424076	430088	84142878	83712790	424571	495	0.6	3000	19.902	53.364	M5-1	0.5
49	0	0	0	0	0	0	0.6	3000	19.902	53.364	M5-1	0.5
51	280272	283513	65259600	64976087	282047	1775	0.6	3000	19.902	53.364	M5-1	0.5
54	392839	394658	62826445	62431787	392946	107	0.6	3000	19.902	53.364	M5-1	0.5
55	1	1	1	0	1	0	0.6	3000	19.902	53.364	M5-1	0.5
57	400340	402140	60077241	59675101	400562	222	0.6	3000	19.902	53.364	M5-1	0.5
58	0	0	0	0	0	0	0.6	3000	19.902	53.364	M5-1	0.5
59	0	0	0	0	0	0	0.6	3000	19.902	53.364	M5-1	0.5
60	138715	141584	42878430	42736846	139023	308	0.6	3000	19.902	53.364	M5-1	0.5
61	0	1	1	0	0	0	0.6	3000	19.902	53.364	M5-1	0.5
62	3	3	6	3	3	0	0.6	3000	19.902	53.364	M5-1	0.5
63	282571	283443	33020001	32736558	282634	63	0.6	3000	19.902	53.364	M5-1	0.5
64	0	0	0	0	0	0	0.6	3000	19.902	53.364	M5-1	0.5
66	145514	146922	23225520	23078598	145514	0	0.6	3000	19.902	53.364	M5-1	0.5
69	209870	210783	17877210	17666427	209905	35	0.6	3000	19.902	53.364	M5-1	0.5
72	197745	198785	11005086	10806301	197959	214	0.6	3000	19.902	53.364	M5-1	0.5
75	27238	27401	2809635	2782234	27242	4	0.6	3000	19.902	53.364	M5-1	0.5
76	0	0	0	0	0	0	0.6	3000	19.902	53.364	M5-1	0.5
78	57391	58159	2273778	2215619	57391	0	0.6	3000	19.902	53.364	M5-1	0.5
81	14868	14958	644680	629722	14868	0	0.6	3000	19.902	53.364	M5-1	0.5
84	29235	29526	328455	298929	29235	0	0.6	3000	19.902	53.364	M5-1	0.5
87	4182	4182	52650	48468	4185	3	0.6	3000	19.902	53.364	M5-1	0.5
90	2090	2090	18721	16631	2090	0	0.6	3000	19.902	53.364	M5-1	0.5
3	0	0	0	0	0	0	0.6	3000	25.714	67.434	M2-1	0.5
12	1	1	1	0	1	0	0.6	3000	25.714	67.434	M2-1	0.5
15	0	0	0	0	0	0	0.6	3000	25.714	67.434	M2-1	0.5
24	80	80	17391	17311	132	52	0.6	3000	25.714	67.434	M2-1	0.5
27	58	58	20706	20648	65	7	0.6	3000	25.714	67.434	M2-1	0.5
30	316	317	102831	102514	326	10	0.6	3000	25.714	67.434	M2-1	0.5
33	760	781	571915	571134	808	48	0.6	3000	25.714	67.434	M2-1	0.5
36	1513	1518	1530375	1528857	1626	113	0.6	3000	25.714	67.434	M2-1	0.5
39	13374	13402	4501500	4488098	13454	80	0.6	3000	25.714	67.434	M2-1	0.5
41	0	0	0	0	0	0	0.6	3000	25.714	67.434	M2-1	0.5
42	28486	28588	10010575	9981987	28725	239	0.6	3000	25.714	67.434	M2-1	0.5
43	0	0	1	1	0	0	0.6	3000	25.714	67.434	M2-1	0.5
45	14838	15621	16522626	16507005	15079	241	0.6	3000	25.714	67.434	M2-1	0.5
46	0	0	1	1	0	0	0.6	3000	25.714	67.434	M2-1	0.5
48	32137	32345	24398605	24366260	32345	208	0.6	3000	25.714	67.434	M2-1	0.5
51	13967	14167	23988201	23974034	14271	304	0.6	3000	25.714	67.434	M2-1	0.5
52	0	0	0	0	0	0	0.6	3000	25.714	67.434	M2-1	0.5
54	33934	34863	24217320	24182457	34092	158	0.6	3000	25.714	67.434	M2-1	0.5
55	0	0	0	0	0	0	0.6	3000	25.714	67.434	M2-1	0.5
57	28314	28771	23932821	23904050	29174	860	0.6	3000	25.714	67.434	M2-1	0.5
58	0	0	0	0	0	0	0.6	3000	25.714	67.434	M2-1	0.5
59	0	0	1	1	0	0	0.6	3000	25.714	67.434	M2-1	0.5
60	13941	14059	16869336	16855277	14021	80	0.6	3000	25.714	67.434	M2-1	0.5
61	0	0	0	0	0	0	0.6	3000	25.714	67.434	M2-1	0.5
62	0	0	0	0	0	0	0.6	3000	25.714	67.434	M2-1	0.5
63	19815	19873	11608971	11589098	19878	63	0.6	3000	25.714	67.434	M2-1	0.5
64	0	0	0	0	0	0	0.6	3000	25.714	67.434	M2-1	0.5
66	42504	42563	7755891	7713328	42518	14	0.6	3000	25.714	67.434	M2-1	0.5
68	0	0	0	0	0	0	0.6	3000	25.714	67.434	M2-1	0.5
69	2709	2772	4928230	4925458	2756	47	0.6	3000	25.714	67.434	M2-1	0.5
72	2708	2716	2248260	2245544	2739	31	0.6	3000	25.714	67.434	M2-1	0.5
73	0	0	1	1	0	0	0.6	3000	25.714	67.434	M2-1	0.5
75	166295	166303	2494261	2327958	166302	7	0.6	3000	25.714	67.434	M2-1	0.5
78	606	617	541320	540703	626	20	0.6	3000	25.714	67.434	M2-1	0.5
81	18083	18097	402753	384656	18083	0	0.6	3000	25.714	67.434	M2-1	0.5
84	295	296	95703	95407	295	0	0.6	3000	25.714	67.434	M2-1	0.5
87	93	102	20100	19998	93	0	0.6	3000	25.714	67.434	M2-1	0.5
90	2	2	9045	9043	2	0	0.6	3000	25.714	67.434	M2-1	0.5
12	0	0	0	0	0	0	0.6	3000	4.752	31.888	M3-1	0.5
24	19	19	528	509	20	1	0.6	3000	4.752	31.888	M3-1	0.5
27	1012	1012	3403	2391	1012	0	0.6	3000	4.752	31.888	M3-1	0.5
30	2244	2244	20706	18462	2266	22	0.6	3000	4.752	31.888	M3-1	0.5
33	14453	14843	188191	173348	14453	0	0.6	3000	4.752	31.888	M3-1	0.5
36	7238877	7242680	9894576	2651896	7238881	4	0.6	3000	4.752	31.888	M3-1	0.5
39	263400	263445	2729616	2466171	263400	0	0.6	3000	4.752	31.888	M3-1	0.5
42	35711	35878	2158003	2122125	35836	125	0.6	3000	4.752	31.888	M3-1	0.5
45	55347	56285	3736011	3679726	55350	3	0.6	3000	4.752	31.888	M3-1	0.5
48	728017	728177	10776403	10048226	728027	10	0.6	3000	4.752	31.888	M3-1	0.5
51	443289	443478	10131751	9688273	443296	7	0.6	3000	4.752	31.888	M3-1	0.5
54	102022	102378	5519503	5417125	102027	5	0.6	3000	4.752	31.888	M3-1	0.5
57	99636	99788	4837605	4737817	99927	291	0.6	3000	4.752	31.888	M3-1	0.5
59	0	0	0	0	0	0	0.6	3000	4.752	31.888	M3-1	0.5
60	221502	221616	3573801	3352185	221541	39	0.6	3000	4.752	31.888	M3-1	0.5
62	0	0	0	0	0	0	0.6	3000	4.752	31.888	M3-1	0.5
63	576245	576491	9748320	9171829	576245	0	0.6	3000	4.752	31.888	M3-1	0.5
64	0	0	0	0	0	0	0.6	3000	4.752	31.888	M3-1	0.5
66	293041	293128	2492028	2198900	293041	0	0.6	3000	4.752	31.888	M3-1	0.5
68	10	10	15	5	10	0	0.6	3000	4.752	31.888	M3-1	0.5
69	359721	359725	4045590	3685865	359732	11	0.6	3000	4.752	31.888	M3-1	0.5
72	72649	75317	1553203	1477886	72649	0	0.6	3000	4.752	31.888	M3-1	0.5
75	18352	18352	328455	310103	18354	2	0.6	3000	4.752	31.888	M3-1	0.5
76	0	0	0	0	0	0	0.6	3000	4.752	31.888	M3-1	0.5
78	132571	132572	773146	640574	132571	0	0.6	3000	4.752	31.888	M3-1	0.5
81	5138	5138	36585	31447	5138	0	0.6	3000	4.752	31.888	M3-1	0.5
84	623	623	9730	9107	623	0	0.6	3000	4.752	31.888	M3-1	0.5
87	478	478	6670	6192	478	0	0.6	3000	4.752	31.888	M3-1	0.5
90	294	305	2278	1973	294	0	0.6	3000	4.752	31.888	M3-1	0.5
3	0	0	0	0	0	0	0.6	3000	5.903	71.851	M4-1	0.5
6	0	0	0	0	0	0	0.6	3000	5.903	71.851	M4-1	0.5
24	73	75	3570	3495	73	0	0.6	3000	5.903	71.851	M4-1	0.5
27	6507	6507	43071	36564	6513	6	0.6	3000	5.903	71.851	M4-1	0.5
30	709	716	40755	40039	714	5	0.6	3000	5.903	71.851	M4-1	0.5
33	33957	33984	424581	390597	33957	0	0.6	3000	5.903	71.851	M4-1	0.5
36	4978	4979	458403	453424	4984	6	0.6	3000	5.903	71.851	M4-1	0.5
39	222875	234607	6813586	6578979	222894	19	0.6	3000	5.903	71.851	M4-1	0.5
41	0	0	0	0	0	0	0.6	3000	5.903	71.851	M4-1	0.5
42	74372	74965	8559453	8484488	75520	1148	0.6	3000	5.903	71.851	M4-1	0.5
45	274768	274902	18638565	18363663	274789	21	0.6	3000	5.903	71.851	M4-1	0.5
47	0	0	0	0	0	0	0.6	3000	5.903	71.851	M4-1	0.5
48	210917	212334	24981846	24769512	211324	407	0.6	3000	5.903	71.851	M4-1	0.5
49	0	0	0	0	0	0	0.6	3000	5.903	71.851	M4-1	0.5
50	10	10	15	5	10	0	0.6	3000	5.903	71.851	M4-1	0.5
51	268213	270020	34283340	34013320	268345	132	0.6	3000	5.903	71.851	M4-1	0.5
52	0	0	0	0	0	0	0.6	3000	5.903	71.851	M4-1	0.5
53	0	0	1	1	0	0	0.6	3000	5.903	71.851	M4-1	0.5
54	249358	257003	26335653	26078650	249378	20	0.6	3000	5.903	71.851	M4-1	0.5
56	55	55	55	0	55	0	0.6	3000	5.903	71.851	M4-1	0.5
57	91948	92998	17307786	17214788	91964	16	0.6	3000	5.903	71.851	M4-1	0.5
58	0	0	0	0	0	0	0.6	3000	5.903	71.851	M4-1	0.5
60	172947	174264	15354111	15179847	172948	1	0.6	3000	5.903	71.851	M4-1	0.5
63	89734	90130	11987856	11897726	89788	54	0.6	3000	5.903	71.851	M4-1	0.5
65	0	0	0	0	0	0	0.6	3000	5.903	71.851	M4-1	0.5
66	189006	189660	8704878	8515218	189008	2	0.6	3000	5.903	71.851	M4-1	0.5
67	0	0	0	0	0	0	0.6	3000	5.903	71.851	M4-1	0.5
69	148691	148774	7634278	7485504	148697	6	0.6	3000	5.903	71.851	M4-1	0.5
72	1448204	1449473	11493615	10044142	1448209	5	0.6	3000	5.903	71.851	M4-1	0.5
73	1	1	1	0	1	0	0.6	3000	5.903	71.851	M4-1	0.5
75	18218	18309	962578	944269	18218	0	0.6	3000	5.903	71.851	M4-1	0.5
78	12180	12247	451725	439478	12180	0	0.6	3000	5.903	71.851	M4-1	0.5
81	1988	2002	126756	124754	1988	0	0.6	3000	5.903	71.851	M4-1	0.5
84	5572	5573	52650	47077	5572	0	0.6	3000	5.903	71.851	M4-1	0.5
87	620	621	12403	11782	620	0	0.6	3000	5.903	71.851	M4-1	0.5
90	218	233	4753	4520	218	0	0.6	3000	5.903	71.851	M4-1	0.5
6	0	0	0	0	0	0	0.6	4000	12.486	90.68	M5-1	0.5
8	3	6	6	0	3	0	0.6	4000	12.486	90.68	M5-1	0.5
9	28	28	28	0	28	0	0.6	4000	12.486	90.68	M5-1	0.5
24	9161	9286	76636	67350	9282	121	0.6	4000	12.486	90.68	M5-1	0.5
27	9928	11312	53956	42644	9928	0	0.6	4000	12.486	90.68	M5-1	0.5
30	84740	84807	512578	427771	84741	1	0.6	4000	12.486	90.68	M5-1	0.5
33	15278	16399	1097421	1081022	15288	10	0.6	4000	12.486	90.68	M5-1	0.5
35	0	0	0	0	0	0	0.6	4000	12.486	90.68	M5-1	0.5
36	38436	38513	3324331	3285818	38468	32	0.6	4000	12.486	90.68	M5-1	0.5
37	0	0	0	0	0	0	0.6	4000	12.486	90.68	M5-1	0.5
39	77192	78081	8914753	8836672	77195	3	0.6	4000	12.486	90.68	M5-1	0.5
40	0	0	0	0	0	0	0.6	4000	12.486	90.68	M5-1	0.5
42	167924	168038	24440536	24272498	168342	418	0.6	4000	12.486	90.68	M5-1	0.5
45	181392	190901	46527481	46336580	181571	179	0.6	4000	12.486	90.68	M5-1	0.5
47	0	0	0	0	0	0	0.6	4000	12.486	90.68	M5-1	0.5
48	424076	430088	84142878	83712790	424571	495	0.6	4000	12.486	90.68	M5-1	0.5
49	0	0	0	0	0	0	0.6	4000	12.486	90.68	M5-1	0.5
51	280272	283513	65259600	64976087	282047	1775	0.6	4000	12.486	90.68	M5-1	0.5
54	392839	394658	62826445	62431787	392946	107	0.6	4000	12.486	90.68	M5-1	0.5
55	1	1	1	0	1	0	0.6	4000	12.486	90.68	M5-1	0.5
57	400340	402140	60077241	59675101	400562	222	0.6	4000	12.486	90.68	M5-1	0.5
58	0	0	0	0	0	0	0.6	4000	12.486	90.68	M5-1	0.5
59	0	0	0	0	0	0	0.6	4000	12.486	90.68	M5-1	0.5
60	138715	141584	42878430	42736846	139023	308	0.6	4000	12.486	90.68	M5-1	0.5
61	0	1	1	0	0	0	0.6	4000	12.486	90.68	M5-1	0.5
62	3	3	6	3	3	0	0.6	4000	12.486	90.68	M5-1	0.5
63	282571	283443	33020001	32736558	282634	63	0.6	4000	12.486	90.68	M5-1	0.5
64	0	0	0	0	0	0	0.6	4000	12.486	90.68	M5-1	0.5
66	145574	146922	23225520	23078598	145574	0	0.6	4000	12.486	90.68	M5-1	0.5
69	210440	210783	17877210	17666427	210476	36	0.6	4000	12.486	90.68	M5-1	0.5
72	197745	198785	11005086	10806301	197959	214	0.6	4000	12.486	90.68	M5-1	0.5
75	27238	27401	2809635	2782234	27242	4	0.6	4000	12.486	90.68	M5-1	0.5
76	0	0	0	0	0	0	0.6	4000	12.486	90.68	M5-1	0.5
78	57391	58159	2273778	2215619	57391	0	0.6	4000	12.486	90.68	M5-1	0.5
81	14868	14958	644680	629722	14868	0	0.6	4000	12.486	90.68	M5-1	0.5
84	29235	29526	328455	298929	29235	0	0.6	4000	12.486	90.68	M5-1	0.5
87	4182	4182	52650	48468	4185	3	0.6	4000	12.486	90.68	M5-1	0.5
90	2090	2090	18721	16631	2090	0	0.6	4000	12.486	90.68	M5-1	0.5
3	0	0	0	0	0	0	0.6	4000	15.401	89.063	M2-1	0.5
12	1	1	1	0	1	0	0.6	4000	15.401	89.063	M2-1	0.5
15	0	0	0	0	0	0	0.6	4000	15.401	89.063	M2-1	0.5
24	80	80	17391	17311	132	52	0.6	4000	15.401	89.063	M2-1	0.5
27	58	58	20706	20648	65	7	0.6	4000	15.401	89.063	M2-1	0.5
30	316	317	102831	102514	326	10	0.6	4000	15.401	89.063	M2-1	0.5
33	760	781	571915	571134	808	48	0.6	4000	15.401	89.063	M2-1	0.5
36	1513	1518	1530375	1528857	1626	113	0.6	4000	15.401	89.063	M2-1	0.5
39	13374	13402	4501500	4488098	13454	80	0.6	4000	15.401	89.063	M2-1	0.5
41	0	0	0	0	0	0	0.6	4000	15.401	89.063	M2-1	0.5
42	28574	28588	10010575	9981987	29028	454	0.6	4000	15.401	89.063	M2-1	0.5
43	0	0	1	1	0	0	0.6	4000	15.401	89.063	M2-1	0.5
45	14838	15621	16522626	16507005	15079	241	0.6	4000	15.401	89.063	M2-1	0.5
46	0	0	1	1	0	0	0.6	4000	15.401	89.063	M2-1	0.5
48	32137	32345	24398605	24366260	32345	208	0.6	4000	15.401	89.063	M2-1	0.5
51	13967	14167	23988201	23974034	14271	304	0.6	4000	15.401	89.063	M2-1	0.5
52	0	0	0	0	0	0	0.6	4000	15.401	89.063	M2-1	0.5
54	33934	34863	24217320	24182457	34092	158	0.6	4000	15.401	89.063	M2-1	0.5
55	0	0	0	0	0	0	0.6	4000	15.401	89.063	M2-1	0.5
57	28314	28771	23932821	23904050	29174	860	0.6	4000	15.401	89.063	M2-1	0.5
58	0	0	0	0	0	0	0.6	4000	15.401	89.063	M2-1	0.5
59	0	0	1	1	0	0	0.6	4000	15.401	89.063	M2-1	0.5
60	13941	14059	16869336	16855277	14021	80	0.6	4000	15.401	89.063	M2-1	0.5
61	0	0	0	0	0	0	0.6	4000	15.401	89.063	M2-1	0.5
62	0	0	0	0	0	0	0.6	4000	15.401	89.063	M2-1	0.5
63	19815	19873	11608971	11589098	19878	63	0.6	4000	15.401	89.063	M2-1	0.5
64	0	0	0	0	0	0	0.6	4000	15.401	89.063	M2-1	0.5
66	42511	42563	7755891	7713328	42534	23	0.6	4000	15.401	89.063	M2-1	0.5
68	0	0	0	0	0	0	0.6	4000	15.401	89.063	M2-1	0.5
69	2709	2772	4928230	4925458	2756	47	0.6	4000	15.401	89.063	M2-1	0.5
72	2708	2716	2248260	2245544	2739	31	0.6	4000	15.401	89.063	M2-1	0.5
73	0	0	1	1	0	0	0.6	4000	15.401	89.063	M2-1	0.5
75	166295	166303	2494261	2327958	166302	7	0.6	4000	15.401	89.063	M2-1	0.5
78	606	617	541320	540703	626	20	0.6	4000	15.401	89.063	M2-1	0.5
81	18083	18097	402753	384656	18083	0	0.6	4000	15.401	89.063	M2-1	0.5
84	295	296	95703	95407	295	0	0.6	4000	15.401	89.063	M2-1	0.5
87	93	102	20100	19998	93	0	0.6	4000	15.401	89.063	M2-1	0.5
90	2	2	9045	9043	2	0	0.6	4000	15.401	89.063	M2-1	0.5
3	0	0	0	0	0	0	0.6	4000	3.49	112.053	M4-1	0.5
6	0	0	0	0	0	0	0.6	4000	3.49	112.053	M4-1	0.5
24	73	75	3570	3495	73	0	0.6	4000	3.49	112.053	M4-1	0.5
27	6507	6507	43071	36564	6513	6	0.6	4000	3.49	112.053	M4-1	0.5
30	709	716	40755	40039	714	5	0.6	4000	3.49	112.053	M4-1	0.5
33	33957	33984	424581	390597	33957	0	0.6	4000	3.49	112.053	M4-1	0.5
36	4978	4979	458403	453424	4984	6	0.6	4000	3.49	112.053	M4-1	0.5
39	222875	234607	6813586	6578979	222894	19	0.6	4000	3.49	112.053	M4-1	0.5
41	0	0	0	0	0	0	0.6	4000	3.49	112.053	M4-1	0.5
42	74372	74965	8559453	8484488	75520	1148	0.6	4000	3.49	112.053	M4-1	0.5
45	274768	274902	18638565	18363663	274789	21	0.6	4000	3.49	112.053	M4-1	0.5
47	0	0	0	0	0	0	0.6	4000	3.49	112.053	M4-1	0.5
48	211115	212334	24981846	24769512	211523	408	0.6	4000	3.49	112.053	M4-1	0.5
49	0	0	0	0	0	0	0.6	4000	3.49	112.053	M4-1	0.5
50	10	10	15	5	10	0	0.6	4000	3.49	112.053	M4-1	0.5
51	268325	270020	34283340	34013320	268475	150	0.6	4000	3.49	112.053	M4-1	0.5
52	0	0	0	0	0	0	0.6	4000	3.49	112.053	M4-1	0.5
53	0	0	1	1	0	0	0.6	4000	3.49	112.053	M4-1	0.5
54	249528	257003	26335653	26078650	249548	20	0.6	4000	3.49	112.053	M4-1	0.5
56	55	55	55	0	55	0	0.6	4000	3.49	112.053	M4-1	0.5
57	92014	92998	17307786	17214788	92040	26	0.6	4000	3.49	112.053	M4-1	0.5
58	0	0	0	0	0	0	0.6	4000	3.49	112.053	M4-1	0.5
60	172947	174264	15354111	15179847	172948	1	0.6	4000	3.49	112.053	M4-1	0.5
63	89734	90130	11987856	11897726	89788	54	0.6	4000	3.49	112.053	M4-1	0.5
65	0	0	0	0	0	0	0.6	4000	3.49	112.053	M4-1	0.5
66	189006	189660	8704878	8515218	189008	2	0.6	4000	3.49	112.053	M4-1	0.5
67	0	0	0	0	0	0	0.6	4000	3.49	112.053	M4-1	0.5
69	148691	148774	7634278	7485504	148697	6	0.6	4000	3.49	112.053	M4-1	0.5
72	1448204	1449473	11493615	10044142	1448209	5	0.6	4000	3.49	112.053	M4-1	0.5
73	1	1	1	0	1	0	0.6	4000	3.49	112.053	M4-1	0.5
75	18218	18309	962578	944269	18218	0	0.6	4000	3.49	112.053	M4-1	0.5
78	12180	12247	451725	439478	12180	0	0.6	4000	3.49	112.053	M4-1	0.5
81	1988	2002	126756	124754	1988	0	0.6	4000	3.49	112.053	M4-1	0.5
84	5572	5573	52650	47077	5572	0	0.6	4000	3.49	112.053	M4-1	0.5
87	620	621	12403	11782	620	0	0.6	4000	3.49	112.053	M4-1	0.5
90	218	233	4753	4520	218	0	0.6	4000	3.49	112.053	M4-1	0.5
12	0	0	0	0	0	0	0.6	4000	3.514	28.392	M3-1	0.5
24	19	19	528	509	20	1	0.6	4000	3.514	28.392	M3-1	0.5
27	1012	1012	3403	2391	1012	0	0.6	4000	3.514	28.392	M3-1	0.5
30	2244	2244	20706	18462	2266	22	0.6	4000	3.514	28.392	M3-1	0.5
33	14453	14843	188191	173348	14453	0	0.6	4000	3.514	28.392	M3-1	0.5
36	7238877	7242680	9894576	2651896	7238881	4	0.6	4000	3.514	28.392	M3-1	0.5
39	263400	263445	2729616	2466171	263400	0	0.6	4000	3.514	28.392	M3-1	0.5
42	35711	35878	2158003	2122125	35836	125	0.6	4000	3.514	28.392	M3-1	0.5
45	55347	56285	3736011	3679726	55350	3	0.6	4000	3.514	28.392	M3-1	0.5
48	728017	728177	10776403	10048226	728027	10	0.6	4000	3.514	28.392	M3-1	0.5
51	443289	443478	10131751	9688273	443296	7	0.6	4000	3.514	28.392	M3-1	0.5
54	102022	102378	5519503	5417125	102027	5	0.6	4000	3.514	28.392	M3-1	0.5
57	99636	99788	4837605	4737817	99927	291	0.6	4000	3.514	28.392	M3-1	0.5
59	0	0	0	0	0	0	0.6	4000	3.514	28.392	M3-1	0.5
60	221502	221616	3573801	3352185	221541	39	0.6	4000	3.514	28.392	M3-1	0.5
62	0	0	0	0	0	0	0.6	4000	3.514	28.392	M3-1	0.5
63	576245	576491	9748320	9171829	576245	0	0.6	4000	3.514	28.392	M3-1	0.5
64	0	0	0	0	0	0	0.6	4000	3.514	28.392	M3-1	0.5
66	293041	293128	2492028	2198900	293041	0	0.6	4000	3.514	28.392	M3-1	0.5
68	10	10	15	5	10	0	0.6	4000	3.514	28.392	M3-1	0.5
69	359721	359725	4045590	3685865	359732	11	0.6	4000	3.514	28.392	M3-1	0.5
72	72649	75317	1553203	1477886	72649	0	0.6	4000	3.514	28.392	M3-1	0.5
75	18352	18352	328455	310103	18354	2	0.6	4000	3.514	28.392	M3-1	0.5
76	0	0	0	0	0	0	0.6	4000	3.514	28.392	M3-1	0.5
78	132571	132572	773146	640574	132571	0	0.6	4000	3.514	28.392	M3-1	0.5
81	5138	5138	36585	31447	5138	0	0.6	4000	3.514	28.392	M3-1	0.5
84	623	623	9730	9107	623	0	0.6	4000	3.514	28.392	M3-1	0.5
87	478	478	6670	6192	478	0	0.6	4000	3.514	28.392	M3-1	0.5
90	294	305	2278	1973	294	0	0.6	4000	3.514	28.392	M3-1	0.5
3	0	0	0	0	0	0	0.6	5000	1.648	99.126	M4-1	0.5
6	0	0	0	0	0	0	0.6	5000	1.648	99.126	M4-1	0.5
24	73	75	3570	3495	73	0	0.6	5000	1.648	99.126	M4-1	0.5
27	6507	6507	43071	36564	6513	6	0.6	5000	1.648	99.126	M4-1	0.5
30	709	716	40755	40039	714	5	0.6	5000	1.648	99.126	M4-1	0.5
33	33957	33984	424581	390597	33957	0	0.6	5000	1.648	99.126	M4-1	0.5
36	4978	4979	458403	453424	4984	6	0.6	5000	1.648	99.126	M4-1	0.5
39	222875	234607	6813586	6578979	222894	19	0.6	5000	1.648	99.126	M4-1	0.5
41	0	0	0	0	0	0	0.6	5000	1.648	99.126	M4-1	0.5
42	74372	74965	8559453	8484488	75520	1148	0.6	5000	1.648	99.126	M4-1	0.5
45	274768	274902	18638565	18363663	274789	21	0.6	5000	1.648	99.126	M4-1	0.5
47	0	0	0	0	0	0	0.6	5000	1.648	99.126	M4-1	0.5
48	211115	212334	24981846	24769512	211523	408	0.6	5000	1.648	99.126	M4-1	0.5
49	0	0	0	0	0	0	0.6	5000	1.648	99.126	M4-1	0.5
50	10	10	15	5	10	0	0.6	5000	1.648	99.126	M4-1	0.5
51	268325	270020	34283340	34013320	268475	150	0.6	5000	1.648	99.126	M4-1	0.5
52	0	0	0	0	0	0	0.6	5000	1.648	99.126	M4-1	0.5
53	0	0	1	1	0	0	0.6	5000	1.648	99.126	M4-1	0.5
54	249528	257003	26335653	26078650	249548	20	0.6	5000	1.648	99.126	M4-1	0.5
56	55	55	55	0	55	0	0.6	5000	1.648	99.126	M4-1	0.5
57	92014	92998	17307786	17214788	92040	26	0.6	5000	1.648	99.126	M4-1	0.5
58	0	0	0	0	0	0	0.6	5000	1.648	99.126	M4-1	0.5
60	172947	174264	15354111	15179847	172948	1	0.6	5000	1.648	99.126	M4-1	0.5
63	89734	90130	11987856	11897726	89788	54	0.6	5000	1.648	99.126	M4-1	0.5
65	0	0	0	0	0	0	0.6	5000	1.648	99.126	M4-1	0.5
66	189006	189660	8704878	8515218	189008	2	0.6	5000	1.648	99.126	M4-1	0.5
67	0	0	0	0	0	0	0.6	5000	1.648	99.126	M4-1	0.5
69	148691	148774	7634278	7485504	148697	6	0.6	5000	1.648	99.126	M4-1	0.5
72	1448204	1449473	11493615	10044142	1448209	5	0.6	5000	1.648	99.126	M4-1	0.5
73	1	1	1	0	1	0	0.6	5000	1.648	99.126	M4-1	0.5
75	18218	18309	962578	944269	18218	0	0.6	5000	1.648	99.126	M4-1	0.5
78	12180	12247	451725	439478	12180	0	0.6	5000	1.648	99.126	M4-1	0.5
81	1988	2002	126756	124754	1988	0	0.6	5000	1.648	99.126	M4-1	0.5
84	5572	5573	52650	47077	5572	0	0.6	5000	1.648	99.126	M4-1	0.5
87	620	621	12403	11782	620	0	0.6	5000	1.648	99.126	M4-1	0.5
90	218	233	4753	4520	218	0	0.6	5000	1.648	99.126	M4-1	0.5
3	0	0	0	0	0	0	0.6	5000	14.043	124.928	M2-1	0.5
12	1	1	1	0	1	0	0.6	5000	14.043	124.928	M2-1	0.5
15	0	0	0	0	0	0	0.6	5000	14.043	124.928	M2-1	0.5
24	80	80	17391	17311	132	52	0.6	5000	14.043	124.928	M2-1	0.5
27	58	58	20706	20648	65	7	0.6	5000	14.043	124.928	M2-1	0.5
30	316	317	102831	102514	326	10	0.6	5000	14.043	124.928	M2-1	0.5
33	760	781	571915	571134	808	48	0.6	5000	14.043	124.928	M2-1	0.5
36	1513	1518	1530375	1528857	1626	113	0.6	5000	14.043	124.928	M2-1	0.5
39	13374	13402	4501500	4488098	13454	80	0.6	5000	14.043	124.928	M2-1	0.5
41	0	0	0	0	0	0	0.6	5000	14.043	124.928	M2-1	0.5
42	28574	28588	10010575	9981987	29028	454	0.6	5000	14.043	124.928	M2-1	0.5
43	0	0	1	1	0	0	0.6	5000	14.043	124.928	M2-1	0.5
45	15556	15621	16522626	16507005	15908	352	0.6	5000	14.043	124.928	M2-1	0.5
46	0	0	1	1	0	0	0.6	5000	14.043	124.928	M2-1	0.5
48	32137	32345	24398605	24366260	32345	208	0.6	5000	14.043	124.928	M2-1	0.5
51	13967	14167	23988201	23974034	14271	304	0.6	5000	14.043	124.928	M2-1	0.5
52	0	0	0	0	0	0	0.6	5000	14.043	124.928	M2-1	0.5
54	33934	34863	24217320	24182457	34092	158	0.6	5000	14.043	124.928	M2-1	0.5
55	0	0	0	0	0	0	0.6	5000	14.043	124.928	M2-1	0.5
57	28314	28771	23932821	23904050	29174	860	0.6	5000	14.043	124.928	M2-1	0.5
58	0	0	0	0	0	0	0.6	5000	14.043	124.928	M2-1	0.5
59	0	0	1	1	0	0	0.6	5000	14.043	124.928	M2-1	0.5
60	13941	14059	16869336	16855277	14021	80	0.6	5000	14.043	124.928	M2-1	0.5
61	0	0	0	0	0	0	0.6	5000	14.043	124.928	M2-1	0.5
62	0	0	0	0	0	0	0.6	5000	14.043	124.928	M2-1	0.5
63	19819	19873	11608971	11589098	19919	100	0.6	5000	14.043	124.928	M2-1	0.5
64	0	0	0	0	0	0	0.6	5000	14.043	124.928	M2-1	0.5
66	42511	42563	7755891	7713328	42534	23	0.6	5000	14.043	124.928	M2-1	0.5
68	0	0	0	0	0	0	0.6	5000	14.043	124.928	M2-1	0.5
69	2709	2772	4928230	4925458	2756	47	0.6	5000	14.043	124.928	M2-1	0.5
72	2708	2716	2248260	2245544	2739	31	0.6	5000	14.043	124.928	M2-1	0.5
73	0	0	1	1	0	0	0.6	5000	14.043	124.928	M2-1	0.5
75	166295	166303	2494261	2327958	166302	7	0.6	5000	14.043	124.928	M2-1	0.5
78	606	617	541320	540703	626	20	0.6	5000	14.043	124.928	M2-1	0.5
81	18083	18097	402753	384656	18083	0	0.6	5000	14.043	124.928	M2-1	0.5
84	295	296	95703	95407	295	0	0.6	5000	14.043	124.928	M2-1	0.5
87	93	102	20100	19998	93	0	0.6	5000	14.043	124.928	M2-1	0.5
90	2	2	9045	9043	2	0	0.6	5000	14.043	124.928	M2-1	0.5
12	0	0	0	0	0	0	0.6	5000	2.973	29.525	M3-1	0.5
24	19	19	528	509	20	1	0.6	5000	2.973	29.525	M3-1	0.5
27	1012	1012	3403	2391	1012	0	0.6	5000	2.973	29.525	M3-1	0.5
30	2244	2244	20706	18462	2266	22	0.6	5000	2.973	29.525	M3-1	0.5
33	14453	14843	188191	173348	14453	0	0.6	5000	2.973	29.525	M3-1	0.5
36	7238877	7242680	9894576	2651896	7238881	4	0.6	5000	2.973	29.525	M3-1	0.5
39	263400	263445	2729616	2466171	263400	0	0.6	5000	2.973	29.525	M3-1	0.5
42	35711	35878	2158003	2122125	35836	125	0.6	5000	2.973	29.525	M3-1	0.5
45	55347	56285	3736011	3679726	55350	3	0.6	5000	2.973	29.525	M3-1	0.5
48	728017	728177	10776403	10048226	728027	10	0.6	5000	2.973	29.525	M3-1	0.5
51	443289	443478	10131751	9688273	443296	7	0.6	5000	2.973	29.525	M3-1	0.5
54	102022	102378	5519503	5417125	102027	5	0.6	5000	2.973	29.525	M3-1	0.5
57	99636	99788	4837605	4737817	99927	291	0.6	5000	2.973	29.525	M3-1	0.5
59	0	0	0	0	0	0	0.6	5000	2.973	29.525	M3-1	0.5
60	221502	221616	3573801	3352185	221541	39	0.6	5000	2.973	29.525	M3-1	0.5
62	0	0	0	0	0	0	0.6	5000	2.973	29.525	M3-1	0.5
63	576245	576491	9748320	9171829	576245	0	0.6	5000	2.973	29.525	M3-1	0.5
64	0	0	0	0	0	0	0.6	5000	2.973	29.525	M3-1	0.5
66	293041	293128	2492028	2198900	293041	0	0.6	5000	2.973	29.525	M3-1	0.5
68	10	10	15	5	10	0	0.6	5000	2.973	29.525	M3-1	0.5
69	359721	359725	4045590	3685865	359732	11	0.6	5000	2.973	29.525	M3-1	0.5
72	72649	75317	1553203	1477886	72649	0	0.6	5000	2.973	29.525	M3-1	0.5
75	18352	18352	328455	310103	18354	2	0.6	5000	2.973	29.525	M3-1	0.5
76	0	0	0	0	0	0	0.6	5000	2.973	29.525	M3-1	0.5
78	132571	132572	773146	640574	132571	0	0.6	5000	2.973	29.525	M3-1	0.5
81	5138	5138	36585	31447	5138	0	0.6	5000	2.973	29.525	M3-1	0.5
84	623	623	9730	9107	623	0	0.6	5000	2.973	29.525	M3-1	0.5
87	478	478	6670	6192	478	0	0.6	5000	2.973	29.525	M3-1	0.5
90	294	305	2278	1973	294	0	0.6	5000	2.973	29.525	M3-1	0.5
6	0	0	0	0	0	0	0.6	5000	9.003	119.896	M5-1	0.5
8	3	6	6	0	3	0	0.6	5000	9.003	119.896	M5-1	0.5
9	28	28	28	0	28	0	0.6	5000	9.003	119.896	M5-1	0.5
24	9161	9286	76636	67350	9282	121	0.6	5000	9.003	119.896	M5-1	0.5
27	9928	11312	53956	42644	9928	0	0.6	5000	9.003	119.896	M5-1	0.5
30	84740	84807	512578	427771	84741	1	0.6	5000	9.003	119.896	M5-1	0.5
33	15278	16399	1097421	1081022	15288	10	0.6	5000	9.003	119.896	M5-1	0.5
35	0	0	0	0	0	0	0.6	5000	9.003	119.896	M5-1	0.5
36	38436	38513	3324331	3285818	38468	32	0.6	5000	9.003	119.896	M5-1	0.5
37	0	0	0	0	0	0	0.6	5000	9.003	119.896	M5-1	0.5
39	77192	78081	8914753	8836672	77195	3	0.6	5000	9.003	119.896	M5-1	0.5
40	0	0	0	0	0	0	0.6	5000	9.003	119.896	M5-1	0.5
42	167924	168038	24440536	24272498	168342	418	0.6	5000	9.003	119.896	M5-1	0.5
45	190403	190901	46527481	46336580	190700	297	0.6	5000	9.003	119.896	M5-1	0.5
47	0	0	0	0	0	0	0.6	5000	9.003	119.896	M5-1	0.5
48	424076	430088	84142878	83712790	424571	495	0.6	5000	9.003	119.896	M5-1	0.5
49	0	0	0	0	0	0	0.6	5000	9.003	119.896	M5-1	0.5
51	280272	283513	65259600	64976087	282047	1775	0.6	5000	9.003	119.896	M5-1	0.5
54	392839	394658	62826445	62431787	392946	107	0.6	5000	9.003	119.896	M5-1	0.5
55	1	1	1	0	1	0	0.6	5000	9.003	119.896	M5-1	0.5
57	400340	402140	60077241	59675101	400562	222	0.6	5000	9.003	119.896	M5-1	0.5
58	0	0	0	0	0	0	0.6	5000	9.003	119.896	M5-1	0.5
59	0	0	0	0	0	0	0.6	5000	9.003	119.896	M5-1	0.5
60	138715	141584	42878430	42736846	139023	308	0.6	5000	9.003	119.896	M5-1	0.5
61	0	1	1	0	0	0	0.6	5000	9.003	119.896	M5-1	0.5
62	3	3	6	3	3	0	0.6	5000	9.003	119.896	M5-1	0.5
63	282636	283443	33020001	32736558	282710	74	0.6	5000	9.003	119.896	M5-1	0.5
64	0	0	0	0	0	0	0.6	5000	9.003	119.896	M5-1	0.5
66	145574	146922	23225520	23078598	145574	0	0.6	5000	9.003	119.896	M5-1	0.5
69	210440	210783	17877210	17666427	210476	36	0.6	5000	9.003	119.896	M5-1	0.5
72	197745	198785	11005086	10806301	197959	214	0.6	5000	9.003	119.896	M5-1	0.5
75	27238	27401	2809635	2782234	27242	4	0.6	5000	9.003	119.896	M5-1	0.5
76	0	0	0	0	0	0	0.6	5000	9.003	119.896	M5-1	0.5
78	57391	58159	2273778	2215619	57391	0	0.6	5000	9.003	119.896	M5-1	0.5
81	14868	14958	644680	629722	14868	0	0.6	5000	9.003	119.896	M5-1	0.5
84	29235	29526	328455	298929	29235	0	0.6	5000	9.003	119.896	M5-1	0.5
87	4182	4182	52650	48468	4185	3	0.6	5000	9.003	119.896	M5-1	0.5
90	2090	2090	18721	16631	2090	0	0.6	5000	9.003	119.896	M5-1	0.5
3	0	0	0	0	0	0	0.7	1000	13.184	54.072	M2-1	0.5
12	1	1	1	0	1	0	0.7	1000	13.184	54.072	M2-1	0.5
15	0	0	0	0	0	0	0.7	1000	13.184	54.072	M2-1	0.5
24	80	80	17391	17311	132	52	0.7	1000	13.184	54.072	M2-1	0.5
27	58	58	20706	20648	65	7	0.7	1000	13.184	54.072	M2-1	0.5
30	316	317	102831	102514	326	10	0.7	1000	13.184	54.072	M2-1	0.5
33	760	781	571915	571134	808	48	0.7	1000	13.184	54.072	M2-1	0.5
36	1311	1518	1530375	1528857	1366	55	0.7	1000	13.184	54.072	M2-1	0.5
39	12895	13402	4501500	4488098	12933	38	0.7	1000	13.184	54.072	M2-1	0.5
41	0	0	0	0	0	0	0.7	1000	13.184	54.072	M2-1	0.5
42	27150	28588	10010575	9981987	27252	102	0.7	1000	13.184	54.072	M2-1	0.5
43	0	0	1	1	0	0	0.7	1000	13.184	54.072	M2-1	0.5
45	13514	15621	16522626	16507005	13659	145	0.7	1000	13.184	54.072	M2-1	0.5
46	0	0	1	1	0	0	0.7	1000	13.184	54.072	M2-1	0.5
48	29072	32345	24398605	24366260	29190	118	0.7	1000	13.184	54.072	M2-1	0.5
51	13028	14167	23988201	23974034	13310	282	0.7	1000	13.184	54.072	M2-1	0.5
52	0	0	0	0	0	0	0.7	1000	13.184	54.072	M2-1	0.5
54	32520	34863	24217320	24182457	32614	94	0.7	1000	13.184	54.072	M2-1	0.5
55	0	0	0	0	0	0	0.7	1000	13.184	54.072	M2-1	0.5
57	26921	28771	23932821	23904050	27722	801	0.7	1000	13.184	54.072	M2-1	0.5
58	0	0	0	0	0	0	0.7	1000	13.184	54.072	M2-1	0.5
59	0	0	1	1	0	0	0.7	1000	13.184	54.072	M2-1	0.5
60	12698	14059	16869336	16855277	12751	53	0.7	1000	13.184	54.072	M2-1	0.5
61	0	0	0	0	0	0	0.7	1000	13.184	54.072	M2-1	0.5
62	0	0	0	0	0	0	0.7	1000	13.184	54.072	M2-1	0.5
63	18973	19873	11608971	11589098	19011	38	0.7	1000	13.184	54.072	M2-1	0.5
64	0	0	0	0	0	0	0.7	1000	13.184	54.072	M2-1	0.5
66	39145	42563	7755891	7713328	39153	8	0.7	1000	13.184	54.072	M2-1	0.5
68	0	0	0	0	0	0	0.7	1000	13.184	54.072	M2-1	0.5
69	2570	2772	4928230	4925458	2585	15	0.7	1000	13.184	54.072	M2-1	0.5
72	2540	2716	2248260	2245544	2568	28	0.7	1000	13.184	54.072	M2-1	0.5
73	0	0	1	1	0	0	0.7	1000	13.184	54.072	M2-1	0.5
75	166017	166303	2494261	2327958	166024	7	0.7	1000	13.184	54.072	M2-1	0.5
78	606	617	541320	540703	626	20	0.7	1000	13.184	54.072	M2-1	0.5
81	18083	18097	402753	384656	18083	0	0.7	1000	13.184	54.072	M2-1	0.5
84	295	296	95703	95407	295	0	0.7	1000	13.184	54.072	M2-1	0.5
87	93	102	20100	19998	93	0	0.7	1000	13.184	54.072	M2-1	0.5
90	2	2	9045	9043	2	0	0.7	1000	13.184	54.072	M2-1	0.5
6	0	0	0	0	0	0	0.7	1000	14.93	49.156	M5-1	0.5
8	3	6	6	0	3	0	0.7	1000	14.93	49.156	M5-1	0.5
9	28	28	28	0	28	0	0.7	1000	14.93	49.156	M5-1	0.5
24	9161	9286	76636	67350	9282	121	0.7	1000	14.93	49.156	M5-1	0.5
27	9928	11312	53956	42644	9928	0	0.7	1000	14.93	49.156	M5-1	0.5
30	84740	84807	512578	427771	84741	1	0.7	1000	14.93	49.156	M5-1	0.5
33	15278	16399	1097421	1081022	15288	10	0.7	1000	14.93	49.156	M5-1	0.5
35	0	0	0	0	0	0	0.7	1000	14.93	49.156	M5-1	0.5
36	33981	38513	3324331	3285818	34009	28	0.7	1000	14.93	49.156	M5-1	0.5
37	0	0	0	0	0	0	0.7	1000	14.93	49.156	M5-1	0.5
39	66425	78081	8914753	8836672	66427	2	0.7	1000	14.93	49.156	M5-1	0.5
40	0	0	0	0	0	0	0.7	1000	14.93	49.156	M5-1	0.5
42	156712	168038	24440536	24272498	157042	330	0.7	1000	14.93	49.156	M5-1	0.5
45	171936	190901	46527481	46336580	172090	154	0.7	1000	14.93	49.156	M5-1	0.5
47	0	0	0	0	0	0	0.7	1000	14.93	49.156	M5-1	0.5
48	406031	430088	84142878	83712790	406522	491	0.7	1000	14.93	49.156	M5-1	0.5
49	0	0	0	0	0	0	0.7	1000	14.93	49.156	M5-1	0.5
51	245106	283513	65259600	64976087	246818	1712	0.7	1000	14.93	49.156	M5-1	0.5
54	320683	394658	62826445	62431787	320692	9	0.7	1000	14.93	49.156	M5-1	0.5
55	1	1	1	0	1	0	0.7	1000	14.93	49.156	M5-1	0.5
57	379434	402140	60077241	59675101	379487	53	0.7	1000	14.93	49.156	M5-1	0.5
58	0	0	0	0	0	0	0.7	1000	14.93	49.156	M5-1	0.5
59	0	0	0	0	0	0	0.7	1000	14.93	49.156	M5-1	0.5
60	108157	141584	42878430	42736846	108202	45	0.7	1000	14.93	49.156	M5-1	0.5
61	0	1	1	0	0	0	0.7	1000	14.93	49.156	M5-1	0.5
62	3	3	6	3	3	0	0.7	1000	14.93	49.156	M5-1	0.5
63	268360	283443	33020001	32736558	268372	12	0.7	1000	14.93	49.156	M5-1	0.5
64	0	0	0	0	0	0	0.7	1000	14.93	49.156	M5-1	0.5
66	123222	146922	23225520	23078598	123222	0	0.7	1000	14.93	49.156	M5-1	0.5
69	204578	210783	17877210	17666427	204605	27	0.7	1000	14.93	49.156	M5-1	0.5
72	193778	198785	11005086	10806301	193954	176	0.7	1000	14.93	49.156	M5-1	0.5
75	26102	27401	2809635	2782234	26106	4	0.7	1000	14.93	49.156	M5-1	0.5
76	0	0	0	0	0	0	0.7	1000	14.93	49.156	M5-1	0.5
78	53409	58159	2273778	2215619	53409	0	0.7	1000	14.93	49.156	M5-1	0.5
81	14868	14958	644680	629722	14868	0	0.7	1000	14.93	49.156	M5-1	0.5
84	29235	29526	328455	298929	29235	0	0.7	1000	14.93	49.156	M5-1	0.5
87	4182	4182	52650	48468	4185	3	0.7	1000	14.93	49.156	M5-1	0.5
90	2090	2090	18721	16631	2090	0	0.7	1000	14.93	49.156	M5-1	0.5
3	0	0	0	0	0	0	0.7	1000	5.488	28.725	M4-1	0.5
6	0	0	0	0	0	0	0.7	1000	5.488	28.725	M4-1	0.5
24	73	75	3570	3495	73	0	0.7	1000	5.488	28.725	M4-1	0.5
27	6507	6507	43071	36564	6513	6	0.7	1000	5.488	28.725	M4-1	0.5
30	709	716	40755	40039	714	5	0.7	1000	5.488	28.725	M4-1	0.5
33	33957	33984	424581	390597	33957	0	0.7	1000	5.488	28.725	M4-1	0.5
36	4978	4979	458403	453424	4984	6	0.7	1000	5.488	28.725	M4-1	0.5
39	211494	234607	6813586	6578979	211509	15	0.7	1000	5.488	28.725	M4-1	0.5
41	0	0	0	0	0	0	0.7	1000	5.488	28.725	M4-1	0.5
42	70377	74965	8559453	8484488	71430	1053	0.7	1000	5.488	28.725	M4-1	0.5
45	253090	274902	18638565	18363663	253104	14	0.7	1000	5.488	28.725	M4-1	0.5
47	0	0	0	0	0	0	0.7	1000	5.488	28.725	M4-1	0.5
48	195793	212334	24981846	24769512	196064	271	0.7	1000	5.488	28.725	M4-1	0.5
49	0	0	0	0	0	0	0.7	1000	5.488	28.725	M4-1	0.5
50	10	10	15	5	10	0	0.7	1000	5.488	28.725	M4-1	0.5
51	255839	270020	34283340	34013320	255975	136	0.7	1000	5.488	28.725	M4-1	0.5
52	0	0	0	0	0	0	0.7	1000	5.488	28.725	M4-1	0.5
53	0	0	1	1	0	0	0.7	1000	5.488	28.725	M4-1	0.5
54	245351	257003	26335653	26078650	245361	10	0.7	1000	5.488	28.725	M4-1	0.5
56	55	55	55	0	55	0	0.7	1000	5.488	28.725	M4-1	0.5
57	90250	92998	17307786	17214788	90270	20	0.7	1000	5.488	28.725	M4-1	0.5
58	0	0	0	0	0	0	0.7	1000	5.488	28.725	M4-1	0.5
60	162113	174264	15354111	15179847	162113	0	0.7	1000	5.488	28.725	M4-1	0.5
63	86494	90130	11987856	11897726	86545	51	0.7	1000	5.488	28.725	M4-1	0.5
65	0	0	0	0	0	0	0.7	1000	5.488	28.725	M4-1	0.5
66	188625	189660	8704878	8515218	188625	0	0.7	1000	5.488	28.725	M4-1	0.5
67	0	0	0	0	0	0	0.7	1000	5.488	28.725	M4-1	0.5
69	138020	148774	7634278	7485504	138023	3	0.7	1000	5.488	28.725	M4-1	0.5
72	1446230	1449473	11493615	10044142	1446231	1	0.7	1000	5.488	28.725	M4-1	0.5
73	1	1	1	0	1	0	0.7	1000	5.488	28.725	M4-1	0.5
75	18218	18309	962578	944269	18218	0	0.7	1000	5.488	28.725	M4-1	0.5
78	12180	12247	451725	439478	12180	0	0.7	1000	5.488	28.725	M4-1	0.5
81	1988	2002	126756	124754	1988	0	0.7	1000	5.488	28.725	M4-1	0.5
84	5572	5573	52650	47077	5572	0	0.7	1000	5.488	28.725	M4-1	0.5
87	620	621	12403	11782	620	0	0.7	1000	5.488	28.725	M4-1	0.5
90	218	233	4753	4520	218	0	0.7	1000	5.488	28.725	M4-1	0.5
12	0	0	0	0	0	0	0.7	1000	5.971	18.728	M3-1	0.5
24	19	19	528	509	20	1	0.7	1000	5.971	18.728	M3-1	0.5
27	1012	1012	3403	2391	1012	0	0.7	1000	5.971	18.728	M3-1	0.5
30	2244	2244	20706	18462	2266	22	0.7	1000	5.971	18.728	M3-1	0.5
33	14453	14843	188191	173348	14453	0	0.7	1000	5.971	18.728	M3-1	0.5
36	7238877	7242680	9894576	2651896	7238881	4	0.7	1000	5.971	18.728	M3-1	0.5
39	263400	263445	2729616	2466171	263400	0	0.7	1000	5.971	18.728	M3-1	0.5
42	35711	35878	2158003	2122125	35836	125	0.7	1000	5.971	18.728	M3-1	0.5
45	45169	56285	3736011	3679726	45170	1	0.7	1000	5.971	18.728	M3-1	0.5
48	726656	728177	10776403	10048226	726662	6	0.7	1000	5.971	18.728	M3-1	0.5
51	429780	443478	10131751	9688273	429781	1	0.7	1000	5.971	18.728	M3-1	0.5
54	101283	102378	5519503	5417125	101283	0	0.7	1000	5.971	18.728	M3-1	0.5
57	98939	99788	4837605	4737817	99230	291	0.7	1000	5.971	18.728	M3-1	0.5
59	0	0	0	0	0	0	0.7	1000	5.971	18.728	M3-1	0.5
60	220414	221616	3573801	3352185	220453	39	0.7	1000	5.971	18.728	M3-1	0.5
62	0	0	0	0	0	0	0.7	1000	5.971	18.728	M3-1	0.5
63	541942	576491	9748320	9171829	541942	0	0.7	1000	5.971	18.728	M3-1	0.5
64	0	0	0	0	0	0	0.7	1000	5.971	18.728	M3-1	0.5
66	293041	293128	2492028	2198900	293041	0	0.7	1000	5.971	18.728	M3-1	0.5
68	10	10	15	5	10	0	0.7	1000	5.971	18.728	M3-1	0.5
69	347105	359725	4045590	3685865	347116	11	0.7	1000	5.971	18.728	M3-1	0.5
72	72649	75317	1553203	1477886	72649	0	0.7	1000	5.971	18.728	M3-1	0.5
75	18352	18352	328455	310103	18354	2	0.7	1000	5.971	18.728	M3-1	0.5
76	0	0	0	0	0	0	0.7	1000	5.971	18.728	M3-1	0.5
78	132571	132572	773146	640574	132571	0	0.7	1000	5.971	18.728	M3-1	0.5
81	5138	5138	36585	31447	5138	0	0.7	1000	5.971	18.728	M3-1	0.5
84	623	623	9730	9107	623	0	0.7	1000	5.971	18.728	M3-1	0.5
87	478	478	6670	6192	478	0	0.7	1000	5.971	18.728	M3-1	0.5
90	294	305	2278	1973	294	0	0.7	1000	5.971	18.728	M3-1	0.5
3	0	0	0	0	0	0	0.7	2000	10.996	70.034	M2-1	0.5
12	1	1	1	0	1	0	0.7	2000	10.996	70.034	M2-1	0.5
15	0	0	0	0	0	0	0.7	2000	10.996	70.034	M2-1	0.5
24	80	80	17391	17311	132	52	0.7	2000	10.996	70.034	M2-1	0.5
27	58	58	20706	20648	65	7	0.7	2000	10.996	70.034	M2-1	0.5
30	316	317	102831	102514	326	10	0.7	2000	10.996	70.034	M2-1	0.5
33	760	781	571915	571134	808	48	0.7	2000	10.996	70.034	M2-1	0.5
36	1513	1518	1530375	1528857	1626	113	0.7	2000	10.996	70.034	M2-1	0.5
39	12895	13402	4501500	4488098	12933	38	0.7	2000	10.996	70.034	M2-1	0.5
41	0	0	0	0	0	0	0.7	2000	10.996	70.034	M2-1	0.5
42	27150	28588	10010575	9981987	27252	102	0.7	2000	10.996	70.034	M2-1	0.5
43	0	0	1	1	0	0	0.7	2000	10.996	70.034	M2-1	0.5
45	13514	15621	16522626	16507005	13659	145	0.7	2000	10.996	70.034	M2-1	0.5
46	0	0	1	1	0	0	0.7	2000	10.996	70.034	M2-1	0.5
48	29292	32345	24398605	24366260	29421	129	0.7	2000	10.996	70.034	M2-1	0.5
51	13347	14167	23988201	23974034	13643	296	0.7	2000	10.996	70.034	M2-1	0.5
52	0	0	0	0	0	0	0.7	2000	10.996	70.034	M2-1	0.5
54	32985	34863	24217320	24182457	33094	109	0.7	2000	10.996	70.034	M2-1	0.5
55	0	0	0	0	0	0	0.7	2000	10.996	70.034	M2-1	0.5
57	27471	28771	23932821	23904050	28280	809	0.7	2000	10.996	70.034	M2-1	0.5
58	0	0	0	0	0	0	0.7	2000	10.996	70.034	M2-1	0.5
59	0	0	1	1	0	0	0.7	2000	10.996	70.034	M2-1	0.5
60	13078	14059	16869336	16855277	13135	57	0.7	2000	10.996	70.034	M2-1	0.5
61	0	0	0	0	0	0	0.7	2000	10.996	70.034	M2-1	0.5
62	0	0	0	0	0	0	0.7	2000	10.996	70.034	M2-1	0.5
63	19181	19873	11608971	11589098	19219	38	0.7	2000	10.996	70.034	M2-1	0.5
64	0	0	0	0	0	0	0.7	2000	10.996	70.034	M2-1	0.5
66	39195	42563	7755891	7713328	39203	8	0.7	2000	10.996	70.034	M2-1	0.5
68	0	0	0	0	0	0	0.7	2000	10.996	70.034	M2-1	0.5
69	2570	2772	4928230	4925458	2585	15	0.7	2000	10.996	70.034	M2-1	0.5
72	2708	2716	2248260	2245544	2739	31	0.7	2000	10.996	70.034	M2-1	0.5
73	0	0	1	1	0	0	0.7	2000	10.996	70.034	M2-1	0.5
75	166295	166303	2494261	2327958	166302	7	0.7	2000	10.996	70.034	M2-1	0.5
78	606	617	541320	540703	626	20	0.7	2000	10.996	70.034	M2-1	0.5
81	18083	18097	402753	384656	18083	0	0.7	2000	10.996	70.034	M2-1	0.5
84	295	296	95703	95407	295	0	0.7	2000	10.996	70.034	M2-1	0.5
87	93	102	20100	19998	93	0	0.7	2000	10.996	70.034	M2-1	0.5
90	2	2	9045	9043	2	0	0.7	2000	10.996	70.034	M2-1	0.5
12	0	0	0	0	0	0	0.7	2000	3.131	28.109	M3-1	0.5
24	19	19	528	509	20	1	0.7	2000	3.131	28.109	M3-1	0.5
27	1012	1012	3403	2391	1012	0	0.7	2000	3.131	28.109	M3-1	0.5
30	2244	2244	20706	18462	2266	22	0.7	2000	3.131	28.109	M3-1	0.5
33	14453	14843	188191	173348	14453	0	0.7	2000	3.131	28.109	M3-1	0.5
36	7238877	7242680	9894576	2651896	7238881	4	0.7	2000	3.131	28.109	M3-1	0.5
39	263400	263445	2729616	2466171	263400	0	0.7	2000	3.131	28.109	M3-1	0.5
42	35711	35878	2158003	2122125	35836	125	0.7	2000	3.131	28.109	M3-1	0.5
45	55347	56285	3736011	3679726	55350	3	0.7	2000	3.131	28.109	M3-1	0.5
48	728017	728177	10776403	10048226	728027	10	0.7	2000	3.131	28.109	M3-1	0.5
51	443289	443478	10131751	9688273	443296	7	0.7	2000	3.131	28.109	M3-1	0.5
54	102022	102378	5519503	5417125	102027	5	0.7	2000	3.131	28.109	M3-1	0.5
57	99636	99788	4837605	4737817	99927	291	0.7	2000	3.131	28.109	M3-1	0.5
59	0	0	0	0	0	0	0.7	2000	3.131	28.109	M3-1	0.5
60	221502	221616	3573801	3352185	221541	39	0.7	2000	3.131	28.109	M3-1	0.5
62	0	0	0	0	0	0	0.7	2000	3.131	28.109	M3-1	0.5
63	576245	576491	9748320	9171829	576245	0	0.7	2000	3.131	28.109	M3-1	0.5
64	0	0	0	0	0	0	0.7	2000	3.131	28.109	M3-1	0.5
66	293041	293128	2492028	2198900	293041	0	0.7	2000	3.131	28.109	M3-1	0.5
68	10	10	15	5	10	0	0.7	2000	3.131	28.109	M3-1	0.5
69	359721	359725	4045590	3685865	359732	11	0.7	2000	3.131	28.109	M3-1	0.5
72	72649	75317	1553203	1477886	72649	0	0.7	2000	3.131	28.109	M3-1	0.5
75	18352	18352	328455	310103	18354	2	0.7	2000	3.131	28.109	M3-1	0.5
76	0	0	0	0	0	0	0.7	2000	3.131	28.109	M3-1	0.5
78	132571	132572	773146	640574	132571	0	0.7	2000	3.131	28.109	M3-1	0.5
81	5138	5138	36585	31447	5138	0	0.7	2000	3.131	28.109	M3-1	0.5
84	623	623	9730	9107	623	0	0.7	2000	3.131	28.109	M3-1	0.5
87	478	478	6670	6192	478	0	0.7	2000	3.131	28.109	M3-1	0.5
90	294	305	2278	1973	294	0	0.7	2000	3.131	28.109	M3-1	0.5
3	0	0	0	0	0	0	0.7	2000	6.045	44.116	M4-1	0.5
6	0	0	0	0	0	0	0.7	2000	6.045	44.116	M4-1	0.5
24	73	75	3570	3495	73	0	0.7	2000	6.045	44.116	M4-1	0.5
27	6507	6507	43071	36564	6513	6	0.7	2000	6.045	44.116	M4-1	0.5
30	709	716	40755	40039	714	5	0.7	2000	6.045	44.116	M4-1	0.5
33	33957	33984	424581	390597	33957	0	0.7	2000	6.045	44.116	M4-1	0.5
36	4978	4979	458403	453424	4984	6	0.7	2000	6.045	44.116	M4-1	0.5
39	222875	234607	6813586	6578979	222894	19	0.7	2000	6.045	44.116	M4-1	0.5
41	0	0	0	0	0	0	0.7	2000	6.045	44.116	M4-1	0.5
42	70377	74965	8559453	8484488	71430	1053	0.7	2000	6.045	44.116	M4-1	0.5
45	253090	274902	18638565	18363663	253104	14	0.7	2000	6.045	44.116	M4-1	0.5
47	0	0	0	0	0	0	0.7	2000	6.045	44.116	M4-1	0.5
48	195793	212334	24981846	24769512	196064	271	0.7	2000	6.045	44.116	M4-1	0.5
49	0	0	0	0	0	0	0.7	2000	6.045	44.116	M4-1	0.5
50	10	10	15	5	10	0	0.7	2000	6.045	44.116	M4-1	0.5
51	255839	270020	34283340	34013320	255975	136	0.7	2000	6.045	44.116	M4-1	0.5
52	0	0	0	0	0	0	0.7	2000	6.045	44.116	M4-1	0.5
53	0	0	1	1	0	0	0.7	2000	6.045	44.116	M4-1	0.5
54	245351	257003	26335653	26078650	245361	10	0.7	2000	6.045	44.116	M4-1	0.5
56	55	55	55	0	55	0	0.7	2000	6.045	44.116	M4-1	0.5
57	90250	92998	17307786	17214788	90270	20	0.7	2000	6.045	44.116	M4-1	0.5
58	0	0	0	0	0	0	0.7	2000	6.045	44.116	M4-1	0.5
60	162113	174264	15354111	15179847	162113	0	0.7	2000	6.045	44.116	M4-1	0.5
63	86494	90130	11987856	11897726	86545	51	0.7	2000	6.045	44.116	M4-1	0.5
65	0	0	0	0	0	0	0.7	2000	6.045	44.116	M4-1	0.5
66	188625	189660	8704878	8515218	188625	0	0.7	2000	6.045	44.116	M4-1	0.5
67	0	0	0	0	0	0	0.7	2000	6.045	44.116	M4-1	0.5
69	148691	148774	7634278	7485504	148697	6	0.7	2000	6.045	44.116	M4-1	0.5
72	1446230	1449473	11493615	10044142	1446231	1	0.7	2000	6.045	44.116	M4-1	0.5
73	1	1	1	0	1	0	0.7	2000	6.045	44.116	M4-1	0.5
75	18218	18309	962578	944269	18218	0	0.7	2000	6.045	44.116	M4-1	0.5
78	12180	12247	451725	439478	12180	0	0.7	2000	6.045	44.116	M4-1	0.5
81	1988	2002	126756	124754	1988	0	0.7	2000	6.045	44.116	M4-1	0.5
84	5572	5573	52650	47077	5572	0	0.7	2000	6.045	44.116	M4-1	0.5
87	620	621	12403	11782	620	0	0.7	2000	6.045	44.116	M4-1	0.5
90	218	233	4753	4520	218	0	0.7	2000	6.045	44.116	M4-1	0.5
6	0	0	0	0	0	0	0.7	2000	9.571	61.612	M5-1	0.5
8	3	6	6	0	3	0	0.7	2000	9.571	61.612	M5-1	0.5
9	28	28	28	0	28	0	0.7	2000	9.571	61.612	M5-1	0.5
24	9161	9286	76636	67350	9282	121	0.7	2000	9.571	61.612	M5-1	0.5
27	9928	11312	53956	42644	9928	0	0.7	2000	9.571	61.612	M5-1	0.5
30	84740	84807	512578	427771	84741	1	0.7	2000	9.571	61.612	M5-1	0.5
33	15278	16399	1097421	1081022	15288	10	0.7	2000	9.571	61.612	M5-1	0.5
35	0	0	0	0	0	0	0.7	2000	9.571	61.612	M5-1	0.5
36	38436	38513	3324331	3285818	38468	32	0.7	2000	9.571	61.612	M5-1	0.5
37	0	0	0	0	0	0	0.7	2000	9.571	61.612	M5-1	0.5
39	66425	78081	8914753	8836672	66427	2	0.7	2000	9.571	61.612	M5-1	0.5
40	0	0	0	0	0	0	0.7	2000	9.571	61.612	M5-1	0.5
42	156712	168038	24440536	24272498	157042	330	0.7	2000	9.571	61.612	M5-1	0.5
45	171936	190901	46527481	46336580	172090	154	0.7	2000	9.571	61.612	M5-1	0.5
47	0	0	0	0	0	0	0.7	2000	9.571	61.612	M5-1	0.5
48	408263	430088	84142878	83712790	408768	505	0.7	2000	9.571	61.612	M5-1	0.5
49	0	0	0	0	0	0	0.7	2000	9.571	61.612	M5-1	0.5
51	266382	283513	65259600	64976087	268094	1712	0.7	2000	9.571	61.612	M5-1	0.5
54	346470	394658	62826445	62431787	346491	21	0.7	2000	9.571	61.612	M5-1	0.5
55	1	1	1	0	1	0	0.7	2000	9.571	61.612	M5-1	0.5
57	387637	402140	60077241	59675101	387719	82	0.7	2000	9.571	61.612	M5-1	0.5
58	0	0	0	0	0	0	0.7	2000	9.571	61.612	M5-1	0.5
59	0	0	0	0	0	0	0.7	2000	9.571	61.612	M5-1	0.5
60	108157	141584	42878430	42736846	108202	45	0.7	2000	9.571	61.612	M5-1	0.5
61	0	1	1	0	0	0	0.7	2000	9.571	61.612	M5-1	0.5
62	3	3	6	3	3	0	0.7	2000	9.571	61.612	M5-1	0.5
63	274521	283443	33020001	32736558	274568	47	0.7	2000	9.571	61.612	M5-1	0.5
64	0	0	0	0	0	0	0.7	2000	9.571	61.612	M5-1	0.5
66	130173	146922	23225520	23078598	130173	0	0.7	2000	9.571	61.612	M5-1	0.5
69	205796	210783	17877210	17666427	205823	27	0.7	2000	9.571	61.612	M5-1	0.5
72	193778	198785	11005086	10806301	193954	176	0.7	2000	9.571	61.612	M5-1	0.5
75	27238	27401	2809635	2782234	27242	4	0.7	2000	9.571	61.612	M5-1	0.5
76	0	0	0	0	0	0	0.7	2000	9.571	61.612	M5-1	0.5
78	57391	58159	2273778	2215619	57391	0	0.7	2000	9.571	61.612	M5-1	0.5
81	14868	14958	644680	629722	14868	0	0.7	2000	9.571	61.612	M5-1	0.5
84	29235	29526	328455	298929	29235	0	0.7	2000	9.571	61.612	M5-1	0.5
87	4182	4182	52650	48468	4185	3	0.7	2000	9.571	61.612	M5-1	0.5
90	2090	2090	18721	16631	2090	0	0.7	2000	9.571	61.612	M5-1	0.5
12	0	0	0	0	0	0	0.7	3000	3.044	27.899	M3-1	0.5
24	19	19	528	509	20	1	0.7	3000	3.044	27.899	M3-1	0.5
27	1012	1012	3403	2391	1012	0	0.7	3000	3.044	27.899	M3-1	0.5
30	2244	2244	20706	18462	2266	22	0.7	3000	3.044	27.899	M3-1	0.5
33	14453	14843	188191	173348	14453	0	0.7	3000	3.044	27.899	M3-1	0.5
36	7238877	7242680	9894576	2651896	7238881	4	0.7	3000	3.044	27.899	M3-1	0.5
39	263400	263445	2729616	2466171	263400	0	0.7	3000	3.044	27.899	M3-1	0.5
42	35711	35878	2158003	2122125	35836	125	0.7	3000	3.044	27.899	M3-1	0.5
45	55347	56285	3736011	3679726	55350	3	0.7	3000	3.044	27.899	M3-1	0.5
48	728017	728177	10776403	10048226	728027	10	0.7	3000	3.044	27.899	M3-1	0.5
51	443289	443478	10131751	9688273	443296	7	0.7	3000	3.044	27.899	M3-1	0.5
54	102022	102378	5519503	5417125	102027	5	0.7	3000	3.044	27.899	M3-1	0.5
57	99636	99788	4837605	4737817	99927	291	0.7	3000	3.044	27.899	M3-1	0.5
59	0	0	0	0	0	0	0.7	3000	3.044	27.899	M3-1	0.5
60	221502	221616	3573801	3352185	221541	39	0.7	3000	3.044	27.899	M3-1	0.5
62	0	0	0	0	0	0	0.7	3000	3.044	27.899	M3-1	0.5
63	576245	576491	9748320	9171829	576245	0	0.7	3000	3.044	27.899	M3-1	0.5
64	0	0	0	0	0	0	0.7	3000	3.044	27.899	M3-1	0.5
66	293041	293128	2492028	2198900	293041	0	0.7	3000	3.044	27.899	M3-1	0.5
68	10	10	15	5	10	0	0.7	3000	3.044	27.899	M3-1	0.5
69	359721	359725	4045590	3685865	359732	11	0.7	3000	3.044	27.899	M3-1	0.5
72	72649	75317	1553203	1477886	72649	0	0.7	3000	3.044	27.899	M3-1	0.5
75	18352	18352	328455	310103	18354	2	0.7	3000	3.044	27.899	M3-1	0.5
76	0	0	0	0	0	0	0.7	3000	3.044	27.899	M3-1	0.5
78	132571	132572	773146	640574	132571	0	0.7	3000	3.044	27.899	M3-1	0.5
81	5138	5138	36585	31447	5138	0	0.7	3000	3.044	27.899	M3-1	0.5
84	623	623	9730	9107	623	0	0.7	3000	3.044	27.899	M3-1	0.5
87	478	478	6670	6192	478	0	0.7	3000	3.044	27.899	M3-1	0.5
90	294	305	2278	1973	294	0	0.7	3000	3.044	27.899	M3-1	0.5
3	0	0	0	0	0	0	0.7	3000	3.092	68.999	M4-1	0.5
6	0	0	0	0	0	0	0.7	3000	3.092	68.999	M4-1	0.5
24	73	75	3570	3495	73	0	0.7	3000	3.092	68.999	M4-1	0.5
27	6507	6507	43071	36564	6513	6	0.7	3000	3.092	68.999	M4-1	0.5
30	709	716	40755	40039	714	5	0.7	3000	3.092	68.999	M4-1	0.5
33	33957	33984	424581	390597	33957	0	0.7	3000	3.092	68.999	M4-1	0.5
36	4978	4979	458403	453424	4984	6	0.7	3000	3.092	68.999	M4-1	0.5
39	222875	234607	6813586	6578979	222894	19	0.7	3000	3.092	68.999	M4-1	0.5
41	0	0	0	0	0	0	0.7	3000	3.092	68.999	M4-1	0.5
42	74372	74965	8559453	8484488	75520	1148	0.7	3000	3.092	68.999	M4-1	0.5
45	274768	274902	18638565	18363663	274789	21	0.7	3000	3.092	68.999	M4-1	0.5
47	0	0	0	0	0	0	0.7	3000	3.092	68.999	M4-1	0.5
48	195793	212334	24981846	24769512	196064	271	0.7	3000	3.092	68.999	M4-1	0.5
49	0	0	0	0	0	0	0.7	3000	3.092	68.999	M4-1	0.5
50	10	10	15	5	10	0	0.7	3000	3.092	68.999	M4-1	0.5
51	255839	270020	34283340	34013320	255975	136	0.7	3000	3.092	68.999	M4-1	0.5
52	0	0	0	0	0	0	0.7	3000	3.092	68.999	M4-1	0.5
53	0	0	1	1	0	0	0.7	3000	3.092	68.999	M4-1	0.5
54	245351	257003	26335653	26078650	245361	10	0.7	3000	3.092	68.999	M4-1	0.5
56	55	55	55	0	55	0	0.7	3000	3.092	68.999	M4-1	0.5
57	90250	92998	17307786	17214788	90270	20	0.7	3000	3.092	68.999	M4-1	0.5
58	0	0	0	0	0	0	0.7	3000	3.092	68.999	M4-1	0.5
60	172947	174264	15354111	15179847	172948	1	0.7	3000	3.092	68.999	M4-1	0.5
63	89734	90130	11987856	11897726	89788	54	0.7	3000	3.092	68.999	M4-1	0.5
65	0	0	0	0	0	0	0.7	3000	3.092	68.999	M4-1	0.5
66	189006	189660	8704878	8515218	189008	2	0.7	3000	3.092	68.999	M4-1	0.5
67	0	0	0	0	0	0	0.7	3000	3.092	68.999	M4-1	0.5
69	148691	148774	7634278	7485504	148697	6	0.7	3000	3.092	68.999	M4-1	0.5
72	1448204	1449473	11493615	10044142	1448209	5	0.7	3000	3.092	68.999	M4-1	0.5
73	1	1	1	0	1	0	0.7	3000	3.092	68.999	M4-1	0.5
75	18218	18309	962578	944269	18218	0	0.7	3000	3.092	68.999	M4-1	0.5
78	12180	12247	451725	439478	12180	0	0.7	3000	3.092	68.999	M4-1	0.5
81	1988	2002	126756	124754	1988	0	0.7	3000	3.092	68.999	M4-1	0.5
84	5572	5573	52650	47077	5572	0	0.7	3000	3.092	68.999	M4-1	0.5
87	620	621	12403	11782	620	0	0.7	3000	3.092	68.999	M4-1	0.5
90	218	233	4753	4520	218	0	0.7	3000	3.092	68.999	M4-1	0.5
3	0	0	0	0	0	0	0.7	3000	7.255	86.347	M2-1	0.5
12	1	1	1	0	1	0	0.7	3000	7.255	86.347	M2-1	0.5
15	0	0	0	0	0	0	0.7	3000	7.255	86.347	M2-1	0.5
24	80	80	17391	17311	132	52	0.7	3000	7.255	86.347	M2-1	0.5
27	58	58	20706	20648	65	7	0.7	3000	7.255	86.347	M2-1	0.5
30	316	317	102831	102514	326	10	0.7	3000	7.255	86.347	M2-1	0.5
33	760	781	571915	571134	808	48	0.7	3000	7.255	86.347	M2-1	0.5
36	1513	1518	1530375	1528857	1626	113	0.7	3000	7.255	86.347	M2-1	0.5
39	13374	13402	4501500	4488098	13454	80	0.7	3000	7.255	86.347	M2-1	0.5
41	0	0	0	0	0	0	0.7	3000	7.255	86.347	M2-1	0.5
42	27150	28588	10010575	9981987	27252	102	0.7	3000	7.255	86.347	M2-1	0.5
43	0	0	1	1	0	0	0.7	3000	7.255	86.347	M2-1	0.5
45	13514	15621	16522626	16507005	13659	145	0.7	3000	7.255	86.347	M2-1	0.5
46	0	0	1	1	0	0	0.7	3000	7.255	86.347	M2-1	0.5
48	29292	32345	24398605	24366260	29421	129	0.7	3000	7.255	86.347	M2-1	0.5
51	13347	14167	23988201	23974034	13643	296	0.7	3000	7.255	86.347	M2-1	0.5
52	0	0	0	0	0	0	0.7	3000	7.255	86.347	M2-1	0.5
54	32985	34863	24217320	24182457	33094	109	0.7	3000	7.255	86.347	M2-1	0.5
55	0	0	0	0	0	0	0.7	3000	7.255	86.347	M2-1	0.5
57	27471	28771	23932821	23904050	28280	809	0.7	3000	7.255	86.347	M2-1	0.5
58	0	0	0	0	0	0	0.7	3000	7.255	86.347	M2-1	0.5
59	0	0	1	1	0	0	0.7	3000	7.255	86.347	M2-1	0.5
60	13078	14059	16869336	16855277	13135	57	0.7	3000	7.255	86.347	M2-1	0.5
61	0	0	0	0	0	0	0.7	3000	7.255	86.347	M2-1	0.5
62	0	0	0	0	0	0	0.7	3000	7.255	86.347	M2-1	0.5
63	19181	19873	11608971	11589098	19219	38	0.7	3000	7.255	86.347	M2-1	0.5
64	0	0	0	0	0	0	0.7	3000	7.255	86.347	M2-1	0.5
66	39195	42563	7755891	7713328	39203	8	0.7	3000	7.255	86.347	M2-1	0.5
68	0	0	0	0	0	0	0.7	3000	7.255	86.347	M2-1	0.5
69	2709	2772	4928230	4925458	2756	47	0.7	3000	7.255	86.347	M2-1	0.5
72	2708	2716	2248260	2245544	2739	31	0.7	3000	7.255	86.347	M2-1	0.5
73	0	0	1	1	0	0	0.7	3000	7.255	86.347	M2-1	0.5
75	166295	166303	2494261	2327958	166302	7	0.7	3000	7.255	86.347	M2-1	0.5
78	606	617	541320	540703	626	20	0.7	3000	7.255	86.347	M2-1	0.5
81	18083	18097	402753	384656	18083	0	0.7	3000	7.255	86.347	M2-1	0.5
84	295	296	95703	95407	295	0	0.7	3000	7.255	86.347	M2-1	0.5
87	93	102	20100	19998	93	0	0.7	3000	7.255	86.347	M2-1	0.5
90	2	2	9045	9043	2	0	0.7	3000	7.255	86.347	M2-1	0.5
6	0	0	0	0	0	0	0.7	3000	7.954	71.443	M5-1	0.5
8	3	6	6	0	3	0	0.7	3000	7.954	71.443	M5-1	0.5
9	28	28	28	0	28	0	0.7	3000	7.954	71.443	M5-1	0.5
24	9161	9286	76636	67350	9282	121	0.7	3000	7.954	71.443	M5-1	0.5
27	9928	11312	53956	42644	9928	0	0.7	3000	7.954	71.443	M5-1	0.5
30	84740	84807	512578	427771	84741	1	0.7	3000	7.954	71.443	M5-1	0.5
33	15278	16399	1097421	1081022	15288	10	0.7	3000	7.954	71.443	M5-1	0.5
35	0	0	0	0	0	0	0.7	3000	7.954	71.443	M5-1	0.5
36	38436	38513	3324331	3285818	38468	32	0.7	3000	7.954	71.443	M5-1	0.5
37	0	0	0	0	0	0	0.7	3000	7.954	71.443	M5-1	0.5
39	77192	78081	8914753	8836672	77195	3	0.7	3000	7.954	71.443	M5-1	0.5
40	0	0	0	0	0	0	0.7	3000	7.954	71.443	M5-1	0.5
42	156712	168038	24440536	24272498	157042	330	0.7	3000	7.954	71.443	M5-1	0.5
45	171936	190901	46527481	46336580	172090	154	0.7	3000	7.954	71.443	M5-1	0.5
47	0	0	0	0	0	0	0.7	3000	7.954	71.443	M5-1	0.5
48	408263	430088	84142878	83712790	408768	505	0.7	3000	7.954	71.443	M5-1	0.5
49	0	0	0	0	0	0	0.7	3000	7.954	71.443	M5-1	0.5
51	266382	283513	65259600	64976087	268094	1712	0.7	3000	7.954	71.443	M5-1	0.5
54	346470	394658	62826445	62431787	346491	21	0.7	3000	7.954	71.443	M5-1	0.5
55	1	1	1	0	1	0	0.7	3000	7.954	71.443	M5-1	0.5
57	387637	402140	60077241	59675101	387719	82	0.7	3000	7.954	71.443	M5-1	0.5
58	0	0	0	0	0	0	0.7	3000	7.954	71.443	M5-1	0.5
59	0	0	0	0	0	0	0.7	3000	7.954	71.443	M5-1	0.5
60	117374	141584	42878430	42736846	117655	281	0.7	3000	7.954	71.443	M5-1	0.5
61	0	1	1	0	0	0	0.7	3000	7.954	71.443	M5-1	0.5
62	3	3	6	3	3	0	0.7	3000	7.954	71.443	M5-1	0.5
63	274521	283443	33020001	32736558	274568	47	0.7	3000	7.954	71.443	M5-1	0.5
64	0	0	0	0	0	0	0.7	3000	7.954	71.443	M5-1	0.5
66	130173	146922	23225520	23078598	130173	0	0.7	3000	7.954	71.443	M5-1	0.5
69	205796	210783	17877210	17666427	205823	27	0.7	3000	7.954	71.443	M5-1	0.5
72	197745	198785	11005086	10806301	197959	214	0.7	3000	7.954	71.443	M5-1	0.5
75	27238	27401	2809635	2782234	27242	4	0.7	3000	7.954	71.443	M5-1	0.5
76	0	0	0	0	0	0	0.7	3000	7.954	71.443	M5-1	0.5
78	57391	58159	2273778	2215619	57391	0	0.7	3000	7.954	71.443	M5-1	0.5
81	14868	14958	644680	629722	14868	0	0.7	3000	7.954	71.443	M5-1	0.5
84	29235	29526	328455	298929	29235	0	0.7	3000	7.954	71.443	M5-1	0.5
87	4182	4182	52650	48468	4185	3	0.7	3000	7.954	71.443	M5-1	0.5
90	2090	2090	18721	16631	2090	0	0.7	3000	7.954	71.443	M5-1	0.5
3	0	0	0	0	0	0	0.7	4000	2.735	98.029	M4-1	0.5
6	0	0	0	0	0	0	0.7	4000	2.735	98.029	M4-1	0.5
24	73	75	3570	3495	73	0	0.7	4000	2.735	98.029	M4-1	0.5
27	6507	6507	43071	36564	6513	6	0.7	4000	2.735	98.029	M4-1	0.5
30	709	716	40755	40039	714	5	0.7	4000	2.735	98.029	M4-1	0.5
33	33957	33984	424581	390597	33957	0	0.7	4000	2.735	98.029	M4-1	0.5
36	4978	4979	458403	453424	4984	6	0.7	4000	2.735	98.029	M4-1	0.5
39	222875	234607	6813586	6578979	222894	19	0.7	4000	2.735	98.029	M4-1	0.5
41	0	0	0	0	0	0	0.7	4000	2.735	98.029	M4-1	0.5
42	74372	74965	8559453	8484488	75520	1148	0.7	4000	2.735	98.029	M4-1	0.5
45	274768	274902	18638565	18363663	274789	21	0.7	4000	2.735	98.029	M4-1	0.5
47	0	0	0	0	0	0	0.7	4000	2.735	98.029	M4-1	0.5
48	211115	212334	24981846	24769512	211523	408	0.7	4000	2.735	98.029	M4-1	0.5
49	0	0	0	0	0	0	0.7	4000	2.735	98.029	M4-1	0.5
50	10	10	15	5	10	0	0.7	4000	2.735	98.029	M4-1	0.5
51	268325	270020	34283340	34013320	268475	150	0.7	4000	2.735	98.029	M4-1	0.5
52	0	0	0	0	0	0	0.7	4000	2.735	98.029	M4-1	0.5
53	0	0	1	1	0	0	0.7	4000	2.735	98.029	M4-1	0.5
54	249528	257003	26335653	26078650	249548	20	0.7	4000	2.735	98.029	M4-1	0.5
56	55	55	55	0	55	0	0.7	4000	2.735	98.029	M4-1	0.5
57	92014	92998	17307786	17214788	92040	26	0.7	4000	2.735	98.029	M4-1	0.5
58	0	0	0	0	0	0	0.7	4000	2.735	98.029	M4-1	0.5
60	172947	174264	15354111	15179847	172948	1	0.7	4000	2.735	98.029	M4-1	0.5
63	89734	90130	11987856	11897726	89788	54	0.7	4000	2.735	98.029	M4-1	0.5
65	0	0	0	0	0	0	0.7	4000	2.735	98.029	M4-1	0.5
66	189006	189660	8704878	8515218	189008	2	0.7	4000	2.735	98.029	M4-1	0.5
67	0	0	0	0	0	0	0.7	4000	2.735	98.029	M4-1	0.5
69	148691	148774	7634278	7485504	148697	6	0.7	4000	2.735	98.029	M4-1	0.5
72	1448204	1449473	11493615	10044142	1448209	5	0.7	4000	2.735	98.029	M4-1	0.5
73	1	1	1	0	1	0	0.7	4000	2.735	98.029	M4-1	0.5
75	18218	18309	962578	944269	18218	0	0.7	4000	2.735	98.029	M4-1	0.5
78	12180	12247	451725	439478	12180	0	0.7	4000	2.735	98.029	M4-1	0.5
81	1988	2002	126756	124754	1988	0	0.7	4000	2.735	98.029	M4-1	0.5
84	5572	5573	52650	47077	5572	0	0.7	4000	2.735	98.029	M4-1	0.5
87	620	621	12403	11782	620	0	0.7	4000	2.735	98.029	M4-1	0.5
90	218	233	4753	4520	218	0	0.7	4000	2.735	98.029	M4-1	0.5
12	0	0	0	0	0	0	0.7	4000	3.007	28.223	M3-1	0.5
24	19	19	528	509	20	1	0.7	4000	3.007	28.223	M3-1	0.5
27	1012	1012	3403	2391	1012	0	0.7	4000	3.007	28.223	M3-1	0.5
30	2244	2244	20706	18462	2266	22	0.7	4000	3.007	28.223	M3-1	0.5
33	14453	14843	188191	173348	14453	0	0.7	4000	3.007	28.223	M3-1	0.5
36	7238877	7242680	9894576	2651896	7238881	4	0.7	4000	3.007	28.223	M3-1	0.5
39	263400	263445	2729616	2466171	263400	0	0.7	4000	3.007	28.223	M3-1	0.5
42	35711	35878	2158003	2122125	35836	125	0.7	4000	3.007	28.223	M3-1	0.5
45	55347	56285	3736011	3679726	55350	3	0.7	4000	3.007	28.223	M3-1	0.5
48	728017	728177	10776403	10048226	728027	10	0.7	4000	3.007	28.223	M3-1	0.5
51	443289	443478	10131751	9688273	443296	7	0.7	4000	3.007	28.223	M3-1	0.5
54	102022	102378	5519503	5417125	102027	5	0.7	4000	3.007	28.223	M3-1	0.5
57	99636	99788	4837605	4737817	99927	291	0.7	4000	3.007	28.223	M3-1	0.5
59	0	0	0	0	0	0	0.7	4000	3.007	28.223	M3-1	0.5
60	221502	221616	3573801	3352185	221541	39	0.7	4000	3.007	28.223	M3-1	0.5
62	0	0	0	0	0	0	0.7	4000	3.007	28.223	M3-1	0.5
63	576245	576491	9748320	9171829	576245	0	0.7	4000	3.007	28.223	M3-1	0.5
64	0	0	0	0	0	0	0.7	4000	3.007	28.223	M3-1	0.5
66	293041	293128	2492028	2198900	293041	0	0.7	4000	3.007	28.223	M3-1	0.5
68	10	10	15	5	10	0	0.7	4000	3.007	28.223	M3-1	0.5
69	359721	359725	4045590	3685865	359732	11	0.7	4000	3.007	28.223	M3-1	0.5
72	72649	75317	1553203	1477886	72649	0	0.7	4000	3.007	28.223	M3-1	0.5
75	18352	18352	328455	310103	18354	2	0.7	4000	3.007	28.223	M3-1	0.5
76	0	0	0	0	0	0	0.7	4000	3.007	28.223	M3-1	0.5
78	132571	132572	773146	640574	132571	0	0.7	4000	3.007	28.223	M3-1	0.5
81	5138	5138	36585	31447	5138	0	0.7	4000	3.007	28.223	M3-1	0.5
84	623	623	9730	9107	623	0	0.7	4000	3.007	28.223	M3-1	0.5
87	478	478	6670	6192	478	0	0.7	4000	3.007	28.223	M3-1	0.5
90	294	305	2278	1973	294	0	0.7	4000	3.007	28.223	M3-1	0.5
3	0	0	0	0	0	0	0.7	4000	3.266	94.98	M2-1	0.5
12	1	1	1	0	1	0	0.7	4000	3.266	94.98	M2-1	0.5
15	0	0	0	0	0	0	0.7	4000	3.266	94.98	M2-1	0.5
24	80	80	17391	17311	132	52	0.7	4000	3.266	94.98	M2-1	0.5
27	58	58	20706	20648	65	7	0.7	4000	3.266	94.98	M2-1	0.5
30	316	317	102831	102514	326	10	0.7	4000	3.266	94.98	M2-1	0.5
33	760	781	571915	571134	808	48	0.7	4000	3.266	94.98	M2-1	0.5
36	1513	1518	1530375	1528857	1626	113	0.7	4000	3.266	94.98	M2-1	0.5
39	13374	13402	4501500	4488098	13454	80	0.7	4000	3.266	94.98	M2-1	0.5
41	0	0	0	0	0	0	0.7	4000	3.266	94.98	M2-1	0.5
42	28574	28588	10010575	9981987	29028	454	0.7	4000	3.266	94.98	M2-1	0.5
43	0	0	1	1	0	0	0.7	4000	3.266	94.98	M2-1	0.5
45	13514	15621	16522626	16507005	13659	145	0.7	4000	3.266	94.98	M2-1	0.5
46	0	0	1	1	0	0	0.7	4000	3.266	94.98	M2-1	0.5
48	29292	32345	24398605	24366260	29421	129	0.7	4000	3.266	94.98	M2-1	0.5
51	13347	14167	23988201	23974034	13643	296	0.7	4000	3.266	94.98	M2-1	0.5
52	0	0	0	0	0	0	0.7	4000	3.266	94.98	M2-1	0.5
54	32985	34863	24217320	24182457	33094	109	0.7	4000	3.266	94.98	M2-1	0.5
55	0	0	0	0	0	0	0.7	4000	3.266	94.98	M2-1	0.5
57	27471	28771	23932821	23904050	28280	809	0.7	4000	3.266	94.98	M2-1	0.5
58	0	0	0	0	0	0	0.7	4000	3.266	94.98	M2-1	0.5
59	0	0	1	1	0	0	0.7	4000	3.266	94.98	M2-1	0.5
60	13078	14059	16869336	16855277	13135	57	0.7	4000	3.266	94.98	M2-1	0.5
61	0	0	0	0	0	0	0.7	4000	3.266	94.98	M2-1	0.5
62	0	0	0	0	0	0	0.7	4000	3.266	94.98	M2-1	0.5
63	19181	19873	11608971	11589098	19219	38	0.7	4000	3.266	94.98	M2-1	0.5
64	0	0	0	0	0	0	0.7	4000	3.266	94.98	M2-1	0.5
66	42511	42563	7755891	7713328	42534	23	0.7	4000	3.266	94.98	M2-1	0.5
68	0	0	0	0	0	0	0.7	4000	3.266	94.98	M2-1	0.5
69	2709	2772	4928230	4925458	2756	47	0.7	4000	3.266	94.98	M2-1	0.5
72	2708	2716	2248260	2245544	2739	31	0.7	4000	3.266	94.98	M2-1	0.5
73	0	0	1	1	0	0	0.7	4000	3.266	94.98	M2-1	0.5
75	166295	166303	2494261	2327958	166302	7	0.7	4000	3.266	94.98	M2-1	0.5
78	606	617	541320	540703	626	20	0.7	4000	3.266	94.98	M2-1	0.5
81	18083	18097	402753	384656	18083	0	0.7	4000	3.266	94.98	M2-1	0.5
84	295	296	95703	95407	295	0	0.7	4000	3.266	94.98	M2-1	0.5
87	93	102	20100	19998	93	0	0.7	4000	3.266	94.98	M2-1	0.5
90	2	2	9045	9043	2	0	0.7	4000	3.266	94.98	M2-1	0.5
6	0	0	0	0	0	0	0.7	4000	5.11	113.332	M5-1	0.5
8	3	6	6	0	3	0	0.7	4000	5.11	113.332	M5-1	0.5
9	28	28	28	0	28	0	0.7	4000	5.11	113.332	M5-1	0.5
24	9161	9286	76636	67350	9282	121	0.7	4000	5.11	113.332	M5-1	0.5
27	9928	11312	53956	42644	9928	0	0.7	4000	5.11	113.332	M5-1	0.5
30	84740	84807	512578	427771	84741	1	0.7	4000	5.11	113.332	M5-1	0.5
33	15278	16399	1097421	1081022	15288	10	0.7	4000	5.11	113.332	M5-1	0.5
35	0	0	0	0	0	0	0.7	4000	5.11	113.332	M5-1	0.5
36	38436	38513	3324331	3285818	38468	32	0.7	4000	5.11	113.332	M5-1	0.5
37	0	0	0	0	0	0	0.7	4000	5.11	113.332	M5-1	0.5
39	77192	78081	8914753	8836672	77195	3	0.7	4000	5.11	113.332	M5-1	0.5
40	0	0	0	0	0	0	0.7	4000	5.11	113.332	M5-1	0.5
42	167924	168038	24440536	24272498	168342	418	0.7	4000	5.11	113.332	M5-1	0.5
45	171936	190901	46527481	46336580	172090	154	0.7	4000	5.11	113.332	M5-1	0.5
47	0	0	0	0	0	0	0.7	4000	5.11	113.332	M5-1	0.5
48	408263	430088	84142878	83712790	408768	505	0.7	4000	5.11	113.332	M5-1	0.5
49	0	0	0	0	0	0	0.7	4000	5.11	113.332	M5-1	0.5
51	266382	283513	65259600	64976087	268094	1712	0.7	4000	5.11	113.332	M5-1	0.5
54	346470	394658	62826445	62431787	346491	21	0.7	4000	5.11	113.332	M5-1	0.5
55	1	1	1	0	1	0	0.7	4000	5.11	113.332	M5-1	0.5
57	387637	402140	60077241	59675101	387719	82	0.7	4000	5.11	113.332	M5-1	0.5
58	0	0	0	0	0	0	0.7	4000	5.11	113.332	M5-1	0.5
59	0	0	0	0	0	0	0.7	4000	5.11	113.332	M5-1	0.5
60	117374	141584	42878430	42736846	117655	281	0.7	4000	5.11	113.332	M5-1	0.5
61	0	1	1	0	0	0	0.7	4000	5.11	113.332	M5-1	0.5
62	3	3	6	3	3	0	0.7	4000	5.11	113.332	M5-1	0.5
63	274521	283443	33020001	32736558	274568	47	0.7	4000	5.11	113.332	M5-1	0.5
64	0	0	0	0	0	0	0.7	4000	5.11	113.332	M5-1	0.5
66	145574	146922	23225520	23078598	145574	0	0.7	4000	5.11	113.332	M5-1	0.5
69	210440	210783	17877210	17666427	210476	36	0.7	4000	5.11	113.332	M5-1	0.5
72	197745	198785	11005086	10806301	197959	214	0.7	4000	5.11	113.332	M5-1	0.5
75	27238	27401	2809635	2782234	27242	4	0.7	4000	5.11	113.332	M5-1	0.5
76	0	0	0	0	0	0	0.7	4000	5.11	113.332	M5-1	0.5
78	57391	58159	2273778	2215619	57391	0	0.7	4000	5.11	113.332	M5-1	0.5
81	14868	14958	644680	629722	14868	0	0.7	4000	5.11	113.332	M5-1	0.5
84	29235	29526	328455	298929	29235	0	0.7	4000	5.11	113.332	M5-1	0.5
87	4182	4182	52650	48468	4185	3	0.7	4000	5.11	113.332	M5-1	0.5
90	2090	2090	18721	16631	2090	0	0.7	4000	5.11	113.332	M5-1	0.5
3	0	0	0	0	0	0	0.7	5000	1.561	90.678	M4-1	0.5
6	0	0	0	0	0	0	0.7	5000	1.561	90.678	M4-1	0.5
24	73	75	3570	3495	73	0	0.7	5000	1.561	90.678	M4-1	0.5
27	6507	6507	43071	36564	6513	6	0.7	5000	1.561	90.678	M4-1	0.5
30	709	716	40755	40039	714	5	0.7	5000	1.561	90.678	M4-1	0.5
33	33957	33984	424581	390597	33957	0	0.7	5000	1.561	90.678	M4-1	0.5
36	4978	4979	458403	453424	4984	6	0.7	5000	1.561	90.678	M4-1	0.5
39	222875	234607	6813586	6578979	222894	19	0.7	5000	1.561	90.678	M4-1	0.5
41	0	0	0	0	0	0	0.7	5000	1.561	90.678	M4-1	0.5
42	74372	74965	8559453	8484488	75520	1148	0.7	5000	1.561	90.678	M4-1	0.5
45	274768	274902	18638565	18363663	274789	21	0.7	5000	1.561	90.678	M4-1	0.5
47	0	0	0	0	0	0	0.7	5000	1.561	90.678	M4-1	0.5
48	211115	212334	24981846	24769512	211523	408	0.7	5000	1.561	90.678	M4-1	0.5
49	0	0	0	0	0	0	0.7	5000	1.561	90.678	M4-1	0.5
50	10	10	15	5	10	0	0.7	5000	1.561	90.678	M4-1	0.5
51	268325	270020	34283340	34013320	268475	150	0.7	5000	1.561	90.678	M4-1	0.5
52	0	0	0	0	0	0	0.7	5000	1.561	90.678	M4-1	0.5
53	0	0	1	1	0	0	0.7	5000	1.561	90.678	M4-1	0.5
54	249528	257003	26335653	26078650	249548	20	0.7	5000	1.561	90.678	M4-1	0.5
56	55	55	55	0	55	0	0.7	5000	1.561	90.678	M4-1	0.5
57	92014	92998	17307786	17214788	92040	26	0.7	5000	1.561	90.678	M4-1	0.5
58	0	0	0	0	0	0	0.7	5000	1.561	90.678	M4-1	0.5
60	172947	174264	15354111	15179847	172948	1	0.7	5000	1.561	90.678	M4-1	0.5
63	89734	90130	11987856	11897726	89788	54	0.7	5000	1.561	90.678	M4-1	0.5
65	0	0	0	0	0	0	0.7	5000	1.561	90.678	M4-1	0.5
66	189006	189660	8704878	8515218	189008	2	0.7	5000	1.561	90.678	M4-1	0.5
67	0	0	0	0	0	0	0.7	5000	1.561	90.678	M4-1	0.5
69	148691	148774	7634278	7485504	148697	6	0.7	5000	1.561	90.678	M4-1	0.5
72	1448204	1449473	11493615	10044142	1448209	5	0.7	5000	1.561	90.678	M4-1	0.5
73	1	1	1	0	1	0	0.7	5000	1.561	90.678	M4-1	0.5
75	18218	18309	962578	944269	18218	0	0.7	5000	1.561	90.678	M4-1	0.5
78	12180	12247	451725	439478	12180	0	0.7	5000	1.561	90.678	M4-1	0.5
81	1988	2002	126756	124754	1988	0	0.7	5000	1.561	90.678	M4-1	0.5
84	5572	5573	52650	47077	5572	0	0.7	5000	1.561	90.678	M4-1	0.5
87	620	621	12403	11782	620	0	0.7	5000	1.561	90.678	M4-1	0.5
90	218	233	4753	4520	218	0	0.7	5000	1.561	90.678	M4-1	0.5
12	0	0	0	0	0	0	0.7	5000	2.925	28.498	M3-1	0.5
24	19	19	528	509	20	1	0.7	5000	2.925	28.498	M3-1	0.5
27	1012	1012	3403	2391	1012	0	0.7	5000	2.925	28.498	M3-1	0.5
30	2244	2244	20706	18462	2266	22	0.7	5000	2.925	28.498	M3-1	0.5
33	14453	14843	188191	173348	14453	0	0.7	5000	2.925	28.498	M3-1	0.5
36	7238877	7242680	9894576	2651896	7238881	4	0.7	5000	2.925	28.498	M3-1	0.5
39	263400	263445	2729616	2466171	263400	0	0.7	5000	2.925	28.498	M3-1	0.5
42	35711	35878	2158003	2122125	35836	125	0.7	5000	2.925	28.498	M3-1	0.5
45	55347	56285	3736011	3679726	55350	3	0.7	5000	2.925	28.498	M3-1	0.5
48	728017	728177	10776403	10048226	728027	10	0.7	5000	2.925	28.498	M3-1	0.5
51	443289	443478	10131751	9688273	443296	7	0.7	5000	2.925	28.498	M3-1	0.5
54	102022	102378	5519503	5417125	102027	5	0.7	5000	2.925	28.498	M3-1	0.5
57	99636	99788	4837605	4737817	99927	291	0.7	5000	2.925	28.498	M3-1	0.5
59	0	0	0	0	0	0	0.7	5000	2.925	28.498	M3-1	0.5
60	221502	221616	3573801	3352185	221541	39	0.7	5000	2.925	28.498	M3-1	0.5
62	0	0	0	0	0	0	0.7	5000	2.925	28.498	M3-1	0.5
63	576245	576491	9748320	9171829	576245	0	0.7	5000	2.925	28.498	M3-1	0.5
64	0	0	0	0	0	0	0.7	5000	2.925	28.498	M3-1	0.5
66	293041	293128	2492028	2198900	293041	0	0.7	5000	2.925	28.498	M3-1	0.5
68	10	10	15	5	10	0	0.7	5000	2.925	28.498	M3-1	0.5
69	359721	359725	4045590	3685865	359732	11	0.7	5000	2.925	28.498	M3-1	0.5
72	72649	75317	1553203	1477886	72649	0	0.7	5000	2.925	28.498	M3-1	0.5
75	18352	18352	328455	310103	18354	2	0.7	5000	2.925	28.498	M3-1	0.5
76	0	0	0	0	0	0	0.7	5000	2.925	28.498	M3-1	0.5
78	132571	132572	773146	640574	132571	0	0.7	5000	2.925	28.498	M3-1	0.5
81	5138	5138	36585	31447	5138	0	0.7	5000	2.925	28.498	M3-1	0.5
84	623	623	9730	9107	623	0	0.7	5000	2.925	28.498	M3-1	0.5
87	478	478	6670	6192	478	0	0.7	5000	2.925	28.498	M3-1	0.5
90	294	305	2278	1973	294	0	0.7	5000	2.925	28.498	M3-1	0.5
6	0	0	0	0	0	0	0.7	5000	3.357	141.535	M5-1	0.5
8	3	6	6	0	3	0	0.7	5000	3.357	141.535	M5-1	0.5
9	28	28	28	0	28	0	0.7	5000	3.357	141.535	M5-1	0.5
24	9161	9286	76636	67350	9282	121	0.7	5000	3.357	141.535	M5-1	0.5
27	9928	11312	53956	42644	9928	0	0.7	5000	3.357	141.535	M5-1	0.5
30	84740	84807	512578	427771	84741	1	0.7	5000	3.357	141.535	M5-1	0.5
33	15278	16399	1097421	1081022	15288	10	0.7	5000	3.357	141.535	M5-1	0.5
35	0	0	0	0	0	0	0.7	5000	3.357	141.535	M5-1	0.5
36	38436	38513	3324331	3285818	38468	32	0.7	5000	3.357	141.535	M5-1	0.5
37	0	0	0	0	0	0	0.7	5000	3.357	141.535	M5-1	0.5
39	77192	78081	8914753	8836672	77195	3	0.7	5000	3.357	141.535	M5-1	0.5
40	0	0	0	0	0	0	0.7	5000	3.357	141.535	M5-1	0.5
42	167924	168038	24440536	24272498	168342	418	0.7	5000	3.357	141.535	M5-1	0.5
45	190403	190901	46527481	46336580	190700	297	0.7	5000	3.357	141.535	M5-1	0.5
47	0	0	0	0	0	0	0.7	5000	3.357	141.535	M5-1	0.5
48	408263	430088	84142878	83712790	408768	505	0.7	5000	3.357	141.535	M5-1	0.5
49	0	0	0	0	0	0	0.7	5000	3.357	141.535	M5-1	0.5
51	266382	283513	65259600	64976087	268094	1712	0.7	5000	3.357	141.535	M5-1	0.5
54	346470	394658	62826445	62431787	346491	21	0.7	5000	3.357	141.535	M5-1	0.5
55	1	1	1	0	1	0	0.7	5000	3.357	141.535	M5-1	0.5
57	387637	402140	60077241	59675101	387719	82	0.7	5000	3.357	141.535	M5-1	0.5
58	0	0	0	0	0	0	0.7	5000	3.357	141.535	M5-1	0.5
59	0	0	0	0	0	0	0.7	5000	3.357	141.535	M5-1	0.5
60	117374	141584	42878430	42736846	117655	281	0.7	5000	3.357	141.535	M5-1	0.5
61	0	1	1	0	0	0	0.7	5000	3.357	141.535	M5-1	0.5
62	3	3	6	3	3	0	0.7	5000	3.357	141.535	M5-1	0.5
63	282636	283443	33020001	32736558	282710	74	0.7	5000	3.357	141.535	M5-1	0.5
64	0	0	0	0	0	0	0.7	5000	3.357	141.535	M5-1	0.5
66	145574	146922	23225520	23078598	145574	0	0.7	5000	3.357	141.535	M5-1	0.5
69	210440	210783	17877210	17666427	210476	36	0.7	5000	3.357	141.535	M5-1	0.5
72	197745	198785	11005086	10806301	197959	214	0.7	5000	3.357	141.535	M5-1	0.5
75	27238	27401	2809635	2782234	27242	4	0.7	5000	3.357	141.535	M5-1	0.5
76	0	0	0	0	0	0	0.7	5000	3.357	141.535	M5-1	0.5
78	57391	58159	2273778	2215619	57391	0	0.7	5000	3.357	141.535	M5-1	0.5
81	14868	14958	644680	629722	14868	0	0.7	5000	3.357	141.535	M5-1	0.5
84	29235	29526	328455	298929	29235	0	0.7	5000	3.357	141.535	M5-1	0.5
87	4182	4182	52650	48468	4185	3	0.7	5000	3.357	141.535	M5-1	0.5
90	2090	2090	18721	16631	2090	0	0.7	5000	3.357	141.535	M5-1	0.5
3	0	0	0	0	0	0	0.7	5000	5.724	135.271	M2-1	0.5
12	1	1	1	0	1	0	0.7	5000	5.724	135.271	M2-1	0.5
15	0	0	0	0	0	0	0.7	5000	5.724	135.271	M2-1	0.5
24	80	80	17391	17311	132	52	0.7	5000	5.724	135.271	M2-1	0.5
27	58	58	20706	20648	65	7	0.7	5000	5.724	135.271	M2-1	0.5
30	316	317	102831	102514	326	10	0.7	5000	5.724	135.271	M2-1	0.5
33	760	781	571915	571134	808	48	0.7	5000	5.724	135.271	M2-1	0.5
36	1513	1518	1530375	1528857	1626	113	0.7	5000	5.724	135.271	M2-1	0.5
39	13374	13402	4501500	4488098	13454	80	0.7	5000	5.724	135.271	M2-1	0.5
41	0	0	0	0	0	0	0.7	5000	5.724	135.271	M2-1	0.5
42	28574	28588	10010575	9981987	29028	454	0.7	5000	5.724	135.271	M2-1	0.5
43	0	0	1	1	0	0	0.7	5000	5.724	135.271	M2-1	0.5
45	15556	15621	16522626	16507005	15908	352	0.7	5000	5.724	135.271	M2-1	0.5
46	0	0	1	1	0	0	0.7	5000	5.724	135.271	M2-1	0.5
48	29292	32345	24398605	24366260	29421	129	0.7	5000	5.724	135.271	M2-1	0.5
51	13347	14167	23988201	23974034	13643	296	0.7	5000	5.724	135.271	M2-1	0.5
52	0	0	0	0	0	0	0.7	5000	5.724	135.271	M2-1	0.5
54	32985	34863	24217320	24182457	33094	109	0.7	5000	5.724	135.271	M2-1	0.5
55	0	0	0	0	0	0	0.7	5000	5.724	135.271	M2-1	0.5
57	27471	28771	23932821	23904050	28280	809	0.7	5000	5.724	135.271	M2-1	0.5
58	0	0	0	0	0	0	0.7	5000	5.724	135.271	M2-1	0.5
59	0	0	1	1	0	0	0.7	5000	5.724	135.271	M2-1	0.5
60	13078	14059	16869336	16855277	13135	57	0.7	5000	5.724	135.271	M2-1	0.5
61	0	0	0	0	0	0	0.7	5000	5.724	135.271	M2-1	0.5
62	0	0	0	0	0	0	0.7	5000	5.724	135.271	M2-1	0.5
63	19819	19873	11608971	11589098	19919	100	0.7	5000	5.724	135.271	M2-1	0.5
64	0	0	0	0	0	0	0.7	5000	5.724	135.271	M2-1	0.5
66	42511	42563	7755891	7713328	42534	23	0.7	5000	5.724	135.271	M2-1	0.5
68	0	0	0	0	0	0	0.7	5000	5.724	135.271	M2-1	0.5
69	2709	2772	4928230	4925458	2756	47	0.7	5000	5.724	135.271	M2-1	0.5
72	2708	2716	2248260	2245544	2739	31	0.7	5000	5.724	135.271	M2-1	0.5
73	0	0	1	1	0	0	0.7	5000	5.724	135.271	M2-1	0.5
75	166295	166303	2494261	2327958	166302	7	0.7	5000	5.724	135.271	M2-1	0.5
78	606	617	541320	540703	626	20	0.7	5000	5.724	135.271	M2-1	0.5
81	18083	18097	402753	384656	18083	0	0.7	5000	5.724	135.271	M2-1	0.5
84	295	296	95703	95407	295	0	0.7	5000	5.724	135.271	M2-1	0.5
87	93	102	20100	19998	93	0	0.7	5000	5.724	135.271	M2-1	0.5
90	2	2	9045	9043	2	0	0.7	5000	5.724	135.271	M2-1	0.5
3	0	0	0	0	0	0	0.8	1000	20.0	30.422	M4-1	0.5
6	0	0	0	0	0	0	0.8	1000	20.0	30.422	M4-1	0.5
24	73	75	3570	3495	73	0	0.8	1000	20.0	30.422	M4-1	0.5
27	6507	6507	43071	36564	6513	6	0.8	1000	20.0	30.422	M4-1	0.5
30	709	716	40755	40039	714	5	0.8	1000	20.0	30.422	M4-1	0.5
33	33957	33984	424581	390597	33957	0	0.8	1000	20.0	30.422	M4-1	0.5
36	4978	4979	458403	453424	4984	6	0.8	1000	20.0	30.422	M4-1	0.5
39	207301	234607	6813586	6578979	207316	15	0.8	1000	20.0	30.422	M4-1	0.5
41	0	0	0	0	0	0	0.8	1000	20.0	30.422	M4-1	0.5
42	69980	74965	8559453	8484488	71044	1064	0.8	1000	20.0	30.422	M4-1	0.5
45	238309	274902	18638565	18363663	238328	19	0.8	1000	20.0	30.422	M4-1	0.5
47	0	0	0	0	0	0	0.8	1000	20.0	30.422	M4-1	0.5
48	156437	212334	24981846	24769512	156638	201	0.8	1000	20.0	30.422	M4-1	0.5
49	0	0	0	0	0	0	0.8	1000	20.0	30.422	M4-1	0.5
50	10	10	15	5	10	0	0.8	1000	20.0	30.422	M4-1	0.5
51	206345	270020	34283340	34013320	206481	136	0.8	1000	20.0	30.422	M4-1	0.5
52	0	0	0	0	0	0	0.8	1000	20.0	30.422	M4-1	0.5
53	0	0	1	1	0	0	0.8	1000	20.0	30.422	M4-1	0.5
54	211615	257003	26335653	26078650	211630	15	0.8	1000	20.0	30.422	M4-1	0.5
56	55	55	55	0	55	0	0.8	1000	20.0	30.422	M4-1	0.5
57	86647	92998	17307786	17214788	86667	20	0.8	1000	20.0	30.422	M4-1	0.5
58	0	0	0	0	0	0	0.8	1000	20.0	30.422	M4-1	0.5
60	165048	174264	15354111	15179847	165049	1	0.8	1000	20.0	30.422	M4-1	0.5
63	84028	90130	11987856	11897726	84080	52	0.8	1000	20.0	30.422	M4-1	0.5
65	0	0	0	0	0	0	0.8	1000	20.0	30.422	M4-1	0.5
66	153455	189660	8704878	8515218	153455	0	0.8	1000	20.0	30.422	M4-1	0.5
67	0	0	0	0	0	0	0.8	1000	20.0	30.422	M4-1	0.5
69	146488	148774	7634278	7485504	146494	6	0.8	1000	20.0	30.422	M4-1	0.5
72	1443911	1449473	11493615	10044142	1443916	5	0.8	1000	20.0	30.422	M4-1	0.5
73	1	1	1	0	1	0	0.8	1000	20.0	30.422	M4-1	0.5
75	18218	18309	962578	944269	18218	0	0.8	1000	20.0	30.422	M4-1	0.5
78	12180	12247	451725	439478	12180	0	0.8	1000	20.0	30.422	M4-1	0.5
81	1988	2002	126756	124754	1988	0	0.8	1000	20.0	30.422	M4-1	0.5
84	5572	5573	52650	47077	5572	0	0.8	1000	20.0	30.422	M4-1	0.5
87	620	621	12403	11782	620	0	0.8	1000	20.0	30.422	M4-1	0.5
90	218	233	4753	4520	218	0	0.8	1000	20.0	30.422	M4-1	0.5
3	0	0	0	0	0	0	0.8	1000	28.7	48.265	M2-1	0.5
12	1	1	1	0	1	0	0.8	1000	28.7	48.265	M2-1	0.5
15	0	0	0	0	0	0	0.8	1000	28.7	48.265	M2-1	0.5
24	80	80	17391	17311	132	52	0.8	1000	28.7	48.265	M2-1	0.5
27	58	58	20706	20648	65	7	0.8	1000	28.7	48.265	M2-1	0.5
30	316	317	102831	102514	326	10	0.8	1000	28.7	48.265	M2-1	0.5
33	760	781	571915	571134	808	48	0.8	1000	28.7	48.265	M2-1	0.5
36	1382	1518	1530375	1528857	1477	95	0.8	1000	28.7	48.265	M2-1	0.5
39	13122	13402	4501500	4488098	13154	32	0.8	1000	28.7	48.265	M2-1	0.5
41	0	0	0	0	0	0	0.8	1000	28.7	48.265	M2-1	0.5
42	27404	28588	10010575	9981987	27538	134	0.8	1000	28.7	48.265	M2-1	0.5
43	0	0	1	1	0	0	0.8	1000	28.7	48.265	M2-1	0.5
45	12864	15621	16522626	16507005	13002	138	0.8	1000	28.7	48.265	M2-1	0.5
46	0	0	1	1	0	0	0.8	1000	28.7	48.265	M2-1	0.5
48	22162	32345	24398605	24366260	22226	64	0.8	1000	28.7	48.265	M2-1	0.5
51	11211	14167	23988201	23974034	11335	124	0.8	1000	28.7	48.265	M2-1	0.5
52	0	0	0	0	0	0	0.8	1000	28.7	48.265	M2-1	0.5
54	31345	34863	24217320	24182457	31419	74	0.8	1000	28.7	48.265	M2-1	0.5
55	0	0	0	0	0	0	0.8	1000	28.7	48.265	M2-1	0.5
57	24090	28771	23932821	23904050	24592	502	0.8	1000	28.7	48.265	M2-1	0.5
58	0	0	0	0	0	0	0.8	1000	28.7	48.265	M2-1	0.5
59	0	0	1	1	0	0	0.8	1000	28.7	48.265	M2-1	0.5
60	11789	14059	16869336	16855277	11840	51	0.8	1000	28.7	48.265	M2-1	0.5
61	0	0	0	0	0	0	0.8	1000	28.7	48.265	M2-1	0.5
62	0	0	0	0	0	0	0.8	1000	28.7	48.265	M2-1	0.5
63	18691	19873	11608971	11589098	18742	51	0.8	1000	28.7	48.265	M2-1	0.5
64	0	0	0	0	0	0	0.8	1000	28.7	48.265	M2-1	0.5
66	42163	42563	7755891	7713328	42186	23	0.8	1000	28.7	48.265	M2-1	0.5
68	0	0	0	0	0	0	0.8	1000	28.7	48.265	M2-1	0.5
69	2522	2772	4928230	4925458	2561	39	0.8	1000	28.7	48.265	M2-1	0.5
72	2603	2716	2248260	2245544	2621	18	0.8	1000	28.7	48.265	M2-1	0.5
73	0	0	1	1	0	0	0.8	1000	28.7	48.265	M2-1	0.5
75	166274	166303	2494261	2327958	166278	4	0.8	1000	28.7	48.265	M2-1	0.5
78	606	617	541320	540703	626	20	0.8	1000	28.7	48.265	M2-1	0.5
81	18083	18097	402753	384656	18083	0	0.8	1000	28.7	48.265	M2-1	0.5
84	295	296	95703	95407	295	0	0.8	1000	28.7	48.265	M2-1	0.5
87	93	102	20100	19998	93	0	0.8	1000	28.7	48.265	M2-1	0.5
90	2	2	9045	9043	2	0	0.8	1000	28.7	48.265	M2-1	0.5
6	0	0	0	0	0	0	0.8	1000	32.662	55.245	M5-1	0.5
8	3	6	6	0	3	0	0.8	1000	32.662	55.245	M5-1	0.5
9	28	28	28	0	28	0	0.8	1000	32.662	55.245	M5-1	0.5
24	9161	9286	76636	67350	9282	121	0.8	1000	32.662	55.245	M5-1	0.5
27	9928	11312	53956	42644	9928	0	0.8	1000	32.662	55.245	M5-1	0.5
30	84740	84807	512578	427771	84741	1	0.8	1000	32.662	55.245	M5-1	0.5
33	15278	16399	1097421	1081022	15288	10	0.8	1000	32.662	55.245	M5-1	0.5
35	0	0	0	0	0	0	0.8	1000	32.662	55.245	M5-1	0.5
36	34187	38513	3324331	3285818	34198	11	0.8	1000	32.662	55.245	M5-1	0.5
37	0	0	0	0	0	0	0.8	1000	32.662	55.245	M5-1	0.5
39	69837	78081	8914753	8836672	69840	3	0.8	1000	32.662	55.245	M5-1	0.5
40	0	0	0	0	0	0	0.8	1000	32.662	55.245	M5-1	0.5
42	139703	168038	24440536	24272498	140120	417	0.8	1000	32.662	55.245	M5-1	0.5
45	164850	190901	46527481	46336580	165004	154	0.8	1000	32.662	55.245	M5-1	0.5
47	0	0	0	0	0	0	0.8	1000	32.662	55.245	M5-1	0.5
48	338053	430088	84142878	83712790	338560	507	0.8	1000	32.662	55.245	M5-1	0.5
49	0	0	0	0	0	0	0.8	1000	32.662	55.245	M5-1	0.5
51	203447	283513	65259600	64976087	205186	1739	0.8	1000	32.662	55.245	M5-1	0.5
54	321242	394658	62826445	62431787	321280	38	0.8	1000	32.662	55.245	M5-1	0.5
55	1	1	1	0	1	0	0.8	1000	32.662	55.245	M5-1	0.5
57	368367	402140	60077241	59675101	368578	211	0.8	1000	32.662	55.245	M5-1	0.5
58	0	0	0	0	0	0	0.8	1000	32.662	55.245	M5-1	0.5
59	0	0	0	0	0	0	0.8	1000	32.662	55.245	M5-1	0.5
60	116673	141584	42878430	42736846	116966	293	0.8	1000	32.662	55.245	M5-1	0.5
61	0	1	1	0	0	0	0.8	1000	32.662	55.245	M5-1	0.5
62	3	3	6	3	3	0	0.8	1000	32.662	55.245	M5-1	0.5
63	258255	283443	33020001	32736558	258312	57	0.8	1000	32.662	55.245	M5-1	0.5
64	0	0	0	0	0	0	0.8	1000	32.662	55.245	M5-1	0.5
66	121523	146922	23225520	23078598	121523	0	0.8	1000	32.662	55.245	M5-1	0.5
69	198790	210783	17877210	17666427	198807	17	0.8	1000	32.662	55.245	M5-1	0.5
72	187423	198785	11005086	10806301	187506	83	0.8	1000	32.662	55.245	M5-1	0.5
75	26598	27401	2809635	2782234	26602	4	0.8	1000	32.662	55.245	M5-1	0.5
76	0	0	0	0	0	0	0.8	1000	32.662	55.245	M5-1	0.5
78	46351	58159	2273778	2215619	46351	0	0.8	1000	32.662	55.245	M5-1	0.5
81	14868	14958	644680	629722	14868	0	0.8	1000	32.662	55.245	M5-1	0.5
84	29235	29526	328455	298929	29235	0	0.8	1000	32.662	55.245	M5-1	0.5
87	4182	4182	52650	48468	4185	3	0.8	1000	32.662	55.245	M5-1	0.5
90	2090	2090	18721	16631	2090	0	0.8	1000	32.662	55.245	M5-1	0.5
12	0	0	0	0	0	0	0.8	1000	5.653	19.929	M3-1	0.5
24	19	19	528	509	20	1	0.8	1000	5.653	19.929	M3-1	0.5
27	1012	1012	3403	2391	1012	0	0.8	1000	5.653	19.929	M3-1	0.5
30	2244	2244	20706	18462	2266	22	0.8	1000	5.653	19.929	M3-1	0.5
33	14453	14843	188191	173348	14453	0	0.8	1000	5.653	19.929	M3-1	0.5
36	7238877	7242680	9894576	2651896	7238881	4	0.8	1000	5.653	19.929	M3-1	0.5
39	263400	263445	2729616	2466171	263400	0	0.8	1000	5.653	19.929	M3-1	0.5
42	35711	35878	2158003	2122125	35836	125	0.8	1000	5.653	19.929	M3-1	0.5
45	52589	56285	3736011	3679726	52592	3	0.8	1000	5.653	19.929	M3-1	0.5
48	726089	728177	10776403	10048226	726099	10	0.8	1000	5.653	19.929	M3-1	0.5
51	439801	443478	10131751	9688273	439808	7	0.8	1000	5.653	19.929	M3-1	0.5
54	101882	102378	5519503	5417125	101886	4	0.8	1000	5.653	19.929	M3-1	0.5
57	99612	99788	4837605	4737817	99903	291	0.8	1000	5.653	19.929	M3-1	0.5
59	0	0	0	0	0	0	0.8	1000	5.653	19.929	M3-1	0.5
60	221437	221616	3573801	3352185	221476	39	0.8	1000	5.653	19.929	M3-1	0.5
62	0	0	0	0	0	0	0.8	1000	5.653	19.929	M3-1	0.5
63	511688	576491	9748320	9171829	511688	0	0.8	1000	5.653	19.929	M3-1	0.5
64	0	0	0	0	0	0	0.8	1000	5.653	19.929	M3-1	0.5
66	293041	293128	2492028	2198900	293041	0	0.8	1000	5.653	19.929	M3-1	0.5
68	10	10	15	5	10	0	0.8	1000	5.653	19.929	M3-1	0.5
69	359469	359725	4045590	3685865	359480	11	0.8	1000	5.653	19.929	M3-1	0.5
72	72649	75317	1553203	1477886	72649	0	0.8	1000	5.653	19.929	M3-1	0.5
75	18352	18352	328455	310103	18354	2	0.8	1000	5.653	19.929	M3-1	0.5
76	0	0	0	0	0	0	0.8	1000	5.653	19.929	M3-1	0.5
78	132571	132572	773146	640574	132571	0	0.8	1000	5.653	19.929	M3-1	0.5
81	5138	5138	36585	31447	5138	0	0.8	1000	5.653	19.929	M3-1	0.5
84	623	623	9730	9107	623	0	0.8	1000	5.653	19.929	M3-1	0.5
87	478	478	6670	6192	478	0	0.8	1000	5.653	19.929	M3-1	0.5
90	294	305	2278	1973	294	0	0.8	1000	5.653	19.929	M3-1	0.5
6	0	0	0	0	0	0	0.8	2000	12.256	80.806	M5-1	0.5
8	3	6	6	0	3	0	0.8	2000	12.256	80.806	M5-1	0.5
9	28	28	28	0	28	0	0.8	2000	12.256	80.806	M5-1	0.5
24	9161	9286	76636	67350	9282	121	0.8	2000	12.256	80.806	M5-1	0.5
27	9928	11312	53956	42644	9928	0	0.8	2000	12.256	80.806	M5-1	0.5
30	84740	84807	512578	427771	84741	1	0.8	2000	12.256	80.806	M5-1	0.5
33	15278	16399	1097421	1081022	15288	10	0.8	2000	12.256	80.806	M5-1	0.5
35	0	0	0	0	0	0	0.8	2000	12.256	80.806	M5-1	0.5
36	38436	38513	3324331	3285818	38468	32	0.8	2000	12.256	80.806	M5-1	0.5
37	0	0	0	0	0	0	0.8	2000	12.256	80.806	M5-1	0.5
39	70747	78081	8914753	8836672	70750	3	0.8	2000	12.256	80.806	M5-1	0.5
40	0	0	0	0	0	0	0.8	2000	12.256	80.806	M5-1	0.5
42	153023	168038	24440536	24272498	153440	417	0.8	2000	12.256	80.806	M5-1	0.5
45	169767	190901	46527481	46336580	169870	103	0.8	2000	12.256	80.806	M5-1	0.5
47	0	0	0	0	0	0	0.8	2000	12.256	80.806	M5-1	0.5
48	373424	430088	84142878	83712790	373940	516	0.8	2000	12.256	80.806	M5-1	0.5
49	0	0	0	0	0	0	0.8	2000	12.256	80.806	M5-1	0.5
51	251834	283513	65259600	64976087	253610	1776	0.8	2000	12.256	80.806	M5-1	0.5
54	345765	394658	62826445	62431787	345876	111	0.8	2000	12.256	80.806	M5-1	0.5
55	1	1	1	0	1	0	0.8	2000	12.256	80.806	M5-1	0.5
57	377333	402140	60077241	59675101	377532	199	0.8	2000	12.256	80.806	M5-1	0.5
58	0	0	0	0	0	0	0.8	2000	12.256	80.806	M5-1	0.5
59	0	0	0	0	0	0	0.8	2000	12.256	80.806	M5-1	0.5
60	118900	141584	42878430	42736846	119239	339	0.8	2000	12.256	80.806	M5-1	0.5
61	0	1	1	0	0	0	0.8	2000	12.256	80.806	M5-1	0.5
62	3	3	6	3	3	0	0.8	2000	12.256	80.806	M5-1	0.5
63	273345	283443	33020001	32736558	273405	60	0.8	2000	12.256	80.806	M5-1	0.5
64	0	0	0	0	0	0	0.8	2000	12.256	80.806	M5-1	0.5
66	119487	146922	23225520	23078598	119487	0	0.8	2000	12.256	80.806	M5-1	0.5
69	204960	210783	17877210	17666427	204982	22	0.8	2000	12.256	80.806	M5-1	0.5
72	192832	198785	11005086	10806301	192915	83	0.8	2000	12.256	80.806	M5-1	0.5
75	27238	27401	2809635	2782234	27242	4	0.8	2000	12.256	80.806	M5-1	0.5
76	0	0	0	0	0	0	0.8	2000	12.256	80.806	M5-1	0.5
78	57391	58159	2273778	2215619	57391	0	0.8	2000	12.256	80.806	M5-1	0.5
81	14868	14958	644680	629722	14868	0	0.8	2000	12.256	80.806	M5-1	0.5
84	29235	29526	328455	298929	29235	0	0.8	2000	12.256	80.806	M5-1	0.5
87	4182	4182	52650	48468	4185	3	0.8	2000	12.256	80.806	M5-1	0.5
90	2090	2090	18721	16631	2090	0	0.8	2000	12.256	80.806	M5-1	0.5
12	0	0	0	0	0	0	0.8	2000	3.22	27.552	M3-1	0.5
24	19	19	528	509	20	1	0.8	2000	3.22	27.552	M3-1	0.5
27	1012	1012	3403	2391	1012	0	0.8	2000	3.22	27.552	M3-1	0.5
30	2244	2244	20706	18462	2266	22	0.8	2000	3.22	27.552	M3-1	0.5
33	14453	14843	188191	173348	14453	0	0.8	2000	3.22	27.552	M3-1	0.5
36	7238877	7242680	9894576	2651896	7238881	4	0.8	2000	3.22	27.552	M3-1	0.5
39	263400	263445	2729616	2466171	263400	0	0.8	2000	3.22	27.552	M3-1	0.5
42	35711	35878	2158003	2122125	35836	125	0.8	2000	3.22	27.552	M3-1	0.5
45	55347	56285	3736011	3679726	55350	3	0.8	2000	3.22	27.552	M3-1	0.5
48	728017	728177	10776403	10048226	728027	10	0.8	2000	3.22	27.552	M3-1	0.5
51	443289	443478	10131751	9688273	443296	7	0.8	2000	3.22	27.552	M3-1	0.5
54	102022	102378	5519503	5417125	102027	5	0.8	2000	3.22	27.552	M3-1	0.5
57	99636	99788	4837605	4737817	99927	291	0.8	2000	3.22	27.552	M3-1	0.5
59	0	0	0	0	0	0	0.8	2000	3.22	27.552	M3-1	0.5
60	221502	221616	3573801	3352185	221541	39	0.8	2000	3.22	27.552	M3-1	0.5
62	0	0	0	0	0	0	0.8	2000	3.22	27.552	M3-1	0.5
63	576245	576491	9748320	9171829	576245	0	0.8	2000	3.22	27.552	M3-1	0.5
64	0	0	0	0	0	0	0.8	2000	3.22	27.552	M3-1	0.5
66	293041	293128	2492028	2198900	293041	0	0.8	2000	3.22	27.552	M3-1	0.5
68	10	10	15	5	10	0	0.8	2000	3.22	27.552	M3-1	0.5
69	359721	359725	4045590	3685865	359732	11	0.8	2000	3.22	27.552	M3-1	0.5
72	72649	75317	1553203	1477886	72649	0	0.8	2000	3.22	27.552	M3-1	0.5
75	18352	18352	328455	310103	18354	2	0.8	2000	3.22	27.552	M3-1	0.5
76	0	0	0	0	0	0	0.8	2000	3.22	27.552	M3-1	0.5
78	132571	132572	773146	640574	132571	0	0.8	2000	3.22	27.552	M3-1	0.5
81	5138	5138	36585	31447	5138	0	0.8	2000	3.22	27.552	M3-1	0.5
84	623	623	9730	9107	623	0	0.8	2000	3.22	27.552	M3-1	0.5
87	478	478	6670	6192	478	0	0.8	2000	3.22	27.552	M3-1	0.5
90	294	305	2278	1973	294	0	0.8	2000	3.22	27.552	M3-1	0.5
3	0	0	0	0	0	0	0.8	2000	5.939	48.957	M4-1	0.5
6	0	0	0	0	0	0	0.8	2000	5.939	48.957	M4-1	0.5
24	73	75	3570	3495	73	0	0.8	2000	5.939	48.957	M4-1	0.5
27	6507	6507	43071	36564	6513	6	0.8	2000	5.939	48.957	M4-1	0.5
30	709	716	40755	40039	714	5	0.8	2000	5.939	48.957	M4-1	0.5
33	33957	33984	424581	390597	33957	0	0.8	2000	5.939	48.957	M4-1	0.5
36	4978	4979	458403	453424	4984	6	0.8	2000	5.939	48.957	M4-1	0.5
39	222875	234607	6813586	6578979	222894	19	0.8	2000	5.939	48.957	M4-1	0.5
41	0	0	0	0	0	0	0.8	2000	5.939	48.957	M4-1	0.5
42	71100	74965	8559453	8484488	72226	1126	0.8	2000	5.939	48.957	M4-1	0.5
45	260853	274902	18638565	18363663	260874	21	0.8	2000	5.939	48.957	M4-1	0.5
47	0	0	0	0	0	0	0.8	2000	5.939	48.957	M4-1	0.5
48	164411	212334	24981846	24769512	164622	211	0.8	2000	5.939	48.957	M4-1	0.5
49	0	0	0	0	0	0	0.8	2000	5.939	48.957	M4-1	0.5
50	10	10	15	5	10	0	0.8	2000	5.939	48.957	M4-1	0.5
51	263998	270020	34283340	34013320	264141	143	0.8	2000	5.939	48.957	M4-1	0.5
52	0	0	0	0	0	0	0.8	2000	5.939	48.957	M4-1	0.5
53	0	0	1	1	0	0	0.8	2000	5.939	48.957	M4-1	0.5
54	220098	257003	26335653	26078650	220114	16	0.8	2000	5.939	48.957	M4-1	0.5
56	55	55	55	0	55	0	0.8	2000	5.939	48.957	M4-1	0.5
57	86736	92998	17307786	17214788	86754	18	0.8	2000	5.939	48.957	M4-1	0.5
58	0	0	0	0	0	0	0.8	2000	5.939	48.957	M4-1	0.5
60	168970	174264	15354111	15179847	168971	1	0.8	2000	5.939	48.957	M4-1	0.5
63	88612	90130	11987856	11897726	88664	52	0.8	2000	5.939	48.957	M4-1	0.5
65	0	0	0	0	0	0	0.8	2000	5.939	48.957	M4-1	0.5
66	158299	189660	8704878	8515218	158299	0	0.8	2000	5.939	48.957	M4-1	0.5
67	0	0	0	0	0	0	0.8	2000	5.939	48.957	M4-1	0.5
69	148691	148774	7634278	7485504	148697	6	0.8	2000	5.939	48.957	M4-1	0.5
72	1447401	1449473	11493615	10044142	1447406	5	0.8	2000	5.939	48.957	M4-1	0.5
73	1	1	1	0	1	0	0.8	2000	5.939	48.957	M4-1	0.5
75	18218	18309	962578	944269	18218	0	0.8	2000	5.939	48.957	M4-1	0.5
78	12180	12247	451725	439478	12180	0	0.8	2000	5.939	48.957	M4-1	0.5
81	1988	2002	126756	124754	1988	0	0.8	2000	5.939	48.957	M4-1	0.5
84	5572	5573	52650	47077	5572	0	0.8	2000	5.939	48.957	M4-1	0.5
87	620	621	12403	11782	620	0	0.8	2000	5.939	48.957	M4-1	0.5
90	218	233	4753	4520	218	0	0.8	2000	5.939	48.957	M4-1	0.5
3	0	0	0	0	0	0	0.8	2000	8.819	79.214	M2-1	0.5
12	1	1	1	0	1	0	0.8	2000	8.819	79.214	M2-1	0.5
15	0	0	0	0	0	0	0.8	2000	8.819	79.214	M2-1	0.5
24	80	80	17391	17311	132	52	0.8	2000	8.819	79.214	M2-1	0.5
27	58	58	20706	20648	65	7	0.8	2000	8.819	79.214	M2-1	0.5
30	316	317	102831	102514	326	10	0.8	2000	8.819	79.214	M2-1	0.5
33	760	781	571915	571134	808	48	0.8	2000	8.819	79.214	M2-1	0.5
36	1513	1518	1530375	1528857	1626	113	0.8	2000	8.819	79.214	M2-1	0.5
39	13274	13402	4501500	4488098	13337	63	0.8	2000	8.819	79.214	M2-1	0.5
41	0	0	0	0	0	0	0.8	2000	8.819	79.214	M2-1	0.5
42	27472	28588	10010575	9981987	27641	169	0.8	2000	8.819	79.214	M2-1	0.5
43	0	0	1	1	0	0	0.8	2000	8.819	79.214	M2-1	0.5
45	14000	15621	16522626	16507005	14148	148	0.8	2000	8.819	79.214	M2-1	0.5
46	0	0	1	1	0	0	0.8	2000	8.819	79.214	M2-1	0.5
48	22594	32345	24398605	24366260	22751	157	0.8	2000	8.819	79.214	M2-1	0.5
51	11875	14167	23988201	23974034	12138	263	0.8	2000	8.819	79.214	M2-1	0.5
52	0	0	0	0	0	0	0.8	2000	8.819	79.214	M2-1	0.5
54	26951	34863	24217320	24182457	27027	76	0.8	2000	8.819	79.214	M2-1	0.5
55	0	0	0	0	0	0	0.8	2000	8.819	79.214	M2-1	0.5
57	26676	28771	23932821	23904050	27168	492	0.8	2000	8.819	79.214	M2-1	0.5
58	0	0	0	0	0	0	0.8	2000	8.819	79.214	M2-1	0.5
59	0	0	1	1	0	0	0.8	2000	8.819	79.214	M2-1	0.5
60	12395	14059	16869336	16855277	12453	58	0.8	2000	8.819	79.214	M2-1	0.5
61	0	0	0	0	0	0	0.8	2000	8.819	79.214	M2-1	0.5
62	0	0	0	0	0	0	0.8	2000	8.819	79.214	M2-1	0.5
63	19015	19873	11608971	11589098	19090	75	0.8	2000	8.819	79.214	M2-1	0.5
64	0	0	0	0	0	0	0.8	2000	8.819	79.214	M2-1	0.5
66	42418	42563	7755891	7713328	42441	23	0.8	2000	8.819	79.214	M2-1	0.5
68	0	0	0	0	0	0	0.8	2000	8.819	79.214	M2-1	0.5
69	2649	2772	4928230	4925458	2689	40	0.8	2000	8.819	79.214	M2-1	0.5
72	2708	2716	2248260	2245544	2739	31	0.8	2000	8.819	79.214	M2-1	0.5
73	0	0	1	1	0	0	0.8	2000	8.819	79.214	M2-1	0.5
75	166295	166303	2494261	2327958	166302	7	0.8	2000	8.819	79.214	M2-1	0.5
78	606	617	541320	540703	626	20	0.8	2000	8.819	79.214	M2-1	0.5
81	18083	18097	402753	384656	18083	0	0.8	2000	8.819	79.214	M2-1	0.5
84	295	296	95703	95407	295	0	0.8	2000	8.819	79.214	M2-1	0.5
87	93	102	20100	19998	93	0	0.8	2000	8.819	79.214	M2-1	0.5
90	2	2	9045	9043	2	0	0.8	2000	8.819	79.214	M2-1	0.5
3	0	0	0	0	0	0	0.8	3000	2.562	78.989	M4-1	0.5
6	0	0	0	0	0	0	0.8	3000	2.562	78.989	M4-1	0.5
24	73	75	3570	3495	73	0	0.8	3000	2.562	78.989	M4-1	0.5
27	6507	6507	43071	36564	6513	6	0.8	3000	2.562	78.989	M4-1	0.5
30	709	716	40755	40039	714	5	0.8	3000	2.562	78.989	M4-1	0.5
33	33957	33984	424581	390597	33957	0	0.8	3000	2.562	78.989	M4-1	0.5
36	4978	4979	458403	453424	4984	6	0.8	3000	2.562	78.989	M4-1	0.5
39	222875	234607	6813586	6578979	222894	19	0.8	3000	2.562	78.989	M4-1	0.5
41	0	0	0	0	0	0	0.8	3000	2.562	78.989	M4-1	0.5
42	74372	74965	8559453	8484488	75520	1148	0.8	3000	2.562	78.989	M4-1	0.5
45	274768	274902	18638565	18363663	274789	21	0.8	3000	2.562	78.989	M4-1	0.5
47	0	0	0	0	0	0	0.8	3000	2.562	78.989	M4-1	0.5
48	169311	212334	24981846	24769512	169525	214	0.8	3000	2.562	78.989	M4-1	0.5
49	0	0	0	0	0	0	0.8	3000	2.562	78.989	M4-1	0.5
50	10	10	15	5	10	0	0.8	3000	2.562	78.989	M4-1	0.5
51	265951	270020	34283340	34013320	266097	146	0.8	3000	2.562	78.989	M4-1	0.5
52	0	0	0	0	0	0	0.8	3000	2.562	78.989	M4-1	0.5
53	0	0	1	1	0	0	0.8	3000	2.562	78.989	M4-1	0.5
54	221489	257003	26335653	26078650	221506	17	0.8	3000	2.562	78.989	M4-1	0.5
56	55	55	55	0	55	0	0.8	3000	2.562	78.989	M4-1	0.5
57	89695	92998	17307786	17214788	89715	20	0.8	3000	2.562	78.989	M4-1	0.5
58	0	0	0	0	0	0	0.8	3000	2.562	78.989	M4-1	0.5
60	172947	174264	15354111	15179847	172948	1	0.8	3000	2.562	78.989	M4-1	0.5
63	89734	90130	11987856	11897726	89788	54	0.8	3000	2.562	78.989	M4-1	0.5
65	0	0	0	0	0	0	0.8	3000	2.562	78.989	M4-1	0.5
66	189006	189660	8704878	8515218	189008	2	0.8	3000	2.562	78.989	M4-1	0.5
67	0	0	0	0	0	0	0.8	3000	2.562	78.989	M4-1	0.5
69	148691	148774	7634278	7485504	148697	6	0.8	3000	2.562	78.989	M4-1	0.5
72	1448204	1449473	11493615	10044142	1448209	5	0.8	3000	2.562	78.989	M4-1	0.5
73	1	1	1	0	1	0	0.8	3000	2.562	78.989	M4-1	0.5
75	18218	18309	962578	944269	18218	0	0.8	3000	2.562	78.989	M4-1	0.5
78	12180	12247	451725	439478	12180	0	0.8	3000	2.562	78.989	M4-1	0.5
81	1988	2002	126756	124754	1988	0	0.8	3000	2.562	78.989	M4-1	0.5
84	5572	5573	52650	47077	5572	0	0.8	3000	2.562	78.989	M4-1	0.5
87	620	621	12403	11782	620	0	0.8	3000	2.562	78.989	M4-1	0.5
90	218	233	4753	4520	218	0	0.8	3000	2.562	78.989	M4-1	0.5
12	0	0	0	0	0	0	0.8	3000	3.463	29.706	M3-1	0.5
24	19	19	528	509	20	1	0.8	3000	3.463	29.706	M3-1	0.5
27	1012	1012	3403	2391	1012	0	0.8	3000	3.463	29.706	M3-1	0.5
30	2244	2244	20706	18462	2266	22	0.8	3000	3.463	29.706	M3-1	0.5
33	14453	14843	188191	173348	14453	0	0.8	3000	3.463	29.706	M3-1	0.5
36	7238877	7242680	9894576	2651896	7238881	4	0.8	3000	3.463	29.706	M3-1	0.5
39	263400	263445	2729616	2466171	263400	0	0.8	3000	3.463	29.706	M3-1	0.5
42	35711	35878	2158003	2122125	35836	125	0.8	3000	3.463	29.706	M3-1	0.5
45	55347	56285	3736011	3679726	55350	3	0.8	3000	3.463	29.706	M3-1	0.5
48	728017	728177	10776403	10048226	728027	10	0.8	3000	3.463	29.706	M3-1	0.5
51	443289	443478	10131751	9688273	443296	7	0.8	3000	3.463	29.706	M3-1	0.5
54	102022	102378	5519503	5417125	102027	5	0.8	3000	3.463	29.706	M3-1	0.5
57	99636	99788	4837605	4737817	99927	291	0.8	3000	3.463	29.706	M3-1	0.5
59	0	0	0	0	0	0	0.8	3000	3.463	29.706	M3-1	0.5
60	221502	221616	3573801	3352185	221541	39	0.8	3000	3.463	29.706	M3-1	0.5
62	0	0	0	0	0	0	0.8	3000	3.463	29.706	M3-1	0.5
63	576245	576491	9748320	9171829	576245	0	0.8	3000	3.463	29.706	M3-1	0.5
64	0	0	0	0	0	0	0.8	3000	3.463	29.706	M3-1	0.5
66	293041	293128	2492028	2198900	293041	0	0.8	3000	3.463	29.706	M3-1	0.5
68	10	10	15	5	10	0	0.8	3000	3.463	29.706	M3-1	0.5
69	359721	359725	4045590	3685865	359732	11	0.8	3000	3.463	29.706	M3-1	0.5
72	72649	75317	1553203	1477886	72649	0	0.8	3000	3.463	29.706	M3-1	0.5
75	18352	18352	328455	310103	18354	2	0.8	3000	3.463	29.706	M3-1	0.5
76	0	0	0	0	0	0	0.8	3000	3.463	29.706	M3-1	0.5
78	132571	132572	773146	640574	132571	0	0.8	3000	3.463	29.706	M3-1	0.5
81	5138	5138	36585	31447	5138	0	0.8	3000	3.463	29.706	M3-1	0.5
84	623	623	9730	9107	623	0	0.8	3000	3.463	29.706	M3-1	0.5
87	478	478	6670	6192	478	0	0.8	3000	3.463	29.706	M3-1	0.5
90	294	305	2278	1973	294	0	0.8	3000	3.463	29.706	M3-1	0.5
3	0	0	0	0	0	0	0.8	3000	3.672	112.762	M2-1	0.5
12	1	1	1	0	1	0	0.8	3000	3.672	112.762	M2-1	0.5
15	0	0	0	0	0	0	0.8	3000	3.672	112.762	M2-1	0.5
24	80	80	17391	17311	132	52	0.8	3000	3.672	112.762	M2-1	0.5
27	58	58	20706	20648	65	7	0.8	3000	3.672	112.762	M2-1	0.5
30	316	317	102831	102514	326	10	0.8	3000	3.672	112.762	M2-1	0.5
33	760	781	571915	571134	808	48	0.8	3000	3.672	112.762	M2-1	0.5
36	1513	1518	1530375	1528857	1626	113	0.8	3000	3.672	112.762	M2-1	0.5
39	13374	13402	4501500	4488098	13454	80	0.8	3000	3.672	112.762	M2-1	0.5
41	0	0	0	0	0	0	0.8	3000	3.672	112.762	M2-1	0.5
42	27472	28588	10010575	9981987	27641	169	0.8	3000	3.672	112.762	M2-1	0.5
43	0	0	1	1	0	0	0.8	3000	3.672	112.762	M2-1	0.5
45	14233	15621	16522626	16507005	14442	209	0.8	3000	3.672	112.762	M2-1	0.5
46	0	0	1	1	0	0	0.8	3000	3.672	112.762	M2-1	0.5
48	31565	32345	24398605	24366260	31735	170	0.8	3000	3.672	112.762	M2-1	0.5
51	12008	14167	23988201	23974034	12272	264	0.8	3000	3.672	112.762	M2-1	0.5
52	0	0	0	0	0	0	0.8	3000	3.672	112.762	M2-1	0.5
54	32048	34863	24217320	24182457	32131	83	0.8	3000	3.672	112.762	M2-1	0.5
55	0	0	0	0	0	0	0.8	3000	3.672	112.762	M2-1	0.5
57	27808	28771	23932821	23904050	28383	575	0.8	3000	3.672	112.762	M2-1	0.5
58	0	0	0	0	0	0	0.8	3000	3.672	112.762	M2-1	0.5
59	0	0	1	1	0	0	0.8	3000	3.672	112.762	M2-1	0.5
60	13742	14059	16869336	16855277	13814	72	0.8	3000	3.672	112.762	M2-1	0.5
61	0	0	0	0	0	0	0.8	3000	3.672	112.762	M2-1	0.5
62	0	0	0	0	0	0	0.8	3000	3.672	112.762	M2-1	0.5
63	19015	19873	11608971	11589098	19090	75	0.8	3000	3.672	112.762	M2-1	0.5
64	0	0	0	0	0	0	0.8	3000	3.672	112.762	M2-1	0.5
66	42450	42563	7755891	7713328	42473	23	0.8	3000	3.672	112.762	M2-1	0.5
68	0	0	0	0	0	0	0.8	3000	3.672	112.762	M2-1	0.5
69	2709	2772	4928230	4925458	2756	47	0.8	3000	3.672	112.762	M2-1	0.5
72	2708	2716	2248260	2245544	2739	31	0.8	3000	3.672	112.762	M2-1	0.5
73	0	0	1	1	0	0	0.8	3000	3.672	112.762	M2-1	0.5
75	166295	166303	2494261	2327958	166302	7	0.8	3000	3.672	112.762	M2-1	0.5
78	606	617	541320	540703	626	20	0.8	3000	3.672	112.762	M2-1	0.5
81	18083	18097	402753	384656	18083	0	0.8	3000	3.672	112.762	M2-1	0.5
84	295	296	95703	95407	295	0	0.8	3000	3.672	112.762	M2-1	0.5
87	93	102	20100	19998	93	0	0.8	3000	3.672	112.762	M2-1	0.5
90	2	2	9045	9043	2	0	0.8	3000	3.672	112.762	M2-1	0.5
6	0	0	0	0	0	0	0.8	3000	7.473	115.487	M5-1	0.5
8	3	6	6	0	3	0	0.8	3000	7.473	115.487	M5-1	0.5
9	28	28	28	0	28	0	0.8	3000	7.473	115.487	M5-1	0.5
24	9161	9286	76636	67350	9282	121	0.8	3000	7.473	115.487	M5-1	0.5
27	9928	11312	53956	42644	9928	0	0.8	3000	7.473	115.487	M5-1	0.5
30	84740	84807	512578	427771	84741	1	0.8	3000	7.473	115.487	M5-1	0.5
33	15278	16399	1097421	1081022	15288	10	0.8	3000	7.473	115.487	M5-1	0.5
35	0	0	0	0	0	0	0.8	3000	7.473	115.487	M5-1	0.5
36	38436	38513	3324331	3285818	38468	32	0.8	3000	7.473	115.487	M5-1	0.5
37	0	0	0	0	0	0	0.8	3000	7.473	115.487	M5-1	0.5
39	77192	78081	8914753	8836672	77195	3	0.8	3000	7.473	115.487	M5-1	0.5
40	0	0	0	0	0	0	0.8	3000	7.473	115.487	M5-1	0.5
42	153023	168038	24440536	24272498	153440	417	0.8	3000	7.473	115.487	M5-1	0.5
45	176909	190901	46527481	46336580	177102	193	0.8	3000	7.473	115.487	M5-1	0.5
47	0	0	0	0	0	0	0.8	3000	7.473	115.487	M5-1	0.5
48	388546	430088	84142878	83712790	389064	518	0.8	3000	7.473	115.487	M5-1	0.5
49	0	0	0	0	0	0	0.8	3000	7.473	115.487	M5-1	0.5
51	259591	283513	65259600	64976087	261399	1808	0.8	3000	7.473	115.487	M5-1	0.5
54	346704	394658	62826445	62431787	346819	115	0.8	3000	7.473	115.487	M5-1	0.5
55	1	1	1	0	1	0	0.8	3000	7.473	115.487	M5-1	0.5
57	384724	402140	60077241	59675101	384987	263	0.8	3000	7.473	115.487	M5-1	0.5
58	0	0	0	0	0	0	0.8	3000	7.473	115.487	M5-1	0.5
59	0	0	0	0	0	0	0.8	3000	7.473	115.487	M5-1	0.5
60	127796	141584	42878430	42736846	128125	329	0.8	3000	7.473	115.487	M5-1	0.5
61	0	1	1	0	0	0	0.8	3000	7.473	115.487	M5-1	0.5
62	3	3	6	3	3	0	0.8	3000	7.473	115.487	M5-1	0.5
63	275691	283443	33020001	32736558	275751	60	0.8	3000	7.473	115.487	M5-1	0.5
64	0	0	0	0	0	0	0.8	3000	7.473	115.487	M5-1	0.5
66	126599	146922	23225520	23078598	126599	0	0.8	3000	7.473	115.487	M5-1	0.5
69	204960	210783	17877210	17666427	204982	22	0.8	3000	7.473	115.487	M5-1	0.5
72	197745	198785	11005086	10806301	197959	214	0.8	3000	7.473	115.487	M5-1	0.5
75	27238	27401	2809635	2782234	27242	4	0.8	3000	7.473	115.487	M5-1	0.5
76	0	0	0	0	0	0	0.8	3000	7.473	115.487	M5-1	0.5
78	57391	58159	2273778	2215619	57391	0	0.8	3000	7.473	115.487	M5-1	0.5
81	14868	14958	644680	629722	14868	0	0.8	3000	7.473	115.487	M5-1	0.5
84	29235	29526	328455	298929	29235	0	0.8	3000	7.473	115.487	M5-1	0.5
87	4182	4182	52650	48468	4185	3	0.8	3000	7.473	115.487	M5-1	0.5
90	2090	2090	18721	16631	2090	0	0.8	3000	7.473	115.487	M5-1	0.5
3	0	0	0	0	0	0	0.8	4000	2.752	92.394	M4-1	0.5
6	0	0	0	0	0	0	0.8	4000	2.752	92.394	M4-1	0.5
24	73	75	3570	3495	73	0	0.8	4000	2.752	92.394	M4-1	0.5
27	6507	6507	43071	36564	6513	6	0.8	4000	2.752	92.394	M4-1	0.5
30	709	716	40755	40039	714	5	0.8	4000	2.752	92.394	M4-1	0.5
33	33957	33984	424581	390597	33957	0	0.8	4000	2.752	92.394	M4-1	0.5
36	4978	4979	458403	453424	4984	6	0.8	4000	2.752	92.394	M4-1	0.5
39	222875	234607	6813586	6578979	222894	19	0.8	4000	2.752	92.394	M4-1	0.5
41	0	0	0	0	0	0	0.8	4000	2.752	92.394	M4-1	0.5
42	74372	74965	8559453	8484488	75520	1148	0.8	4000	2.752	92.394	M4-1	0.5
45	274768	274902	18638565	18363663	274789	21	0.8	4000	2.752	92.394	M4-1	0.5
47	0	0	0	0	0	0	0.8	4000	2.752	92.394	M4-1	0.5
48	211115	212334	24981846	24769512	211523	408	0.8	4000	2.752	92.394	M4-1	0.5
49	0	0	0	0	0	0	0.8	4000	2.752	92.394	M4-1	0.5
50	10	10	15	5	10	0	0.8	4000	2.752	92.394	M4-1	0.5
51	268325	270020	34283340	34013320	268475	150	0.8	4000	2.752	92.394	M4-1	0.5
52	0	0	0	0	0	0	0.8	4000	2.752	92.394	M4-1	0.5
53	0	0	1	1	0	0	0.8	4000	2.752	92.394	M4-1	0.5
54	249528	257003	26335653	26078650	249548	20	0.8	4000	2.752	92.394	M4-1	0.5
56	55	55	55	0	55	0	0.8	4000	2.752	92.394	M4-1	0.5
57	92014	92998	17307786	17214788	92040	26	0.8	4000	2.752	92.394	M4-1	0.5
58	0	0	0	0	0	0	0.8	4000	2.752	92.394	M4-1	0.5
60	172947	174264	15354111	15179847	172948	1	0.8	4000	2.752	92.394	M4-1	0.5
63	89734	90130	11987856	11897726	89788	54	0.8	4000	2.752	92.394	M4-1	0.5
65	0	0	0	0	0	0	0.8	4000	2.752	92.394	M4-1	0.5
66	189006	189660	8704878	8515218	189008	2	0.8	4000	2.752	92.394	M4-1	0.5
67	0	0	0	0	0	0	0.8	4000	2.752	92.394	M4-1	0.5
69	148691	148774	7634278	7485504	148697	6	0.8	4000	2.752	92.394	M4-1	0.5
72	1448204	1449473	11493615	10044142	1448209	5	0.8	4000	2.752	92.394	M4-1	0.5
73	1	1	1	0	1	0	0.8	4000	2.752	92.394	M4-1	0.5
75	18218	18309	962578	944269	18218	0	0.8	4000	2.752	92.394	M4-1	0.5
78	12180	12247	451725	439478	12180	0	0.8	4000	2.752	92.394	M4-1	0.5
81	1988	2002	126756	124754	1988	0	0.8	4000	2.752	92.394	M4-1	0.5
84	5572	5573	52650	47077	5572	0	0.8	4000	2.752	92.394	M4-1	0.5
87	620	621	12403	11782	620	0	0.8	4000	2.752	92.394	M4-1	0.5
90	218	233	4753	4520	218	0	0.8	4000	2.752	92.394	M4-1	0.5
6	0	0	0	0	0	0	0.8	4000	4.127	165.215	M5-1	0.5
8	3	6	6	0	3	0	0.8	4000	4.127	165.215	M5-1	0.5
9	28	28	28	0	28	0	0.8	4000	4.127	165.215	M5-1	0.5
24	9161	9286	76636	67350	9282	121	0.8	4000	4.127	165.215	M5-1	0.5
27	9928	11312	53956	42644	9928	0	0.8	4000	4.127	165.215	M5-1	0.5
30	84740	84807	512578	427771	84741	1	0.8	4000	4.127	165.215	M5-1	0.5
33	15278	16399	1097421	1081022	15288	10	0.8	4000	4.127	165.215	M5-1	0.5
35	0	0	0	0	0	0	0.8	4000	4.127	165.215	M5-1	0.5
36	38436	38513	3324331	3285818	38468	32	0.8	4000	4.127	165.215	M5-1	0.5
37	0	0	0	0	0	0	0.8	4000	4.127	165.215	M5-1	0.5
39	77192	78081	8914753	8836672	77195	3	0.8	4000	4.127	165.215	M5-1	0.5
40	0	0	0	0	0	0	0.8	4000	4.127	165.215	M5-1	0.5
42	167924	168038	24440536	24272498	168342	418	0.8	4000	4.127	165.215	M5-1	0.5
45	176909	190901	46527481	46336580	177102	193	0.8	4000	4.127	165.215	M5-1	0.5
47	0	0	0	0	0	0	0.8	4000	4.127	165.215	M5-1	0.5
48	388546	430088	84142878	83712790	389064	518	0.8	4000	4.127	165.215	M5-1	0.5
49	0	0	0	0	0	0	0.8	4000	4.127	165.215	M5-1	0.5
51	259591	283513	65259600	64976087	261399	1808	0.8	4000	4.127	165.215	M5-1	0.5
54	352974	394658	62826445	62431787	353089	115	0.8	4000	4.127	165.215	M5-1	0.5
55	1	1	1	0	1	0	0.8	4000	4.127	165.215	M5-1	0.5
57	385653	402140	60077241	59675101	385918	265	0.8	4000	4.127	165.215	M5-1	0.5
58	0	0	0	0	0	0	0.8	4000	4.127	165.215	M5-1	0.5
59	0	0	0	0	0	0	0.8	4000	4.127	165.215	M5-1	0.5
60	129898	141584	42878430	42736846	130624	726	0.8	4000	4.127	165.215	M5-1	0.5
61	0	1	1	0	0	0	0.8	4000	4.127	165.215	M5-1	0.5
62	3	3	6	3	3	0	0.8	4000	4.127	165.215	M5-1	0.5
63	275691	283443	33020001	32736558	275751	60	0.8	4000	4.127	165.215	M5-1	0.5
64	0	0	0	0	0	0	0.8	4000	4.127	165.215	M5-1	0.5
66	145574	146922	23225520	23078598	145574	0	0.8	4000	4.127	165.215	M5-1	0.5
69	210440	210783	17877210	17666427	210476	36	0.8	4000	4.127	165.215	M5-1	0.5
72	197745	198785	11005086	10806301	197959	214	0.8	4000	4.127	165.215	M5-1	0.5
75	27238	27401	2809635	2782234	27242	4	0.8	4000	4.127	165.215	M5-1	0.5
76	0	0	0	0	0	0	0.8	4000	4.127	165.215	M5-1	0.5
78	57391	58159	2273778	2215619	57391	0	0.8	4000	4.127	165.215	M5-1	0.5
81	14868	14958	644680	629722	14868	0	0.8	4000	4.127	165.215	M5-1	0.5
84	29235	29526	328455	298929	29235	0	0.8	4000	4.127	165.215	M5-1	0.5
87	4182	4182	52650	48468	4185	3	0.8	4000	4.127	165.215	M5-1	0.5
90	2090	2090	18721	16631	2090	0	0.8	4000	4.127	165.215	M5-1	0.5
12	0	0	0	0	0	0	0.8	4000	4.416	33.86	M3-1	0.5
24	19	19	528	509	20	1	0.8	4000	4.416	33.86	M3-1	0.5
27	1012	1012	3403	2391	1012	0	0.8	4000	4.416	33.86	M3-1	0.5
30	2244	2244	20706	18462	2266	22	0.8	4000	4.416	33.86	M3-1	0.5
33	14453	14843	188191	173348	14453	0	0.8	4000	4.416	33.86	M3-1	0.5
36	7238877	7242680	9894576	2651896	7238881	4	0.8	4000	4.416	33.86	M3-1	0.5
39	263400	263445	2729616	2466171	263400	0	0.8	4000	4.416	33.86	M3-1	0.5
42	35711	35878	2158003	2122125	35836	125	0.8	4000	4.416	33.86	M3-1	0.5
45	55347	56285	3736011	3679726	55350	3	0.8	4000	4.416	33.86	M3-1	0.5
48	728017	728177	10776403	10048226	728027	10	0.8	4000	4.416	33.86	M3-1	0.5
51	443289	443478	10131751	9688273	443296	7	0.8	4000	4.416	33.86	M3-1	0.5
54	102022	102378	5519503	5417125	102027	5	0.8	4000	4.416	33.86	M3-1	0.5
57	99636	99788	4837605	4737817	99927	291	0.8	4000	4.416	33.86	M3-1	0.5
59	0	0	0	0	0	0	0.8	4000	4.416	33.86	M3-1	0.5
60	221502	221616	3573801	3352185	221541	39	0.8	4000	4.416	33.86	M3-1	0.5
62	0	0	0	0	0	0	0.8	4000	4.416	33.86	M3-1	0.5
63	576245	576491	9748320	9171829	576245	0	0.8	4000	4.416	33.86	M3-1	0.5
64	0	0	0	0	0	0	0.8	4000	4.416	33.86	M3-1	0.5
66	293041	293128	2492028	2198900	293041	0	0.8	4000	4.416	33.86	M3-1	0.5
68	10	10	15	5	10	0	0.8	4000	4.416	33.86	M3-1	0.5
69	359721	359725	4045590	3685865	359732	11	0.8	4000	4.416	33.86	M3-1	0.5
72	72649	75317	1553203	1477886	72649	0	0.8	4000	4.416	33.86	M3-1	0.5
75	18352	18352	328455	310103	18354	2	0.8	4000	4.416	33.86	M3-1	0.5
76	0	0	0	0	0	0	0.8	4000	4.416	33.86	M3-1	0.5
78	132571	132572	773146	640574	132571	0	0.8	4000	4.416	33.86	M3-1	0.5
81	5138	5138	36585	31447	5138	0	0.8	4000	4.416	33.86	M3-1	0.5
84	623	623	9730	9107	623	0	0.8	4000	4.416	33.86	M3-1	0.5
87	478	478	6670	6192	478	0	0.8	4000	4.416	33.86	M3-1	0.5
90	294	305	2278	1973	294	0	0.8	4000	4.416	33.86	M3-1	0.5
3	0	0	0	0	0	0	0.8	4000	4.694	133.397	M2-1	0.5
12	1	1	1	0	1	0	0.8	4000	4.694	133.397	M2-1	0.5
15	0	0	0	0	0	0	0.8	4000	4.694	133.397	M2-1	0.5
24	80	80	17391	17311	132	52	0.8	4000	4.694	133.397	M2-1	0.5
27	58	58	20706	20648	65	7	0.8	4000	4.694	133.397	M2-1	0.5
30	316	317	102831	102514	326	10	0.8	4000	4.694	133.397	M2-1	0.5
33	760	781	571915	571134	808	48	0.8	4000	4.694	133.397	M2-1	0.5
36	1513	1518	1530375	1528857	1626	113	0.8	4000	4.694	133.397	M2-1	0.5
39	13374	13402	4501500	4488098	13454	80	0.8	4000	4.694	133.397	M2-1	0.5
41	0	0	0	0	0	0	0.8	4000	4.694	133.397	M2-1	0.5
42	28574	28588	10010575	9981987	29028	454	0.8	4000	4.694	133.397	M2-1	0.5
43	0	0	1	1	0	0	0.8	4000	4.694	133.397	M2-1	0.5
45	14233	15621	16522626	16507005	14442	209	0.8	4000	4.694	133.397	M2-1	0.5
46	0	0	1	1	0	0	0.8	4000	4.694	133.397	M2-1	0.5
48	31681	32345	24398605	24366260	31858	177	0.8	4000	4.694	133.397	M2-1	0.5
51	12008	14167	23988201	23974034	12272	264	0.8	4000	4.694	133.397	M2-1	0.5
52	0	0	0	0	0	0	0.8	4000	4.694	133.397	M2-1	0.5
54	32197	34863	24217320	24182457	32310	113	0.8	4000	4.694	133.397	M2-1	0.5
55	0	0	0	0	0	0	0.8	4000	4.694	133.397	M2-1	0.5
57	27808	28771	23932821	23904050	28383	575	0.8	4000	4.694	133.397	M2-1	0.5
58	0	0	0	0	0	0	0.8	4000	4.694	133.397	M2-1	0.5
59	0	0	1	1	0	0	0.8	4000	4.694	133.397	M2-1	0.5
60	13742	14059	16869336	16855277	13814	72	0.8	4000	4.694	133.397	M2-1	0.5
61	0	0	0	0	0	0	0.8	4000	4.694	133.397	M2-1	0.5
62	0	0	0	0	0	0	0.8	4000	4.694	133.397	M2-1	0.5
63	19015	19873	11608971	11589098	19090	75	0.8	4000	4.694	133.397	M2-1	0.5
64	0	0	0	0	0	0	0.8	4000	4.694	133.397	M2-1	0.5
66	42511	42563	7755891	7713328	42534	23	0.8	4000	4.694	133.397	M2-1	0.5
68	0	0	0	0	0	0	0.8	4000	4.694	133.397	M2-1	0.5
69	2709	2772	4928230	4925458	2756	47	0.8	4000	4.694	133.397	M2-1	0.5
72	2708	2716	2248260	2245544	2739	31	0.8	4000	4.694	133.397	M2-1	0.5
73	0	0	1	1	0	0	0.8	4000	4.694	133.397	M2-1	0.5
75	166295	166303	2494261	2327958	166302	7	0.8	4000	4.694	133.397	M2-1	0.5
78	606	617	541320	540703	626	20	0.8	4000	4.694	133.397	M2-1	0.5
81	18083	18097	402753	384656	18083	0	0.8	4000	4.694	133.397	M2-1	0.5
84	295	296	95703	95407	295	0	0.8	4000	4.694	133.397	M2-1	0.5
87	93	102	20100	19998	93	0	0.8	4000	4.694	133.397	M2-1	0.5
90	2	2	9045	9043	2	0	0.8	4000	4.694	133.397	M2-1	0.5
3	0	0	0	0	0	0	0.8	5000	2.396	117.522	M4-1	0.5
6	0	0	0	0	0	0	0.8	5000	2.396	117.522	M4-1	0.5
24	73	75	3570	3495	73	0	0.8	5000	2.396	117.522	M4-1	0.5
27	6507	6507	43071	36564	6513	6	0.8	5000	2.396	117.522	M4-1	0.5
30	709	716	40755	40039	714	5	0.8	5000	2.396	117.522	M4-1	0.5
33	33957	33984	424581	390597	33957	0	0.8	5000	2.396	117.522	M4-1	0.5
36	4978	4979	458403	453424	4984	6	0.8	5000	2.396	117.522	M4-1	0.5
39	222875	234607	6813586	6578979	222894	19	0.8	5000	2.396	117.522	M4-1	0.5
41	0	0	0	0	0	0	0.8	5000	2.396	117.522	M4-1	0.5
42	74372	74965	8559453	8484488	75520	1148	0.8	5000	2.396	117.522	M4-1	0.5
45	274768	274902	18638565	18363663	274789	21	0.8	5000	2.396	117.522	M4-1	0.5
47	0	0	0	0	0	0	0.8	5000	2.396	117.522	M4-1	0.5
48	211115	212334	24981846	24769512	211523	408	0.8	5000	2.396	117.522	M4-1	0.5
49	0	0	0	0	0	0	0.8	5000	2.396	117.522	M4-1	0.5
50	10	10	15	5	10	0	0.8	5000	2.396	117.522	M4-1	0.5
51	268325	270020	34283340	34013320	268475	150	0.8	5000	2.396	117.522	M4-1	0.5
52	0	0	0	0	0	0	0.8	5000	2.396	117.522	M4-1	0.5
53	0	0	1	1	0	0	0.8	5000	2.396	117.522	M4-1	0.5
54	249528	257003	26335653	26078650	249548	20	0.8	5000	2.396	117.522	M4-1	0.5
56	55	55	55	0	55	0	0.8	5000	2.396	117.522	M4-1	0.5
57	92014	92998	17307786	17214788	92040	26	0.8	5000	2.396	117.522	M4-1	0.5
58	0	0	0	0	0	0	0.8	5000	2.396	117.522	M4-1	0.5
60	172947	174264	15354111	15179847	172948	1	0.8	5000	2.396	117.522	M4-1	0.5
63	89734	90130	11987856	11897726	89788	54	0.8	5000	2.396	117.522	M4-1	0.5
65	0	0	0	0	0	0	0.8	5000	2.396	117.522	M4-1	0.5
66	189006	189660	8704878	8515218	189008	2	0.8	5000	2.396	117.522	M4-1	0.5
67	0	0	0	0	0	0	0.8	5000	2.396	117.522	M4-1	0.5
69	148691	148774	7634278	7485504	148697	6	0.8	5000	2.396	117.522	M4-1	0.5
72	1448204	1449473	11493615	10044142	1448209	5	0.8	5000	2.396	117.522	M4-1	0.5
73	1	1	1	0	1	0	0.8	5000	2.396	117.522	M4-1	0.5
75	18218	18309	962578	944269	18218	0	0.8	5000	2.396	117.522	M4-1	0.5
78	12180	12247	451725	439478	12180	0	0.8	5000	2.396	117.522	M4-1	0.5
81	1988	2002	126756	124754	1988	0	0.8	5000	2.396	117.522	M4-1	0.5
84	5572	5573	52650	47077	5572	0	0.8	5000	2.396	117.522	M4-1	0.5
87	620	621	12403	11782	620	0	0.8	5000	2.396	117.522	M4-1	0.5
90	218	233	4753	4520	218	0	0.8	5000	2.396	117.522	M4-1	0.5
6	0	0	0	0	0	0	0.8	5000	2.876	201.852	M5-1	0.5
8	3	6	6	0	3	0	0.8	5000	2.876	201.852	M5-1	0.5
9	28	28	28	0	28	0	0.8	5000	2.876	201.852	M5-1	0.5
24	9161	9286	76636	67350	9282	121	0.8	5000	2.876	201.852	M5-1	0.5
27	9928	11312	53956	42644	9928	0	0.8	5000	2.876	201.852	M5-1	0.5
30	84740	84807	512578	427771	84741	1	0.8	5000	2.876	201.852	M5-1	0.5
33	15278	16399	1097421	1081022	15288	10	0.8	5000	2.876	201.852	M5-1	0.5
35	0	0	0	0	0	0	0.8	5000	2.876	201.852	M5-1	0.5
36	38436	38513	3324331	3285818	38468	32	0.8	5000	2.876	201.852	M5-1	0.5
37	0	0	0	0	0	0	0.8	5000	2.876	201.852	M5-1	0.5
39	77192	78081	8914753	8836672	77195	3	0.8	5000	2.876	201.852	M5-1	0.5
40	0	0	0	0	0	0	0.8	5000	2.876	201.852	M5-1	0.5
42	167924	168038	24440536	24272498	168342	418	0.8	5000	2.876	201.852	M5-1	0.5
45	190403	190901	46527481	46336580	190700	297	0.8	5000	2.876	201.852	M5-1	0.5
47	0	0	0	0	0	0	0.8	5000	2.876	201.852	M5-1	0.5
48	388546	430088	84142878	83712790	389064	518	0.8	5000	2.876	201.852	M5-1	0.5
49	0	0	0	0	0	0	0.8	5000	2.876	201.852	M5-1	0.5
51	259591	283513	65259600	64976087	261399	1808	0.8	5000	2.876	201.852	M5-1	0.5
54	352974	394658	62826445	62431787	353089	115	0.8	5000	2.876	201.852	M5-1	0.5
55	1	1	1	0	1	0	0.8	5000	2.876	201.852	M5-1	0.5
57	385653	402140	60077241	59675101	385918	265	0.8	5000	2.876	201.852	M5-1	0.5
58	0	0	0	0	0	0	0.8	5000	2.876	201.852	M5-1	0.5
59	0	0	0	0	0	0	0.8	5000	2.876	201.852	M5-1	0.5
60	129898	141584	42878430	42736846	130624	726	0.8	5000	2.876	201.852	M5-1	0.5
61	0	1	1	0	0	0	0.8	5000	2.876	201.852	M5-1	0.5
62	3	3	6	3	3	0	0.8	5000	2.876	201.852	M5-1	0.5
63	282636	283443	33020001	32736558	282710	74	0.8	5000	2.876	201.852	M5-1	0.5
64	0	0	0	0	0	0	0.8	5000	2.876	201.852	M5-1	0.5
66	145574	146922	23225520	23078598	145574	0	0.8	5000	2.876	201.852	M5-1	0.5
69	210440	210783	17877210	17666427	210476	36	0.8	5000	2.876	201.852	M5-1	0.5
72	197745	198785	11005086	10806301	197959	214	0.8	5000	2.876	201.852	M5-1	0.5
75	27238	27401	2809635	2782234	27242	4	0.8	5000	2.876	201.852	M5-1	0.5
76	0	0	0	0	0	0	0.8	5000	2.876	201.852	M5-1	0.5
78	57391	58159	2273778	2215619	57391	0	0.8	5000	2.876	201.852	M5-1	0.5
81	14868	14958	644680	629722	14868	0	0.8	5000	2.876	201.852	M5-1	0.5
84	29235	29526	328455	298929	29235	0	0.8	5000	2.876	201.852	M5-1	0.5
87	4182	4182	52650	48468	4185	3	0.8	5000	2.876	201.852	M5-1	0.5
90	2090	2090	18721	16631	2090	0	0.8	5000	2.876	201.852	M5-1	0.5
12	0	0	0	0	0	0	0.8	5000	3.532	30.936	M3-1	0.5
24	19	19	528	509	20	1	0.8	5000	3.532	30.936	M3-1	0.5
27	1012	1012	3403	2391	1012	0	0.8	5000	3.532	30.936	M3-1	0.5
30	2244	2244	20706	18462	2266	22	0.8	5000	3.532	30.936	M3-1	0.5
33	14453	14843	188191	173348	14453	0	0.8	5000	3.532	30.936	M3-1	0.5
36	7238877	7242680	9894576	2651896	7238881	4	0.8	5000	3.532	30.936	M3-1	0.5
39	263400	263445	2729616	2466171	263400	0	0.8	5000	3.532	30.936	M3-1	0.5
42	35711	35878	2158003	2122125	35836	125	0.8	5000	3.532	30.936	M3-1	0.5
45	55347	56285	3736011	3679726	55350	3	0.8	5000	3.532	30.936	M3-1	0.5
48	728017	728177	10776403	10048226	728027	10	0.8	5000	3.532	30.936	M3-1	0.5
51	443289	443478	10131751	9688273	443296	7	0.8	5000	3.532	30.936	M3-1	0.5
54	102022	102378	5519503	5417125	102027	5	0.8	5000	3.532	30.936	M3-1	0.5
57	99636	99788	4837605	4737817	99927	291	0.8	5000	3.532	30.936	M3-1	0.5
59	0	0	0	0	0	0	0.8	5000	3.532	30.936	M3-1	0.5
60	221502	221616	3573801	3352185	221541	39	0.8	5000	3.532	30.936	M3-1	0.5
62	0	0	0	0	0	0	0.8	5000	3.532	30.936	M3-1	0.5
63	576245	576491	9748320	9171829	576245	0	0.8	5000	3.532	30.936	M3-1	0.5
64	0	0	0	0	0	0	0.8	5000	3.532	30.936	M3-1	0.5
66	293041	293128	2492028	2198900	293041	0	0.8	5000	3.532	30.936	M3-1	0.5
68	10	10	15	5	10	0	0.8	5000	3.532	30.936	M3-1	0.5
69	359721	359725	4045590	3685865	359732	11	0.8	5000	3.532	30.936	M3-1	0.5
72	72649	75317	1553203	1477886	72649	0	0.8	5000	3.532	30.936	M3-1	0.5
75	18352	18352	328455	310103	18354	2	0.8	5000	3.532	30.936	M3-1	0.5
76	0	0	0	0	0	0	0.8	5000	3.532	30.936	M3-1	0.5
78	132571	132572	773146	640574	132571	0	0.8	5000	3.532	30.936	M3-1	0.5
81	5138	5138	36585	31447	5138	0	0.8	5000	3.532	30.936	M3-1	0.5
84	623	623	9730	9107	623	0	0.8	5000	3.532	30.936	M3-1	0.5
87	478	478	6670	6192	478	0	0.8	5000	3.532	30.936	M3-1	0.5
90	294	305	2278	1973	294	0	0.8	5000	3.532	30.936	M3-1	0.5
3	0	0	0	0	0	0	0.8	5000	3.857	169.666	M2-1	0.5
12	1	1	1	0	1	0	0.8	5000	3.857	169.666	M2-1	0.5
15	0	0	0	0	0	0	0.8	5000	3.857	169.666	M2-1	0.5
24	80	80	17391	17311	132	52	0.8	5000	3.857	169.666	M2-1	0.5
27	58	58	20706	20648	65	7	0.8	5000	3.857	169.666	M2-1	0.5
30	316	317	102831	102514	326	10	0.8	5000	3.857	169.666	M2-1	0.5
33	760	781	571915	571134	808	48	0.8	5000	3.857	169.666	M2-1	0.5
36	1513	1518	1530375	1528857	1626	113	0.8	5000	3.857	169.666	M2-1	0.5
39	13374	13402	4501500	4488098	13454	80	0.8	5000	3.857	169.666	M2-1	0.5
41	0	0	0	0	0	0	0.8	5000	3.857	169.666	M2-1	0.5
42	28574	28588	10010575	9981987	29028	454	0.8	5000	3.857	169.666	M2-1	0.5
43	0	0	1	1	0	0	0.8	5000	3.857	169.666	M2-1	0.5
45	15556	15621	16522626	16507005	15908	352	0.8	5000	3.857	169.666	M2-1	0.5
46	0	0	1	1	0	0	0.8	5000	3.857	169.666	M2-1	0.5
48	31681	32345	24398605	24366260	31858	177	0.8	5000	3.857	169.666	M2-1	0.5
51	12008	14167	23988201	23974034	12272	264	0.8	5000	3.857	169.666	M2-1	0.5
52	0	0	0	0	0	0	0.8	5000	3.857	169.666	M2-1	0.5
54	32197	34863	24217320	24182457	32310	113	0.8	5000	3.857	169.666	M2-1	0.5
55	0	0	0	0	0	0	0.8	5000	3.857	169.666	M2-1	0.5
57	27808	28771	23932821	23904050	28383	575	0.8	5000	3.857	169.666	M2-1	0.5
58	0	0	0	0	0	0	0.8	5000	3.857	169.666	M2-1	0.5
59	0	0	1	1	0	0	0.8	5000	3.857	169.666	M2-1	0.5
60	13742	14059	16869336	16855277	13814	72	0.8	5000	3.857	169.666	M2-1	0.5
61	0	0	0	0	0	0	0.8	5000	3.857	169.666	M2-1	0.5
62	0	0	0	0	0	0	0.8	5000	3.857	169.666	M2-1	0.5
63	19819	19873	11608971	11589098	19919	100	0.8	5000	3.857	169.666	M2-1	0.5
64	0	0	0	0	0	0	0.8	5000	3.857	169.666	M2-1	0.5
66	42511	42563	7755891	7713328	42534	23	0.8	5000	3.857	169.666	M2-1	0.5
68	0	0	0	0	0	0	0.8	5000	3.857	169.666	M2-1	0.5
69	2709	2772	4928230	4925458	2756	47	0.8	5000	3.857	169.666	M2-1	0.5
72	2708	2716	2248260	2245544	2739	31	0.8	5000	3.857	169.666	M2-1	0.5
73	0	0	1	1	0	0	0.8	5000	3.857	169.666	M2-1	0.5
75	166295	166303	2494261	2327958	166302	7	0.8	5000	3.857	169.666	M2-1	0.5
78	606	617	541320	540703	626	20	0.8	5000	3.857	169.666	M2-1	0.5
81	18083	18097	402753	384656	18083	0	0.8	5000	3.857	169.666	M2-1	0.5
84	295	296	95703	95407	295	0	0.8	5000	3.857	169.666	M2-1	0.5
87	93	102	20100	19998	93	0	0.8	5000	3.857	169.666	M2-1	0.5
90	2	2	9045	9043	2	0	0.8	5000	3.857	169.666	M2-1	0.5
