junction_length	tpos	cond_pos	cond_all	cond_neg	test_pos	fpos	norm_mini	size_threshold	cut_off	para_pp	para_pw	radius	sample
12	0	0	0	0	0	0	0.6	1000	0.18	10.47	18.696	0.5	M3-1
24	19	19	528	509	30	11	0.6	1000	0.18	10.47	18.696	0.5	M3-1
27	1012	1012	3403	2391	1012	0	0.6	1000	0.18	10.47	18.696	0.5	M3-1
30	2244	2244	20706	18462	2316	72	0.6	1000	0.18	10.47	18.696	0.5	M3-1
33	14843	14843	188191	173348	14862	19	0.6	1000	0.18	10.47	18.696	0.5	M3-1
36	7242680	7242680	9894576	2651896	7242696	16	0.6	1000	0.18	10.47	18.696	0.5	M3-1
39	263445	263445	2729616	2466171	265509	2064	0.6	1000	0.18	10.47	18.696	0.5	M3-1
42	35786	35878	2158003	2122125	35930	144	0.6	1000	0.18	10.47	18.696	0.5	M3-1
45	53512	56285	3736011	3679726	53556	44	0.6	1000	0.18	10.47	18.696	0.5	M3-1
48	727790	728177	10776403	10048226	727878	88	0.6	1000	0.18	10.47	18.696	0.5	M3-1
51	440008	443478	10131751	9688273	440381	373	0.6	1000	0.18	10.47	18.696	0.5	M3-1
54	101974	102378	5519503	5417125	102100	126	0.6	1000	0.18	10.47	18.696	0.5	M3-1
57	99569	99788	4837605	4737817	100202	633	0.6	1000	0.18	10.47	18.696	0.5	M3-1
59	0	0	0	0	0	0	0.6	1000	0.18	10.47	18.696	0.5	M3-1
60	221007	221616	3573801	3352185	221053	46	0.6	1000	0.18	10.47	18.696	0.5	M3-1
62	0	0	0	0	0	0	0.6	1000	0.18	10.47	18.696	0.5	M3-1
63	575585	576491	9748320	9171829	575588	3	0.6	1000	0.18	10.47	18.696	0.5	M3-1
64	0	0	0	0	0	0	0.6	1000	0.18	10.47	18.696	0.5	M3-1
66	293126	293128	2492028	2198900	293130	4	0.6	1000	0.18	10.47	18.696	0.5	M3-1
68	10	10	15	5	10	0	0.6	1000	0.18	10.47	18.696	0.5	M3-1
69	359718	359725	4045590	3685865	359731	13	0.6	1000	0.18	10.47	18.696	0.5	M3-1
72	75013	75317	1553203	1477886	75013	0	0.6	1000	0.18	10.47	18.696	0.5	M3-1
75	18352	18352	328455	310103	18354	2	0.6	1000	0.18	10.47	18.696	0.5	M3-1
76	0	0	0	0	0	0	0.6	1000	0.18	10.47	18.696	0.5	M3-1
78	132572	132572	773146	640574	132574	2	0.6	1000	0.18	10.47	18.696	0.5	M3-1
81	5138	5138	36585	31447	5138	0	0.6	1000	0.18	10.47	18.696	0.5	M3-1
84	623	623	9730	9107	623	0	0.6	1000	0.18	10.47	18.696	0.5	M3-1
87	478	478	6670	6192	478	0	0.6	1000	0.18	10.47	18.696	0.5	M3-1
90	305	305	2278	1973	305	0	0.6	1000	0.18	10.47	18.696	0.5	M3-1
3	0	0	0	0	0	0	0.6	1000	0.1	13.687	16.987	0.5	M4-1
6	0	0	0	0	0	0	0.6	1000	0.1	13.687	16.987	0.5	M4-1
24	73	75	3570	3495	73	0	0.6	1000	0.1	13.687	16.987	0.5	M4-1
27	6507	6507	43071	36564	6507	0	0.6	1000	0.1	13.687	16.987	0.5	M4-1
30	709	716	40755	40039	714	5	0.6	1000	0.1	13.687	16.987	0.5	M4-1
33	33957	33984	424581	390597	33957	0	0.6	1000	0.1	13.687	16.987	0.5	M4-1
36	4964	4979	458403	453424	4970	6	0.6	1000	0.1	13.687	16.987	0.5	M4-1
39	216763	234607	6813586	6578979	216763	0	0.6	1000	0.1	13.687	16.987	0.5	M4-1
41	0	0	0	0	0	0	0.6	1000	0.1	13.687	16.987	0.5	M4-1
42	70402	74965	8559453	8484488	71502	1100	0.6	1000	0.1	13.687	16.987	0.5	M4-1
45	263590	274902	18638565	18363663	263601	11	0.6	1000	0.1	13.687	16.987	0.5	M4-1
47	0	0	0	0	0	0	0.6	1000	0.1	13.687	16.987	0.5	M4-1
48	178302	212334	24981846	24769512	178692	390	0.6	1000	0.1	13.687	16.987	0.5	M4-1
49	0	0	0	0	0	0	0.6	1000	0.1	13.687	16.987	0.5	M4-1
50	10	10	15	5	10	0	0.6	1000	0.1	13.687	16.987	0.5	M4-1
51	267688	270020	34283340	34013320	267697	9	0.6	1000	0.1	13.687	16.987	0.5	M4-1
52	0	0	0	0	0	0	0.6	1000	0.1	13.687	16.987	0.5	M4-1
53	0	0	1	1	0	0	0.6	1000	0.1	13.687	16.987	0.5	M4-1
54	240060	257003	26335653	26078650	240070	10	0.6	1000	0.1	13.687	16.987	0.5	M4-1
56	55	55	55	0	55	0	0.6	1000	0.1	13.687	16.987	0.5	M4-1
57	91412	92998	17307786	17214788	91424	12	0.6	1000	0.1	13.687	16.987	0.5	M4-1
58	0	0	0	0	0	0	0.6	1000	0.1	13.687	16.987	0.5	M4-1
60	172711	174264	15354111	15179847	172711	0	0.6	1000	0.1	13.687	16.987	0.5	M4-1
63	88681	90130	11987856	11897726	88723	42	0.6	1000	0.1	13.687	16.987	0.5	M4-1
65	0	0	0	0	0	0	0.6	1000	0.1	13.687	16.987	0.5	M4-1
66	188871	189660	8704878	8515218	188871	0	0.6	1000	0.1	13.687	16.987	0.5	M4-1
67	0	0	0	0	0	0	0.6	1000	0.1	13.687	16.987	0.5	M4-1
69	143924	148774	7634278	7485504	143924	0	0.6	1000	0.1	13.687	16.987	0.5	M4-1
72	1442620	1449473	11493615	10044142	1442621	1	0.6	1000	0.1	13.687	16.987	0.5	M4-1
73	1	1	1	0	1	0	0.6	1000	0.1	13.687	16.987	0.5	M4-1
75	18190	18309	962578	944269	18190	0	0.6	1000	0.1	13.687	16.987	0.5	M4-1
78	12173	12247	451725	439478	12173	0	0.6	1000	0.1	13.687	16.987	0.5	M4-1
81	1952	2002	126756	124754	1952	0	0.6	1000	0.1	13.687	16.987	0.5	M4-1
84	5572	5573	52650	47077	5572	0	0.6	1000	0.1	13.687	16.987	0.5	M4-1
87	620	621	12403	11782	620	0	0.6	1000	0.1	13.687	16.987	0.5	M4-1
90	218	233	4753	4520	218	0	0.6	1000	0.1	13.687	16.987	0.5	M4-1
3	0	0	0	0	0	0	0.6	1000	0.17	13.813	19.998	0.5	M4-1
6	0	0	0	0	0	0	0.6	1000	0.17	13.813	19.998	0.5	M4-1
24	75	75	3570	3495	93	18	0.6	1000	0.17	13.813	19.998	0.5	M4-1
27	6507	6507	43071	36564	6516	9	0.6	1000	0.17	13.813	19.998	0.5	M4-1
30	710	716	40755	40039	746	36	0.6	1000	0.17	13.813	19.998	0.5	M4-1
33	33976	33984	424581	390597	34138	162	0.6	1000	0.17	13.813	19.998	0.5	M4-1
36	4979	4979	458403	453424	5161	182	0.6	1000	0.17	13.813	19.998	0.5	M4-1
39	220612	234607	6813586	6578979	220744	132	0.6	1000	0.17	13.813	19.998	0.5	M4-1
41	0	0	0	0	0	0	0.6	1000	0.17	13.813	19.998	0.5	M4-1
42	70807	74965	8559453	8484488	72298	1491	0.6	1000	0.17	13.813	19.998	0.5	M4-1
45	266603	274902	18638565	18363663	266825	222	0.6	1000	0.17	13.813	19.998	0.5	M4-1
47	0	0	0	0	0	0	0.6	1000	0.17	13.813	19.998	0.5	M4-1
48	212082	212334	24981846	24769512	215643	3561	0.6	1000	0.17	13.813	19.998	0.5	M4-1
49	0	0	0	0	0	0	0.6	1000	0.17	13.813	19.998	0.5	M4-1
50	10	10	15	5	10	0	0.6	1000	0.17	13.813	19.998	0.5	M4-1
51	268550	270020	34283340	34013320	276295	7745	0.6	1000	0.17	13.813	19.998	0.5	M4-1
52	0	0	0	0	0	0	0.6	1000	0.17	13.813	19.998	0.5	M4-1
53	0	0	1	1	0	0	0.6	1000	0.17	13.813	19.998	0.5	M4-1
54	256549	257003	26335653	26078650	258051	1502	0.6	1000	0.17	13.813	19.998	0.5	M4-1
56	55	55	55	0	55	0	0.6	1000	0.17	13.813	19.998	0.5	M4-1
57	92886	92998	17307786	17214788	93151	265	0.6	1000	0.17	13.813	19.998	0.5	M4-1
58	0	0	0	0	0	0	0.6	1000	0.17	13.813	19.998	0.5	M4-1
60	173284	174264	15354111	15179847	173485	201	0.6	1000	0.17	13.813	19.998	0.5	M4-1
63	89343	90130	11987856	11897726	89419	76	0.6	1000	0.17	13.813	19.998	0.5	M4-1
65	0	0	0	0	0	0	0.6	1000	0.17	13.813	19.998	0.5	M4-1
66	189512	189660	8704878	8515218	189549	37	0.6	1000	0.17	13.813	19.998	0.5	M4-1
67	0	0	0	0	0	0	0.6	1000	0.17	13.813	19.998	0.5	M4-1
69	148691	148774	7634278	7485504	148793	102	0.6	1000	0.17	13.813	19.998	0.5	M4-1
72	1444440	1449473	11493615	10044142	1444459	19	0.6	1000	0.17	13.813	19.998	0.5	M4-1
73	1	1	1	0	1	0	0.6	1000	0.17	13.813	19.998	0.5	M4-1
75	18308	18309	962578	944269	18314	6	0.6	1000	0.17	13.813	19.998	0.5	M4-1
78	12208	12247	451725	439478	12212	4	0.6	1000	0.17	13.813	19.998	0.5	M4-1
81	2002	2002	126756	124754	2002	0	0.6	1000	0.17	13.813	19.998	0.5	M4-1
84	5572	5573	52650	47077	5572	0	0.6	1000	0.17	13.813	19.998	0.5	M4-1
87	620	621	12403	11782	620	0	0.6	1000	0.17	13.813	19.998	0.5	M4-1
90	233	233	4753	4520	233	0	0.6	1000	0.17	13.813	19.998	0.5	M4-1
3	0	0	0	0	0	0	0.6	1000	0.16	13.944	18.23	0.5	M4-1
6	0	0	0	0	0	0	0.6	1000	0.16	13.944	18.23	0.5	M4-1
24	73	75	3570	3495	83	10	0.6	1000	0.16	13.944	18.23	0.5	M4-1
27	6507	6507	43071	36564	6516	9	0.6	1000	0.16	13.944	18.23	0.5	M4-1
30	710	716	40755	40039	715	5	0.6	1000	0.16	13.944	18.23	0.5	M4-1
33	33976	33984	424581	390597	34138	162	0.6	1000	0.16	13.944	18.23	0.5	M4-1
36	4978	4979	458403	453424	5003	25	0.6	1000	0.16	13.944	18.23	0.5	M4-1
39	220612	234607	6813586	6578979	220744	132	0.6	1000	0.16	13.944	18.23	0.5	M4-1
41	0	0	0	0	0	0	0.6	1000	0.16	13.944	18.23	0.5	M4-1
42	70795	74965	8559453	8484488	72124	1329	0.6	1000	0.16	13.944	18.23	0.5	M4-1
45	266603	274902	18638565	18363663	266825	222	0.6	1000	0.16	13.944	18.23	0.5	M4-1
47	0	0	0	0	0	0	0.6	1000	0.16	13.944	18.23	0.5	M4-1
48	211812	212334	24981846	24769512	213964	2152	0.6	1000	0.16	13.944	18.23	0.5	M4-1
49	0	0	0	0	0	0	0.6	1000	0.16	13.944	18.23	0.5	M4-1
50	10	10	15	5	10	0	0.6	1000	0.16	13.944	18.23	0.5	M4-1
51	268550	270020	34283340	34013320	276295	7745	0.6	1000	0.16	13.944	18.23	0.5	M4-1
52	0	0	0	0	0	0	0.6	1000	0.16	13.944	18.23	0.5	M4-1
53	0	0	1	1	0	0	0.6	1000	0.16	13.944	18.23	0.5	M4-1
54	256548	257003	26335653	26078650	256601	53	0.6	1000	0.16	13.944	18.23	0.5	M4-1
56	55	55	55	0	55	0	0.6	1000	0.16	13.944	18.23	0.5	M4-1
57	92886	92998	17307786	17214788	93151	265	0.6	1000	0.16	13.944	18.23	0.5	M4-1
58	0	0	0	0	0	0	0.6	1000	0.16	13.944	18.23	0.5	M4-1
60	173214	174264	15354111	15179847	173321	107	0.6	1000	0.16	13.944	18.23	0.5	M4-1
63	89343	90130	11987856	11897726	89419	76	0.6	1000	0.16	13.944	18.23	0.5	M4-1
65	0	0	0	0	0	0	0.6	1000	0.16	13.944	18.23	0.5	M4-1
66	189512	189660	8704878	8515218	189519	7	0.6	1000	0.16	13.944	18.23	0.5	M4-1
67	0	0	0	0	0	0	0.6	1000	0.16	13.944	18.23	0.5	M4-1
69	148691	148774	7634278	7485504	148793	102	0.6	1000	0.16	13.944	18.23	0.5	M4-1
72	1444437	1449473	11493615	10044142	1444444	7	0.6	1000	0.16	13.944	18.23	0.5	M4-1
73	1	1	1	0	1	0	0.6	1000	0.16	13.944	18.23	0.5	M4-1
75	18308	18309	962578	944269	18314	6	0.6	1000	0.16	13.944	18.23	0.5	M4-1
78	12208	12247	451725	439478	12209	1	0.6	1000	0.16	13.944	18.23	0.5	M4-1
81	2002	2002	126756	124754	2002	0	0.6	1000	0.16	13.944	18.23	0.5	M4-1
84	5572	5573	52650	47077	5572	0	0.6	1000	0.16	13.944	18.23	0.5	M4-1
87	620	621	12403	11782	620	0	0.6	1000	0.16	13.944	18.23	0.5	M4-1
90	233	233	4753	4520	233	0	0.6	1000	0.16	13.944	18.23	0.5	M4-1
3	0	0	0	0	0	0	0.6	1000	0.2	14.467	20.161	0.5	M4-1
6	0	0	0	0	0	0	0.6	1000	0.2	14.467	20.161	0.5	M4-1
24	75	75	3570	3495	93	18	0.6	1000	0.2	14.467	20.161	0.5	M4-1
27	6507	6507	43071	36564	7006	499	0.6	1000	0.2	14.467	20.161	0.5	M4-1
30	716	716	40755	40039	1157	441	0.6	1000	0.2	14.467	20.161	0.5	M4-1
33	33976	33984	424581	390597	36817	2841	0.6	1000	0.2	14.467	20.161	0.5	M4-1
36	4979	4979	458403	453424	7317	2338	0.6	1000	0.2	14.467	20.161	0.5	M4-1
39	220612	234607	6813586	6578979	221387	775	0.6	1000	0.2	14.467	20.161	0.5	M4-1
41	0	0	0	0	0	0	0.6	1000	0.2	14.467	20.161	0.5	M4-1
42	70959	74965	8559453	8484488	73452	2493	0.6	1000	0.2	14.467	20.161	0.5	M4-1
45	266622	274902	18638565	18363663	268555	1933	0.6	1000	0.2	14.467	20.161	0.5	M4-1
47	0	0	0	0	0	0	0.6	1000	0.2	14.467	20.161	0.5	M4-1
48	212095	212334	24981846	24769512	216797	4702	0.6	1000	0.2	14.467	20.161	0.5	M4-1
49	0	0	0	0	0	0	0.6	1000	0.2	14.467	20.161	0.5	M4-1
50	10	10	15	5	10	0	0.6	1000	0.2	14.467	20.161	0.5	M4-1
51	269014	270020	34283340	34013320	295826	26812	0.6	1000	0.2	14.467	20.161	0.5	M4-1
52	0	0	0	0	0	0	0.6	1000	0.2	14.467	20.161	0.5	M4-1
53	0	0	1	1	0	0	0.6	1000	0.2	14.467	20.161	0.5	M4-1
54	256789	257003	26335653	26078650	260596	3807	0.6	1000	0.2	14.467	20.161	0.5	M4-1
56	55	55	55	0	55	0	0.6	1000	0.2	14.467	20.161	0.5	M4-1
57	92889	92998	17307786	17214788	97189	4300	0.6	1000	0.2	14.467	20.161	0.5	M4-1
58	0	0	0	0	0	0	0.6	1000	0.2	14.467	20.161	0.5	M4-1
60	173290	174264	15354111	15179847	177149	3859	0.6	1000	0.2	14.467	20.161	0.5	M4-1
63	89602	90130	11987856	11897726	89884	282	0.6	1000	0.2	14.467	20.161	0.5	M4-1
65	0	0	0	0	0	0	0.6	1000	0.2	14.467	20.161	0.5	M4-1
66	189566	189660	8704878	8515218	189782	216	0.6	1000	0.2	14.467	20.161	0.5	M4-1
67	0	0	0	0	0	0	0.6	1000	0.2	14.467	20.161	0.5	M4-1
69	148717	148774	7634278	7485504	149817	1100	0.6	1000	0.2	14.467	20.161	0.5	M4-1
72	1444457	1449473	11493615	10044142	1444498	41	0.6	1000	0.2	14.467	20.161	0.5	M4-1
73	1	1	1	0	1	0	0.6	1000	0.2	14.467	20.161	0.5	M4-1
75	18309	18309	962578	944269	18345	36	0.6	1000	0.2	14.467	20.161	0.5	M4-1
78	12247	12247	451725	439478	12267	20	0.6	1000	0.2	14.467	20.161	0.5	M4-1
81	2002	2002	126756	124754	2007	5	0.6	1000	0.2	14.467	20.161	0.5	M4-1
84	5572	5573	52650	47077	5572	0	0.6	1000	0.2	14.467	20.161	0.5	M4-1
87	620	621	12403	11782	620	0	0.6	1000	0.2	14.467	20.161	0.5	M4-1
90	233	233	4753	4520	233	0	0.6	1000	0.2	14.467	20.161	0.5	M4-1
3	0	0	0	0	0	0	0.6	1000	0.13	14.524	19.388	0.5	M4-1
6	0	0	0	0	0	0	0.6	1000	0.13	14.524	19.388	0.5	M4-1
24	73	75	3570	3495	83	10	0.6	1000	0.13	14.524	19.388	0.5	M4-1
27	6507	6507	43071	36564	6513	6	0.6	1000	0.13	14.524	19.388	0.5	M4-1
30	709	716	40755	40039	714	5	0.6	1000	0.13	14.524	19.388	0.5	M4-1
33	33966	33984	424581	390597	34022	56	0.6	1000	0.13	14.524	19.388	0.5	M4-1
36	4978	4979	458403	453424	4984	6	0.6	1000	0.13	14.524	19.388	0.5	M4-1
39	220610	234607	6813586	6578979	220691	81	0.6	1000	0.13	14.524	19.388	0.5	M4-1
41	0	0	0	0	0	0	0.6	1000	0.13	14.524	19.388	0.5	M4-1
42	70590	74965	8559453	8484488	71727	1137	0.6	1000	0.13	14.524	19.388	0.5	M4-1
45	266514	274902	18638565	18363663	266535	21	0.6	1000	0.13	14.524	19.388	0.5	M4-1
47	0	0	0	0	0	0	0.6	1000	0.13	14.524	19.388	0.5	M4-1
48	211734	212334	24981846	24769512	212648	914	0.6	1000	0.13	14.524	19.388	0.5	M4-1
49	0	0	0	0	0	0	0.6	1000	0.13	14.524	19.388	0.5	M4-1
50	10	10	15	5	10	0	0.6	1000	0.13	14.524	19.388	0.5	M4-1
51	268213	270020	34283340	34013320	268345	132	0.6	1000	0.13	14.524	19.388	0.5	M4-1
52	0	0	0	0	0	0	0.6	1000	0.13	14.524	19.388	0.5	M4-1
53	0	0	1	1	0	0	0.6	1000	0.13	14.524	19.388	0.5	M4-1
54	255769	257003	26335653	26078650	255795	26	0.6	1000	0.13	14.524	19.388	0.5	M4-1
56	55	55	55	0	55	0	0.6	1000	0.13	14.524	19.388	0.5	M4-1
57	92601	92998	17307786	17214788	92662	61	0.6	1000	0.13	14.524	19.388	0.5	M4-1
58	0	0	0	0	0	0	0.6	1000	0.13	14.524	19.388	0.5	M4-1
60	172821	174264	15354111	15179847	172822	1	0.6	1000	0.13	14.524	19.388	0.5	M4-1
63	89325	90130	11987856	11897726	89374	49	0.6	1000	0.13	14.524	19.388	0.5	M4-1
65	0	0	0	0	0	0	0.6	1000	0.13	14.524	19.388	0.5	M4-1
66	189092	189660	8704878	8515218	189092	0	0.6	1000	0.13	14.524	19.388	0.5	M4-1
67	0	0	0	0	0	0	0.6	1000	0.13	14.524	19.388	0.5	M4-1
69	148640	148774	7634278	7485504	148646	6	0.6	1000	0.13	14.524	19.388	0.5	M4-1
72	1444374	1449473	11493615	10044142	1444379	5	0.6	1000	0.13	14.524	19.388	0.5	M4-1
73	1	1	1	0	1	0	0.6	1000	0.13	14.524	19.388	0.5	M4-1
75	18218	18309	962578	944269	18218	0	0.6	1000	0.13	14.524	19.388	0.5	M4-1
78	12184	12247	451725	439478	12184	0	0.6	1000	0.13	14.524	19.388	0.5	M4-1
81	1988	2002	126756	124754	1988	0	0.6	1000	0.13	14.524	19.388	0.5	M4-1
84	5572	5573	52650	47077	5572	0	0.6	1000	0.13	14.524	19.388	0.5	M4-1
87	620	621	12403	11782	620	0	0.6	1000	0.13	14.524	19.388	0.5	M4-1
90	218	233	4753	4520	218	0	0.6	1000	0.13	14.524	19.388	0.5	M4-1
3	0	0	0	0	0	0	0.6	1000	0.14	14.97	19.158	0.5	M4-1
6	0	0	0	0	0	0	0.6	1000	0.14	14.97	19.158	0.5	M4-1
24	73	75	3570	3495	83	10	0.6	1000	0.14	14.97	19.158	0.5	M4-1
27	6507	6507	43071	36564	6513	6	0.6	1000	0.14	14.97	19.158	0.5	M4-1
30	710	716	40755	40039	715	5	0.6	1000	0.14	14.97	19.158	0.5	M4-1
33	33966	33984	424581	390597	34022	56	0.6	1000	0.14	14.97	19.158	0.5	M4-1
36	4978	4979	458403	453424	5003	25	0.6	1000	0.14	14.97	19.158	0.5	M4-1
39	220610	234607	6813586	6578979	220691	81	0.6	1000	0.14	14.97	19.158	0.5	M4-1
41	0	0	0	0	0	0	0.6	1000	0.14	14.97	19.158	0.5	M4-1
42	70590	74965	8559453	8484488	71727	1137	0.6	1000	0.14	14.97	19.158	0.5	M4-1
45	266594	274902	18638565	18363663	266668	74	0.6	1000	0.14	14.97	19.158	0.5	M4-1
47	0	0	0	0	0	0	0.6	1000	0.14	14.97	19.158	0.5	M4-1
48	211734	212334	24981846	24769512	212648	914	0.6	1000	0.14	14.97	19.158	0.5	M4-1
49	0	0	0	0	0	0	0.6	1000	0.14	14.97	19.158	0.5	M4-1
50	10	10	15	5	10	0	0.6	1000	0.14	14.97	19.158	0.5	M4-1
51	268524	270020	34283340	34013320	269601	1077	0.6	1000	0.14	14.97	19.158	0.5	M4-1
52	0	0	0	0	0	0	0.6	1000	0.14	14.97	19.158	0.5	M4-1
53	0	0	1	1	0	0	0.6	1000	0.14	14.97	19.158	0.5	M4-1
54	255769	257003	26335653	26078650	255795	26	0.6	1000	0.14	14.97	19.158	0.5	M4-1
56	55	55	55	0	55	0	0.6	1000	0.14	14.97	19.158	0.5	M4-1
57	92601	92998	17307786	17214788	92662	61	0.6	1000	0.14	14.97	19.158	0.5	M4-1
58	0	0	0	0	0	0	0.6	1000	0.14	14.97	19.158	0.5	M4-1
60	172868	174264	15354111	15179847	172896	28	0.6	1000	0.14	14.97	19.158	0.5	M4-1
63	89325	90130	11987856	11897726	89374	49	0.6	1000	0.14	14.97	19.158	0.5	M4-1
65	0	0	0	0	0	0	0.6	1000	0.14	14.97	19.158	0.5	M4-1
66	189483	189660	8704878	8515218	189483	0	0.6	1000	0.14	14.97	19.158	0.5	M4-1
67	0	0	0	0	0	0	0.6	1000	0.14	14.97	19.158	0.5	M4-1
69	148643	148774	7634278	7485504	148719	76	0.6	1000	0.14	14.97	19.158	0.5	M4-1
72	1444437	1449473	11493615	10044142	1444443	6	0.6	1000	0.14	14.97	19.158	0.5	M4-1
73	1	1	1	0	1	0	0.6	1000	0.14	14.97	19.158	0.5	M4-1
75	18288	18309	962578	944269	18289	1	0.6	1000	0.14	14.97	19.158	0.5	M4-1
78	12184	12247	451725	439478	12184	0	0.6	1000	0.14	14.97	19.158	0.5	M4-1
81	1988	2002	126756	124754	1988	0	0.6	1000	0.14	14.97	19.158	0.5	M4-1
84	5572	5573	52650	47077	5572	0	0.6	1000	0.14	14.97	19.158	0.5	M4-1
87	620	621	12403	11782	620	0	0.6	1000	0.14	14.97	19.158	0.5	M4-1
90	233	233	4753	4520	233	0	0.6	1000	0.14	14.97	19.158	0.5	M4-1
3	0	0	0	0	0	0	0.6	1000	0.11	15.912	22.068	0.5	M4-1
6	0	0	0	0	0	0	0.6	1000	0.11	15.912	22.068	0.5	M4-1
24	73	75	3570	3495	73	0	0.6	1000	0.11	15.912	22.068	0.5	M4-1
27	6507	6507	43071	36564	6507	0	0.6	1000	0.11	15.912	22.068	0.5	M4-1
30	709	716	40755	40039	714	5	0.6	1000	0.11	15.912	22.068	0.5	M4-1
33	33957	33984	424581	390597	33957	0	0.6	1000	0.11	15.912	22.068	0.5	M4-1
36	4964	4979	458403	453424	4970	6	0.6	1000	0.11	15.912	22.068	0.5	M4-1
39	218354	234607	6813586	6578979	218373	19	0.6	1000	0.11	15.912	22.068	0.5	M4-1
41	0	0	0	0	0	0	0.6	1000	0.11	15.912	22.068	0.5	M4-1
42	70402	74965	8559453	8484488	71502	1100	0.6	1000	0.11	15.912	22.068	0.5	M4-1
45	263590	274902	18638565	18363663	263601	11	0.6	1000	0.11	15.912	22.068	0.5	M4-1
47	0	0	0	0	0	0	0.6	1000	0.11	15.912	22.068	0.5	M4-1
48	210917	212334	24981846	24769512	211324	407	0.6	1000	0.11	15.912	22.068	0.5	M4-1
49	0	0	0	0	0	0	0.6	1000	0.11	15.912	22.068	0.5	M4-1
50	10	10	15	5	10	0	0.6	1000	0.11	15.912	22.068	0.5	M4-1
51	267688	270020	34283340	34013320	267697	9	0.6	1000	0.11	15.912	22.068	0.5	M4-1
52	0	0	0	0	0	0	0.6	1000	0.11	15.912	22.068	0.5	M4-1
53	0	0	1	1	0	0	0.6	1000	0.11	15.912	22.068	0.5	M4-1
54	240060	257003	26335653	26078650	240070	10	0.6	1000	0.11	15.912	22.068	0.5	M4-1
56	55	55	55	0	55	0	0.6	1000	0.11	15.912	22.068	0.5	M4-1
57	91948	92998	17307786	17214788	91964	16	0.6	1000	0.11	15.912	22.068	0.5	M4-1
58	0	0	0	0	0	0	0.6	1000	0.11	15.912	22.068	0.5	M4-1
60	172711	174264	15354111	15179847	172711	0	0.6	1000	0.11	15.912	22.068	0.5	M4-1
63	88681	90130	11987856	11897726	88723	42	0.6	1000	0.11	15.912	22.068	0.5	M4-1
65	0	0	0	0	0	0	0.6	1000	0.11	15.912	22.068	0.5	M4-1
66	188994	189660	8704878	8515218	188994	0	0.6	1000	0.11	15.912	22.068	0.5	M4-1
67	0	0	0	0	0	0	0.6	1000	0.11	15.912	22.068	0.5	M4-1
69	145489	148774	7634278	7485504	145489	0	0.6	1000	0.11	15.912	22.068	0.5	M4-1
72	1442620	1449473	11493615	10044142	1442621	1	0.6	1000	0.11	15.912	22.068	0.5	M4-1
73	1	1	1	0	1	0	0.6	1000	0.11	15.912	22.068	0.5	M4-1
75	18193	18309	962578	944269	18193	0	0.6	1000	0.11	15.912	22.068	0.5	M4-1
78	12178	12247	451725	439478	12178	0	0.6	1000	0.11	15.912	22.068	0.5	M4-1
81	1952	2002	126756	124754	1952	0	0.6	1000	0.11	15.912	22.068	0.5	M4-1
84	5572	5573	52650	47077	5572	0	0.6	1000	0.11	15.912	22.068	0.5	M4-1
87	620	621	12403	11782	620	0	0.6	1000	0.11	15.912	22.068	0.5	M4-1
90	218	233	4753	4520	218	0	0.6	1000	0.11	15.912	22.068	0.5	M4-1
3	0	0	0	0	0	0	0.6	1000	0.15	16.122	24.648	0.5	M4-1
6	0	0	0	0	0	0	0.6	1000	0.15	16.122	24.648	0.5	M4-1
24	73	75	3570	3495	83	10	0.6	1000	0.15	16.122	24.648	0.5	M4-1
27	6507	6507	43071	36564	6516	9	0.6	1000	0.15	16.122	24.648	0.5	M4-1
30	710	716	40755	40039	715	5	0.6	1000	0.15	16.122	24.648	0.5	M4-1
33	33966	33984	424581	390597	34022	56	0.6	1000	0.15	16.122	24.648	0.5	M4-1
36	4978	4979	458403	453424	5003	25	0.6	1000	0.15	16.122	24.648	0.5	M4-1
39	220610	234607	6813586	6578979	220691	81	0.6	1000	0.15	16.122	24.648	0.5	M4-1
41	0	0	0	0	0	0	0.6	1000	0.15	16.122	24.648	0.5	M4-1
42	70795	74965	8559453	8484488	72124	1329	0.6	1000	0.15	16.122	24.648	0.5	M4-1
45	266594	274902	18638565	18363663	266668	74	0.6	1000	0.15	16.122	24.648	0.5	M4-1
47	0	0	0	0	0	0	0.6	1000	0.15	16.122	24.648	0.5	M4-1
48	211812	212334	24981846	24769512	213964	2152	0.6	1000	0.15	16.122	24.648	0.5	M4-1
49	0	0	0	0	0	0	0.6	1000	0.15	16.122	24.648	0.5	M4-1
50	10	10	15	5	10	0	0.6	1000	0.15	16.122	24.648	0.5	M4-1
51	268524	270020	34283340	34013320	269601	1077	0.6	1000	0.15	16.122	24.648	0.5	M4-1
52	0	0	0	0	0	0	0.6	1000	0.15	16.122	24.648	0.5	M4-1
53	0	0	1	1	0	0	0.6	1000	0.15	16.122	24.648	0.5	M4-1
54	256548	257003	26335653	26078650	256601	53	0.6	1000	0.15	16.122	24.648	0.5	M4-1
56	55	55	55	0	55	0	0.6	1000	0.15	16.122	24.648	0.5	M4-1
57	92778	92998	17307786	17214788	92885	107	0.6	1000	0.15	16.122	24.648	0.5	M4-1
58	0	0	0	0	0	0	0.6	1000	0.15	16.122	24.648	0.5	M4-1
60	173214	174264	15354111	15179847	173321	107	0.6	1000	0.15	16.122	24.648	0.5	M4-1
63	89342	90130	11987856	11897726	89398	56	0.6	1000	0.15	16.122	24.648	0.5	M4-1
65	0	0	0	0	0	0	0.6	1000	0.15	16.122	24.648	0.5	M4-1
66	189483	189660	8704878	8515218	189483	0	0.6	1000	0.15	16.122	24.648	0.5	M4-1
67	0	0	0	0	0	0	0.6	1000	0.15	16.122	24.648	0.5	M4-1
69	148648	148774	7634278	7485504	148734	86	0.6	1000	0.15	16.122	24.648	0.5	M4-1
72	1444437	1449473	11493615	10044142	1444443	6	0.6	1000	0.15	16.122	24.648	0.5	M4-1
73	1	1	1	0	1	0	0.6	1000	0.15	16.122	24.648	0.5	M4-1
75	18308	18309	962578	944269	18312	4	0.6	1000	0.15	16.122	24.648	0.5	M4-1
78	12205	12247	451725	439478	12205	0	0.6	1000	0.15	16.122	24.648	0.5	M4-1
81	2002	2002	126756	124754	2002	0	0.6	1000	0.15	16.122	24.648	0.5	M4-1
84	5572	5573	52650	47077	5572	0	0.6	1000	0.15	16.122	24.648	0.5	M4-1
87	620	621	12403	11782	620	0	0.6	1000	0.15	16.122	24.648	0.5	M4-1
90	233	233	4753	4520	233	0	0.6	1000	0.15	16.122	24.648	0.5	M4-1
3	0	0	0	0	0	0	0.6	1000	0.19	16.275	19.375	0.5	M4-1
6	0	0	0	0	0	0	0.6	1000	0.19	16.275	19.375	0.5	M4-1
24	75	75	3570	3495	93	18	0.6	1000	0.19	16.275	19.375	0.5	M4-1
27	6507	6507	43071	36564	7006	499	0.6	1000	0.19	16.275	19.375	0.5	M4-1
30	710	716	40755	40039	746	36	0.6	1000	0.19	16.275	19.375	0.5	M4-1
33	33976	33984	424581	390597	36817	2841	0.6	1000	0.19	16.275	19.375	0.5	M4-1
36	4979	4979	458403	453424	5161	182	0.6	1000	0.19	16.275	19.375	0.5	M4-1
39	220612	234607	6813586	6578979	221387	775	0.6	1000	0.19	16.275	19.375	0.5	M4-1
41	0	0	0	0	0	0	0.6	1000	0.19	16.275	19.375	0.5	M4-1
42	70807	74965	8559453	8484488	72298	1491	0.6	1000	0.19	16.275	19.375	0.5	M4-1
45	266622	274902	18638565	18363663	267068	446	0.6	1000	0.19	16.275	19.375	0.5	M4-1
47	0	0	0	0	0	0	0.6	1000	0.19	16.275	19.375	0.5	M4-1
48	212095	212334	24981846	24769512	216797	4702	0.6	1000	0.19	16.275	19.375	0.5	M4-1
49	0	0	0	0	0	0	0.6	1000	0.19	16.275	19.375	0.5	M4-1
50	10	10	15	5	10	0	0.6	1000	0.19	16.275	19.375	0.5	M4-1
51	269012	270020	34283340	34013320	281272	12260	0.6	1000	0.19	16.275	19.375	0.5	M4-1
52	0	0	0	0	0	0	0.6	1000	0.19	16.275	19.375	0.5	M4-1
53	0	0	1	1	0	0	0.6	1000	0.19	16.275	19.375	0.5	M4-1
54	256789	257003	26335653	26078650	260596	3807	0.6	1000	0.19	16.275	19.375	0.5	M4-1
56	55	55	55	0	55	0	0.6	1000	0.19	16.275	19.375	0.5	M4-1
57	92889	92998	17307786	17214788	95450	2561	0.6	1000	0.19	16.275	19.375	0.5	M4-1
58	0	0	0	0	0	0	0.6	1000	0.19	16.275	19.375	0.5	M4-1
60	173290	174264	15354111	15179847	173834	544	0.6	1000	0.19	16.275	19.375	0.5	M4-1
63	89592	90130	11987856	11897726	89700	108	0.6	1000	0.19	16.275	19.375	0.5	M4-1
65	0	0	0	0	0	0	0.6	1000	0.19	16.275	19.375	0.5	M4-1
66	189512	189660	8704878	8515218	189640	128	0.6	1000	0.19	16.275	19.375	0.5	M4-1
67	0	0	0	0	0	0	0.6	1000	0.19	16.275	19.375	0.5	M4-1
69	148717	148774	7634278	7485504	149817	1100	0.6	1000	0.19	16.275	19.375	0.5	M4-1
72	1444441	1449473	11493615	10044142	1444461	20	0.6	1000	0.19	16.275	19.375	0.5	M4-1
73	1	1	1	0	1	0	0.6	1000	0.19	16.275	19.375	0.5	M4-1
75	18309	18309	962578	944269	18330	21	0.6	1000	0.19	16.275	19.375	0.5	M4-1
78	12247	12247	451725	439478	12261	14	0.6	1000	0.19	16.275	19.375	0.5	M4-1
81	2002	2002	126756	124754	2007	5	0.6	1000	0.19	16.275	19.375	0.5	M4-1
84	5572	5573	52650	47077	5572	0	0.6	1000	0.19	16.275	19.375	0.5	M4-1
87	620	621	12403	11782	620	0	0.6	1000	0.19	16.275	19.375	0.5	M4-1
90	233	233	4753	4520	233	0	0.6	1000	0.19	16.275	19.375	0.5	M4-1
3	0	0	0	0	0	0	0.6	1000	0.2	18.347	24.587	0.5	M2-1
12	1	1	1	0	1	0	0.6	1000	0.2	18.347	24.587	0.5	M2-1
15	0	0	0	0	0	0	0.6	1000	0.2	18.347	24.587	0.5	M2-1
24	80	80	17391	17311	331	251	0.6	1000	0.2	18.347	24.587	0.5	M2-1
27	58	58	20706	20648	299	241	0.6	1000	0.2	18.347	24.587	0.5	M2-1
30	317	317	102831	102514	1696	1379	0.6	1000	0.2	18.347	24.587	0.5	M2-1
33	781	781	571915	571134	7481	6700	0.6	1000	0.2	18.347	24.587	0.5	M2-1
36	1469	1518	1530375	1528857	3214	1745	0.6	1000	0.2	18.347	24.587	0.5	M2-1
39	13345	13402	4501500	4488098	15155	1810	0.6	1000	0.2	18.347	24.587	0.5	M2-1
41	0	0	0	0	0	0	0.6	1000	0.2	18.347	24.587	0.5	M2-1
42	28498	28588	10010575	9981987	31028	2530	0.6	1000	0.2	18.347	24.587	0.5	M2-1
43	0	0	1	1	0	0	0.6	1000	0.2	18.347	24.587	0.5	M2-1
45	14894	15621	16522626	16507005	20696	5802	0.6	1000	0.2	18.347	24.587	0.5	M2-1
46	0	0	1	1	0	0	0.6	1000	0.2	18.347	24.587	0.5	M2-1
48	32291	32345	24398605	24366260	42790	10499	0.6	1000	0.2	18.347	24.587	0.5	M2-1
51	14072	14167	23988201	23974034	23583	9511	0.6	1000	0.2	18.347	24.587	0.5	M2-1
52	0	0	0	0	0	0	0.6	1000	0.2	18.347	24.587	0.5	M2-1
54	34188	34863	24217320	24182457	44673	10485	0.6	1000	0.2	18.347	24.587	0.5	M2-1
55	0	0	0	0	0	0	0.6	1000	0.2	18.347	24.587	0.5	M2-1
57	28479	28771	23932821	23904050	41601	13122	0.6	1000	0.2	18.347	24.587	0.5	M2-1
58	0	0	0	0	0	0	0.6	1000	0.2	18.347	24.587	0.5	M2-1
59	0	0	1	1	0	0	0.6	1000	0.2	18.347	24.587	0.5	M2-1
60	13985	14059	16869336	16855277	18895	4910	0.6	1000	0.2	18.347	24.587	0.5	M2-1
61	0	0	0	0	0	0	0.6	1000	0.2	18.347	24.587	0.5	M2-1
62	0	0	0	0	0	0	0.6	1000	0.2	18.347	24.587	0.5	M2-1
63	19862	19873	11608971	11589098	21918	2056	0.6	1000	0.2	18.347	24.587	0.5	M2-1
64	0	0	0	0	0	0	0.6	1000	0.2	18.347	24.587	0.5	M2-1
66	42546	42563	7755891	7713328	44600	2054	0.6	1000	0.2	18.347	24.587	0.5	M2-1
68	0	0	0	0	0	0	0.6	1000	0.2	18.347	24.587	0.5	M2-1
69	2743	2772	4928230	4925458	3494	751	0.6	1000	0.2	18.347	24.587	0.5	M2-1
72	2709	2716	2248260	2245544	2887	178	0.6	1000	0.2	18.347	24.587	0.5	M2-1
73	0	0	1	1	0	0	0.6	1000	0.2	18.347	24.587	0.5	M2-1
75	166293	166303	2494261	2327958	166469	176	0.6	1000	0.2	18.347	24.587	0.5	M2-1
78	617	617	541320	540703	1232	615	0.6	1000	0.2	18.347	24.587	0.5	M2-1
81	18097	18097	402753	384656	18128	31	0.6	1000	0.2	18.347	24.587	0.5	M2-1
84	295	296	95703	95407	299	4	0.6	1000	0.2	18.347	24.587	0.5	M2-1
87	102	102	20100	19998	111	9	0.6	1000	0.2	18.347	24.587	0.5	M2-1
90	2	2	9045	9043	2	0	0.6	1000	0.2	18.347	24.587	0.5	M2-1
3	0	0	0	0	0	0	0.6	1000	0.18	19.201	26.121	0.5	M4-1
6	0	0	0	0	0	0	0.6	1000	0.18	19.201	26.121	0.5	M4-1
24	75	75	3570	3495	93	18	0.6	1000	0.18	19.201	26.121	0.5	M4-1
27	6507	6507	43071	36564	6516	9	0.6	1000	0.18	19.201	26.121	0.5	M4-1
30	710	716	40755	40039	746	36	0.6	1000	0.18	19.201	26.121	0.5	M4-1
33	33976	33984	424581	390597	34138	162	0.6	1000	0.18	19.201	26.121	0.5	M4-1
36	4979	4979	458403	453424	5161	182	0.6	1000	0.18	19.201	26.121	0.5	M4-1
39	220612	234607	6813586	6578979	221387	775	0.6	1000	0.18	19.201	26.121	0.5	M4-1
41	0	0	0	0	0	0	0.6	1000	0.18	19.201	26.121	0.5	M4-1
42	70807	74965	8559453	8484488	72298	1491	0.6	1000	0.18	19.201	26.121	0.5	M4-1
45	266622	274902	18638565	18363663	267068	446	0.6	1000	0.18	19.201	26.121	0.5	M4-1
47	0	0	0	0	0	0	0.6	1000	0.18	19.201	26.121	0.5	M4-1
48	212082	212334	24981846	24769512	215643	3561	0.6	1000	0.18	19.201	26.121	0.5	M4-1
49	0	0	0	0	0	0	0.6	1000	0.18	19.201	26.121	0.5	M4-1
50	10	10	15	5	10	0	0.6	1000	0.18	19.201	26.121	0.5	M4-1
51	269012	270020	34283340	34013320	281272	12260	0.6	1000	0.18	19.201	26.121	0.5	M4-1
52	0	0	0	0	0	0	0.6	1000	0.18	19.201	26.121	0.5	M4-1
53	0	0	1	1	0	0	0.6	1000	0.18	19.201	26.121	0.5	M4-1
54	256549	257003	26335653	26078650	258051	1502	0.6	1000	0.18	19.201	26.121	0.5	M4-1
56	55	55	55	0	55	0	0.6	1000	0.18	19.201	26.121	0.5	M4-1
57	92889	92998	17307786	17214788	95450	2561	0.6	1000	0.18	19.201	26.121	0.5	M4-1
58	0	0	0	0	0	0	0.6	1000	0.18	19.201	26.121	0.5	M4-1
60	173284	174264	15354111	15179847	173485	201	0.6	1000	0.18	19.201	26.121	0.5	M4-1
63	89592	90130	11987856	11897726	89700	108	0.6	1000	0.18	19.201	26.121	0.5	M4-1
65	0	0	0	0	0	0	0.6	1000	0.18	19.201	26.121	0.5	M4-1
66	189512	189660	8704878	8515218	189549	37	0.6	1000	0.18	19.201	26.121	0.5	M4-1
67	0	0	0	0	0	0	0.6	1000	0.18	19.201	26.121	0.5	M4-1
69	148694	148774	7634278	7485504	148837	143	0.6	1000	0.18	19.201	26.121	0.5	M4-1
72	1444440	1449473	11493615	10044142	1444459	19	0.6	1000	0.18	19.201	26.121	0.5	M4-1
73	1	1	1	0	1	0	0.6	1000	0.18	19.201	26.121	0.5	M4-1
75	18308	18309	962578	944269	18316	8	0.6	1000	0.18	19.201	26.121	0.5	M4-1
78	12247	12247	451725	439478	12261	14	0.6	1000	0.18	19.201	26.121	0.5	M4-1
81	2002	2002	126756	124754	2002	0	0.6	1000	0.18	19.201	26.121	0.5	M4-1
84	5572	5573	52650	47077	5572	0	0.6	1000	0.18	19.201	26.121	0.5	M4-1
87	620	621	12403	11782	620	0	0.6	1000	0.18	19.201	26.121	0.5	M4-1
90	233	233	4753	4520	233	0	0.6	1000	0.18	19.201	26.121	0.5	M4-1
3	0	0	0	0	0	0	0.6	1000	0.13	19.551	29.606	0.5	M2-1
12	1	1	1	0	1	0	0.6	1000	0.13	19.551	29.606	0.5	M2-1
15	0	0	0	0	0	0	0.6	1000	0.13	19.551	29.606	0.5	M2-1
24	80	80	17391	17311	238	158	0.6	1000	0.13	19.551	29.606	0.5	M2-1
27	58	58	20706	20648	65	7	0.6	1000	0.13	19.551	29.606	0.5	M2-1
30	316	317	102831	102514	326	10	0.6	1000	0.13	19.551	29.606	0.5	M2-1
33	777	781	571915	571134	1183	406	0.6	1000	0.13	19.551	29.606	0.5	M2-1
36	1468	1518	1530375	1528857	1543	75	0.6	1000	0.13	19.551	29.606	0.5	M2-1
39	13340	13402	4501500	4488098	13516	176	0.6	1000	0.13	19.551	29.606	0.5	M2-1
41	0	0	0	0	0	0	0.6	1000	0.13	19.551	29.606	0.5	M2-1
42	28486	28588	10010575	9981987	28725	239	0.6	1000	0.13	19.551	29.606	0.5	M2-1
43	0	0	1	1	0	0	0.6	1000	0.13	19.551	29.606	0.5	M2-1
45	14838	15621	16522626	16507005	15079	241	0.6	1000	0.13	19.551	29.606	0.5	M2-1
46	0	0	1	1	0	0	0.6	1000	0.13	19.551	29.606	0.5	M2-1
48	32174	32345	24398605	24366260	32839	665	0.6	1000	0.13	19.551	29.606	0.5	M2-1
51	13967	14167	23988201	23974034	14271	304	0.6	1000	0.13	19.551	29.606	0.5	M2-1
52	0	0	0	0	0	0	0.6	1000	0.13	19.551	29.606	0.5	M2-1
54	33976	34863	24217320	24182457	34571	595	0.6	1000	0.13	19.551	29.606	0.5	M2-1
55	0	0	0	0	0	0	0.6	1000	0.13	19.551	29.606	0.5	M2-1
57	28432	28771	23932821	23904050	29335	903	0.6	1000	0.13	19.551	29.606	0.5	M2-1
58	0	0	0	0	0	0	0.6	1000	0.13	19.551	29.606	0.5	M2-1
59	0	0	1	1	0	0	0.6	1000	0.13	19.551	29.606	0.5	M2-1
60	13941	14059	16869336	16855277	14021	80	0.6	1000	0.13	19.551	29.606	0.5	M2-1
61	0	0	0	0	0	0	0.6	1000	0.13	19.551	29.606	0.5	M2-1
62	0	0	0	0	0	0	0.6	1000	0.13	19.551	29.606	0.5	M2-1
63	19828	19873	11608971	11589098	19914	86	0.6	1000	0.13	19.551	29.606	0.5	M2-1
64	0	0	0	0	0	0	0.6	1000	0.13	19.551	29.606	0.5	M2-1
66	42515	42563	7755891	7713328	42533	18	0.6	1000	0.13	19.551	29.606	0.5	M2-1
68	0	0	0	0	0	0	0.6	1000	0.13	19.551	29.606	0.5	M2-1
69	2685	2772	4928230	4925458	2722	37	0.6	1000	0.13	19.551	29.606	0.5	M2-1
72	2704	2716	2248260	2245544	2730	26	0.6	1000	0.13	19.551	29.606	0.5	M2-1
73	0	0	1	1	0	0	0.6	1000	0.13	19.551	29.606	0.5	M2-1
75	166287	166303	2494261	2327958	166292	5	0.6	1000	0.13	19.551	29.606	0.5	M2-1
78	614	617	541320	540703	646	32	0.6	1000	0.13	19.551	29.606	0.5	M2-1
81	18097	18097	402753	384656	18097	0	0.6	1000	0.13	19.551	29.606	0.5	M2-1
84	295	296	95703	95407	295	0	0.6	1000	0.13	19.551	29.606	0.5	M2-1
87	96	102	20100	19998	96	0	0.6	1000	0.13	19.551	29.606	0.5	M2-1
90	2	2	9045	9043	2	0	0.6	1000	0.13	19.551	29.606	0.5	M2-1
3	0	0	0	0	0	0	0.6	1000	0.14	19.737	24.261	0.5	M2-1
12	1	1	1	0	1	0	0.6	1000	0.14	19.737	24.261	0.5	M2-1
15	0	0	0	0	0	0	0.6	1000	0.14	19.737	24.261	0.5	M2-1
24	80	80	17391	17311	238	158	0.6	1000	0.14	19.737	24.261	0.5	M2-1
27	58	58	20706	20648	65	7	0.6	1000	0.14	19.737	24.261	0.5	M2-1
30	317	317	102831	102514	418	101	0.6	1000	0.14	19.737	24.261	0.5	M2-1
33	777	781	571915	571134	1183	406	0.6	1000	0.14	19.737	24.261	0.5	M2-1
36	1468	1518	1530375	1528857	1628	160	0.6	1000	0.14	19.737	24.261	0.5	M2-1
39	13340	13402	4501500	4488098	13516	176	0.6	1000	0.14	19.737	24.261	0.5	M2-1
41	0	0	0	0	0	0	0.6	1000	0.14	19.737	24.261	0.5	M2-1
42	28486	28588	10010575	9981987	28725	239	0.6	1000	0.14	19.737	24.261	0.5	M2-1
43	0	0	1	1	0	0	0.6	1000	0.14	19.737	24.261	0.5	M2-1
45	14878	15621	16522626	16507005	15459	581	0.6	1000	0.14	19.737	24.261	0.5	M2-1
46	0	0	1	1	0	0	0.6	1000	0.14	19.737	24.261	0.5	M2-1
48	32174	32345	24398605	24366260	32839	665	0.6	1000	0.14	19.737	24.261	0.5	M2-1
51	13993	14167	23988201	23974034	15317	1324	0.6	1000	0.14	19.737	24.261	0.5	M2-1
52	0	0	0	0	0	0	0.6	1000	0.14	19.737	24.261	0.5	M2-1
54	33976	34863	24217320	24182457	34571	595	0.6	1000	0.14	19.737	24.261	0.5	M2-1
55	0	0	0	0	0	0	0.6	1000	0.14	19.737	24.261	0.5	M2-1
57	28432	28771	23932821	23904050	29335	903	0.6	1000	0.14	19.737	24.261	0.5	M2-1
58	0	0	0	0	0	0	0.6	1000	0.14	19.737	24.261	0.5	M2-1
59	0	0	1	1	0	0	0.6	1000	0.14	19.737	24.261	0.5	M2-1
60	13946	14059	16869336	16855277	14107	161	0.6	1000	0.14	19.737	24.261	0.5	M2-1
61	0	0	0	0	0	0	0.6	1000	0.14	19.737	24.261	0.5	M2-1
62	0	0	0	0	0	0	0.6	1000	0.14	19.737	24.261	0.5	M2-1
63	19828	19873	11608971	11589098	19914	86	0.6	1000	0.14	19.737	24.261	0.5	M2-1
64	0	0	0	0	0	0	0.6	1000	0.14	19.737	24.261	0.5	M2-1
66	42535	42563	7755891	7713328	42654	119	0.6	1000	0.14	19.737	24.261	0.5	M2-1
68	0	0	0	0	0	0	0.6	1000	0.14	19.737	24.261	0.5	M2-1
69	2700	2772	4928230	4925458	2758	58	0.6	1000	0.14	19.737	24.261	0.5	M2-1
72	2705	2716	2248260	2245544	2739	34	0.6	1000	0.14	19.737	24.261	0.5	M2-1
73	0	0	1	1	0	0	0.6	1000	0.14	19.737	24.261	0.5	M2-1
75	166290	166303	2494261	2327958	166303	13	0.6	1000	0.14	19.737	24.261	0.5	M2-1
78	614	617	541320	540703	646	32	0.6	1000	0.14	19.737	24.261	0.5	M2-1
81	18097	18097	402753	384656	18097	0	0.6	1000	0.14	19.737	24.261	0.5	M2-1
84	295	296	95703	95407	295	0	0.6	1000	0.14	19.737	24.261	0.5	M2-1
87	96	102	20100	19998	96	0	0.6	1000	0.14	19.737	24.261	0.5	M2-1
90	2	2	9045	9043	2	0	0.6	1000	0.14	19.737	24.261	0.5	M2-1
3	0	0	0	0	0	0	0.6	1000	0.11	19.855	24.924	0.5	M2-1
12	1	1	1	0	1	0	0.6	1000	0.11	19.855	24.924	0.5	M2-1
15	0	0	0	0	0	0	0.6	1000	0.11	19.855	24.924	0.5	M2-1
24	80	80	17391	17311	132	52	0.6	1000	0.11	19.855	24.924	0.5	M2-1
27	58	58	20706	20648	60	2	0.6	1000	0.11	19.855	24.924	0.5	M2-1
30	316	317	102831	102514	326	10	0.6	1000	0.11	19.855	24.924	0.5	M2-1
33	760	781	571915	571134	808	48	0.6	1000	0.11	19.855	24.924	0.5	M2-1
36	1457	1518	1530375	1528857	1489	32	0.6	1000	0.11	19.855	24.924	0.5	M2-1
39	13325	13402	4501500	4488098	13394	69	0.6	1000	0.11	19.855	24.924	0.5	M2-1
41	0	0	0	0	0	0	0.6	1000	0.11	19.855	24.924	0.5	M2-1
42	28450	28588	10010575	9981987	28550	100	0.6	1000	0.11	19.855	24.924	0.5	M2-1
43	0	0	1	1	0	0	0.6	1000	0.11	19.855	24.924	0.5	M2-1
45	14721	15621	16522626	16507005	14822	101	0.6	1000	0.11	19.855	24.924	0.5	M2-1
46	0	0	1	1	0	0	0.6	1000	0.11	19.855	24.924	0.5	M2-1
48	32137	32345	24398605	24366260	32345	208	0.6	1000	0.11	19.855	24.924	0.5	M2-1
51	13883	14167	23988201	23974034	13967	84	0.6	1000	0.11	19.855	24.924	0.5	M2-1
52	0	0	0	0	0	0	0.6	1000	0.11	19.855	24.924	0.5	M2-1
54	33846	34863	24217320	24182457	33911	65	0.6	1000	0.11	19.855	24.924	0.5	M2-1
55	0	0	0	0	0	0	0.6	1000	0.11	19.855	24.924	0.5	M2-1
57	28314	28771	23932821	23904050	29174	860	0.6	1000	0.11	19.855	24.924	0.5	M2-1
58	0	0	0	0	0	0	0.6	1000	0.11	19.855	24.924	0.5	M2-1
59	0	0	1	1	0	0	0.6	1000	0.11	19.855	24.924	0.5	M2-1
60	13802	14059	16869336	16855277	13842	40	0.6	1000	0.11	19.855	24.924	0.5	M2-1
61	0	0	0	0	0	0	0.6	1000	0.11	19.855	24.924	0.5	M2-1
62	0	0	0	0	0	0	0.6	1000	0.11	19.855	24.924	0.5	M2-1
63	19766	19873	11608971	11589098	19817	51	0.6	1000	0.11	19.855	24.924	0.5	M2-1
64	0	0	0	0	0	0	0.6	1000	0.11	19.855	24.924	0.5	M2-1
66	42504	42563	7755891	7713328	42518	14	0.6	1000	0.11	19.855	24.924	0.5	M2-1
68	0	0	0	0	0	0	0.6	1000	0.11	19.855	24.924	0.5	M2-1
69	2684	2772	4928230	4925458	2703	19	0.6	1000	0.11	19.855	24.924	0.5	M2-1
72	2693	2716	2248260	2245544	2700	7	0.6	1000	0.11	19.855	24.924	0.5	M2-1
73	0	0	1	1	0	0	0.6	1000	0.11	19.855	24.924	0.5	M2-1
75	166282	166303	2494261	2327958	166287	5	0.6	1000	0.11	19.855	24.924	0.5	M2-1
78	603	617	541320	540703	612	9	0.6	1000	0.11	19.855	24.924	0.5	M2-1
81	18070	18097	402753	384656	18070	0	0.6	1000	0.11	19.855	24.924	0.5	M2-1
84	295	296	95703	95407	295	0	0.6	1000	0.11	19.855	24.924	0.5	M2-1
87	82	102	20100	19998	82	0	0.6	1000	0.11	19.855	24.924	0.5	M2-1
90	2	2	9045	9043	2	0	0.6	1000	0.11	19.855	24.924	0.5	M2-1
3	0	0	0	0	0	0	0.6	1000	0.16	20.21	27.939	0.5	M2-1
12	1	1	1	0	1	0	0.6	1000	0.16	20.21	27.939	0.5	M2-1
15	0	0	0	0	0	0	0.6	1000	0.16	20.21	27.939	0.5	M2-1
24	80	80	17391	17311	238	158	0.6	1000	0.16	20.21	27.939	0.5	M2-1
27	58	58	20706	20648	137	79	0.6	1000	0.16	20.21	27.939	0.5	M2-1
30	317	317	102831	102514	418	101	0.6	1000	0.16	20.21	27.939	0.5	M2-1
33	781	781	571915	571134	2125	1344	0.6	1000	0.16	20.21	27.939	0.5	M2-1
36	1468	1518	1530375	1528857	1628	160	0.6	1000	0.16	20.21	27.939	0.5	M2-1
39	13345	13402	4501500	4488098	14068	723	0.6	1000	0.16	20.21	27.939	0.5	M2-1
41	0	0	0	0	0	0	0.6	1000	0.16	20.21	27.939	0.5	M2-1
42	28493	28588	10010575	9981987	28932	439	0.6	1000	0.16	20.21	27.939	0.5	M2-1
43	0	0	1	1	0	0	0.6	1000	0.16	20.21	27.939	0.5	M2-1
45	14888	15621	16522626	16507005	16456	1568	0.6	1000	0.16	20.21	27.939	0.5	M2-1
46	0	0	1	1	0	0	0.6	1000	0.16	20.21	27.939	0.5	M2-1
48	32265	32345	24398605	24366260	33953	1688	0.6	1000	0.16	20.21	27.939	0.5	M2-1
51	14000	14167	23988201	23974034	17517	3517	0.6	1000	0.16	20.21	27.939	0.5	M2-1
52	0	0	0	0	0	0	0.6	1000	0.16	20.21	27.939	0.5	M2-1
54	34001	34863	24217320	24182457	36084	2083	0.6	1000	0.16	20.21	27.939	0.5	M2-1
55	0	0	0	0	0	0	0.6	1000	0.16	20.21	27.939	0.5	M2-1
57	28477	28771	23932821	23904050	32005	3528	0.6	1000	0.16	20.21	27.939	0.5	M2-1
58	0	0	0	0	0	0	0.6	1000	0.16	20.21	27.939	0.5	M2-1
59	0	0	1	1	0	0	0.6	1000	0.16	20.21	27.939	0.5	M2-1
60	13949	14059	16869336	16855277	14546	597	0.6	1000	0.16	20.21	27.939	0.5	M2-1
61	0	0	0	0	0	0	0.6	1000	0.16	20.21	27.939	0.5	M2-1
62	0	0	0	0	0	0	0.6	1000	0.16	20.21	27.939	0.5	M2-1
63	19861	19873	11608971	11589098	20146	285	0.6	1000	0.16	20.21	27.939	0.5	M2-1
64	0	0	0	0	0	0	0.6	1000	0.16	20.21	27.939	0.5	M2-1
66	42544	42563	7755891	7713328	42738	194	0.6	1000	0.16	20.21	27.939	0.5	M2-1
68	0	0	0	0	0	0	0.6	1000	0.16	20.21	27.939	0.5	M2-1
69	2739	2772	4928230	4925458	2948	209	0.6	1000	0.16	20.21	27.939	0.5	M2-1
72	2709	2716	2248260	2245544	2775	66	0.6	1000	0.16	20.21	27.939	0.5	M2-1
73	0	0	1	1	0	0	0.6	1000	0.16	20.21	27.939	0.5	M2-1
75	166290	166303	2494261	2327958	166364	74	0.6	1000	0.16	20.21	27.939	0.5	M2-1
78	615	617	541320	540703	727	112	0.6	1000	0.16	20.21	27.939	0.5	M2-1
81	18097	18097	402753	384656	18097	0	0.6	1000	0.16	20.21	27.939	0.5	M2-1
84	295	296	95703	95407	295	0	0.6	1000	0.16	20.21	27.939	0.5	M2-1
87	102	102	20100	19998	102	0	0.6	1000	0.16	20.21	27.939	0.5	M2-1
90	2	2	9045	9043	2	0	0.6	1000	0.16	20.21	27.939	0.5	M2-1
3	0	0	0	0	0	0	0.6	1000	0.12	20.592	26.33	0.5	M2-1
12	1	1	1	0	1	0	0.6	1000	0.12	20.592	26.33	0.5	M2-1
15	0	0	0	0	0	0	0.6	1000	0.12	20.592	26.33	0.5	M2-1
24	80	80	17391	17311	132	52	0.6	1000	0.12	20.592	26.33	0.5	M2-1
27	58	58	20706	20648	65	7	0.6	1000	0.12	20.592	26.33	0.5	M2-1
30	316	317	102831	102514	326	10	0.6	1000	0.12	20.592	26.33	0.5	M2-1
33	760	781	571915	571134	808	48	0.6	1000	0.12	20.592	26.33	0.5	M2-1
36	1468	1518	1530375	1528857	1543	75	0.6	1000	0.12	20.592	26.33	0.5	M2-1
39	13325	13402	4501500	4488098	13394	69	0.6	1000	0.12	20.592	26.33	0.5	M2-1
41	0	0	0	0	0	0	0.6	1000	0.12	20.592	26.33	0.5	M2-1
42	28486	28588	10010575	9981987	28725	239	0.6	1000	0.12	20.592	26.33	0.5	M2-1
43	0	0	1	1	0	0	0.6	1000	0.12	20.592	26.33	0.5	M2-1
45	14838	15621	16522626	16507005	15079	241	0.6	1000	0.12	20.592	26.33	0.5	M2-1
46	0	0	1	1	0	0	0.6	1000	0.12	20.592	26.33	0.5	M2-1
48	32137	32345	24398605	24366260	32345	208	0.6	1000	0.12	20.592	26.33	0.5	M2-1
51	13967	14167	23988201	23974034	14271	304	0.6	1000	0.12	20.592	26.33	0.5	M2-1
52	0	0	0	0	0	0	0.6	1000	0.12	20.592	26.33	0.5	M2-1
54	33934	34863	24217320	24182457	34092	158	0.6	1000	0.12	20.592	26.33	0.5	M2-1
55	0	0	0	0	0	0	0.6	1000	0.12	20.592	26.33	0.5	M2-1
57	28314	28771	23932821	23904050	29174	860	0.6	1000	0.12	20.592	26.33	0.5	M2-1
58	0	0	0	0	0	0	0.6	1000	0.12	20.592	26.33	0.5	M2-1
59	0	0	1	1	0	0	0.6	1000	0.12	20.592	26.33	0.5	M2-1
60	13941	14059	16869336	16855277	14021	80	0.6	1000	0.12	20.592	26.33	0.5	M2-1
61	0	0	0	0	0	0	0.6	1000	0.12	20.592	26.33	0.5	M2-1
62	0	0	0	0	0	0	0.6	1000	0.12	20.592	26.33	0.5	M2-1
63	19815	19873	11608971	11589098	19878	63	0.6	1000	0.12	20.592	26.33	0.5	M2-1
64	0	0	0	0	0	0	0.6	1000	0.12	20.592	26.33	0.5	M2-1
66	42504	42563	7755891	7713328	42518	14	0.6	1000	0.12	20.592	26.33	0.5	M2-1
68	0	0	0	0	0	0	0.6	1000	0.12	20.592	26.33	0.5	M2-1
69	2685	2772	4928230	4925458	2722	37	0.6	1000	0.12	20.592	26.33	0.5	M2-1
72	2703	2716	2248260	2245544	2720	17	0.6	1000	0.12	20.592	26.33	0.5	M2-1
73	0	0	1	1	0	0	0.6	1000	0.12	20.592	26.33	0.5	M2-1
75	166287	166303	2494261	2327958	166292	5	0.6	1000	0.12	20.592	26.33	0.5	M2-1
78	606	617	541320	540703	626	20	0.6	1000	0.12	20.592	26.33	0.5	M2-1
81	18083	18097	402753	384656	18083	0	0.6	1000	0.12	20.592	26.33	0.5	M2-1
84	295	296	95703	95407	295	0	0.6	1000	0.12	20.592	26.33	0.5	M2-1
87	93	102	20100	19998	93	0	0.6	1000	0.12	20.592	26.33	0.5	M2-1
90	2	2	9045	9043	2	0	0.6	1000	0.12	20.592	26.33	0.5	M2-1
3	0	0	0	0	0	0	0.6	1000	0.15	20.887	30.98	0.5	M2-1
12	1	1	1	0	1	0	0.6	1000	0.15	20.887	30.98	0.5	M2-1
15	0	0	0	0	0	0	0.6	1000	0.15	20.887	30.98	0.5	M2-1
24	80	80	17391	17311	238	158	0.6	1000	0.15	20.887	30.98	0.5	M2-1
27	58	58	20706	20648	137	79	0.6	1000	0.15	20.887	30.98	0.5	M2-1
30	317	317	102831	102514	418	101	0.6	1000	0.15	20.887	30.98	0.5	M2-1
33	777	781	571915	571134	1183	406	0.6	1000	0.15	20.887	30.98	0.5	M2-1
36	1468	1518	1530375	1528857	1628	160	0.6	1000	0.15	20.887	30.98	0.5	M2-1
39	13340	13402	4501500	4488098	13516	176	0.6	1000	0.15	20.887	30.98	0.5	M2-1
41	0	0	0	0	0	0	0.6	1000	0.15	20.887	30.98	0.5	M2-1
42	28493	28588	10010575	9981987	28932	439	0.6	1000	0.15	20.887	30.98	0.5	M2-1
43	0	0	1	1	0	0	0.6	1000	0.15	20.887	30.98	0.5	M2-1
45	14878	15621	16522626	16507005	15459	581	0.6	1000	0.15	20.887	30.98	0.5	M2-1
46	0	0	1	1	0	0	0.6	1000	0.15	20.887	30.98	0.5	M2-1
48	32265	32345	24398605	24366260	33953	1688	0.6	1000	0.15	20.887	30.98	0.5	M2-1
51	13993	14167	23988201	23974034	15317	1324	0.6	1000	0.15	20.887	30.98	0.5	M2-1
52	0	0	0	0	0	0	0.6	1000	0.15	20.887	30.98	0.5	M2-1
54	34001	34863	24217320	24182457	36084	2083	0.6	1000	0.15	20.887	30.98	0.5	M2-1
55	0	0	0	0	0	0	0.6	1000	0.15	20.887	30.98	0.5	M2-1
57	28476	28771	23932821	23904050	29988	1512	0.6	1000	0.15	20.887	30.98	0.5	M2-1
58	0	0	0	0	0	0	0.6	1000	0.15	20.887	30.98	0.5	M2-1
59	0	0	1	1	0	0	0.6	1000	0.15	20.887	30.98	0.5	M2-1
60	13949	14059	16869336	16855277	14546	597	0.6	1000	0.15	20.887	30.98	0.5	M2-1
61	0	0	0	0	0	0	0.6	1000	0.15	20.887	30.98	0.5	M2-1
62	0	0	0	0	0	0	0.6	1000	0.15	20.887	30.98	0.5	M2-1
63	19855	19873	11608971	11589098	20008	153	0.6	1000	0.15	20.887	30.98	0.5	M2-1
64	0	0	0	0	0	0	0.6	1000	0.15	20.887	30.98	0.5	M2-1
66	42535	42563	7755891	7713328	42654	119	0.6	1000	0.15	20.887	30.98	0.5	M2-1
68	0	0	0	0	0	0	0.6	1000	0.15	20.887	30.98	0.5	M2-1
69	2737	2772	4928230	4925458	2850	113	0.6	1000	0.15	20.887	30.98	0.5	M2-1
72	2705	2716	2248260	2245544	2739	34	0.6	1000	0.15	20.887	30.98	0.5	M2-1
73	0	0	1	1	0	0	0.6	1000	0.15	20.887	30.98	0.5	M2-1
75	166290	166303	2494261	2327958	166331	41	0.6	1000	0.15	20.887	30.98	0.5	M2-1
78	614	617	541320	540703	701	87	0.6	1000	0.15	20.887	30.98	0.5	M2-1
81	18097	18097	402753	384656	18097	0	0.6	1000	0.15	20.887	30.98	0.5	M2-1
84	295	296	95703	95407	295	0	0.6	1000	0.15	20.887	30.98	0.5	M2-1
87	102	102	20100	19998	102	0	0.6	1000	0.15	20.887	30.98	0.5	M2-1
90	2	2	9045	9043	2	0	0.6	1000	0.15	20.887	30.98	0.5	M2-1
6	0	0	0	0	0	0	0.6	1000	0.1	22.318	29.619	0.5	M5-1
8	3	6	6	0	3	0	0.6	1000	0.1	22.318	29.619	0.5	M5-1
9	28	28	28	0	28	0	0.6	1000	0.1	22.318	29.619	0.5	M5-1
24	9161	9286	76636	67350	9282	121	0.6	1000	0.1	22.318	29.619	0.5	M5-1
27	9928	11312	53956	42644	9928	0	0.6	1000	0.1	22.318	29.619	0.5	M5-1
30	84740	84807	512578	427771	84741	1	0.6	1000	0.1	22.318	29.619	0.5	M5-1
33	15278	16399	1097421	1081022	15288	10	0.6	1000	0.1	22.318	29.619	0.5	M5-1
35	0	0	0	0	0	0	0.6	1000	0.1	22.318	29.619	0.5	M5-1
36	38224	38513	3324331	3285818	38246	22	0.6	1000	0.1	22.318	29.619	0.5	M5-1
37	0	0	0	0	0	0	0.6	1000	0.1	22.318	29.619	0.5	M5-1
39	71418	78081	8914753	8836672	71420	2	0.6	1000	0.1	22.318	29.619	0.5	M5-1
40	0	0	0	0	0	0	0.6	1000	0.1	22.318	29.619	0.5	M5-1
42	161951	168038	24440536	24272498	161979	28	0.6	1000	0.1	22.318	29.619	0.5	M5-1
45	178320	190901	46527481	46336580	178451	131	0.6	1000	0.1	22.318	29.619	0.5	M5-1
47	0	0	0	0	0	0	0.6	1000	0.1	22.318	29.619	0.5	M5-1
48	421821	430088	84142878	83712790	422273	452	0.6	1000	0.1	22.318	29.619	0.5	M5-1
49	0	0	0	0	0	0	0.6	1000	0.1	22.318	29.619	0.5	M5-1
51	276815	283513	65259600	64976087	278494	1679	0.6	1000	0.1	22.318	29.619	0.5	M5-1
54	389895	394658	62826445	62431787	389904	9	0.6	1000	0.1	22.318	29.619	0.5	M5-1
55	1	1	1	0	1	0	0.6	1000	0.1	22.318	29.619	0.5	M5-1
57	397702	402140	60077241	59675101	397888	186	0.6	1000	0.1	22.318	29.619	0.5	M5-1
58	0	0	0	0	0	0	0.6	1000	0.1	22.318	29.619	0.5	M5-1
59	0	0	0	0	0	0	0.6	1000	0.1	22.318	29.619	0.5	M5-1
60	138098	141584	42878430	42736846	138399	301	0.6	1000	0.1	22.318	29.619	0.5	M5-1
61	0	1	1	0	0	0	0.6	1000	0.1	22.318	29.619	0.5	M5-1
62	3	3	6	3	3	0	0.6	1000	0.1	22.318	29.619	0.5	M5-1
63	282150	283443	33020001	32736558	282213	63	0.6	1000	0.1	22.318	29.619	0.5	M5-1
64	0	0	0	0	0	0	0.6	1000	0.1	22.318	29.619	0.5	M5-1
66	143382	146922	23225520	23078598	143382	0	0.6	1000	0.1	22.318	29.619	0.5	M5-1
69	208731	210783	17877210	17666427	208752	21	0.6	1000	0.1	22.318	29.619	0.5	M5-1
72	196788	198785	11005086	10806301	196964	176	0.6	1000	0.1	22.318	29.619	0.5	M5-1
75	24142	27401	2809635	2782234	24146	4	0.6	1000	0.1	22.318	29.619	0.5	M5-1
76	0	0	0	0	0	0	0.6	1000	0.1	22.318	29.619	0.5	M5-1
78	57186	58159	2273778	2215619	57186	0	0.6	1000	0.1	22.318	29.619	0.5	M5-1
81	14821	14958	644680	629722	14821	0	0.6	1000	0.1	22.318	29.619	0.5	M5-1
84	29207	29526	328455	298929	29207	0	0.6	1000	0.1	22.318	29.619	0.5	M5-1
87	4182	4182	52650	48468	4185	3	0.6	1000	0.1	22.318	29.619	0.5	M5-1
90	2090	2090	18721	16631	2090	0	0.6	1000	0.1	22.318	29.619	0.5	M5-1
3	0	0	0	0	0	0	0.6	1000	0.12	22.358	22.601	0.5	M4-1
6	0	0	0	0	0	0	0.6	1000	0.12	22.358	22.601	0.5	M4-1
24	73	75	3570	3495	73	0	0.6	1000	0.12	22.358	22.601	0.5	M4-1
27	6507	6507	43071	36564	6513	6	0.6	1000	0.12	22.358	22.601	0.5	M4-1
30	709	716	40755	40039	714	5	0.6	1000	0.12	22.358	22.601	0.5	M4-1
33	33957	33984	424581	390597	33957	0	0.6	1000	0.12	22.358	22.601	0.5	M4-1
36	4978	4979	458403	453424	4984	6	0.6	1000	0.12	22.358	22.601	0.5	M4-1
39	218354	234607	6813586	6578979	218373	19	0.6	1000	0.12	22.358	22.601	0.5	M4-1
41	0	0	0	0	0	0	0.6	1000	0.12	22.358	22.601	0.5	M4-1
42	70590	74965	8559453	8484488	71727	1137	0.6	1000	0.12	22.358	22.601	0.5	M4-1
45	266514	274902	18638565	18363663	266535	21	0.6	1000	0.12	22.358	22.601	0.5	M4-1
47	0	0	0	0	0	0	0.6	1000	0.12	22.358	22.601	0.5	M4-1
48	210917	212334	24981846	24769512	211324	407	0.6	1000	0.12	22.358	22.601	0.5	M4-1
49	0	0	0	0	0	0	0.6	1000	0.12	22.358	22.601	0.5	M4-1
50	10	10	15	5	10	0	0.6	1000	0.12	22.358	22.601	0.5	M4-1
51	268213	270020	34283340	34013320	268345	132	0.6	1000	0.12	22.358	22.601	0.5	M4-1
52	0	0	0	0	0	0	0.6	1000	0.12	22.358	22.601	0.5	M4-1
53	0	0	1	1	0	0	0.6	1000	0.12	22.358	22.601	0.5	M4-1
54	249358	257003	26335653	26078650	249378	20	0.6	1000	0.12	22.358	22.601	0.5	M4-1
56	55	55	55	0	55	0	0.6	1000	0.12	22.358	22.601	0.5	M4-1
57	91948	92998	17307786	17214788	91964	16	0.6	1000	0.12	22.358	22.601	0.5	M4-1
58	0	0	0	0	0	0	0.6	1000	0.12	22.358	22.601	0.5	M4-1
60	172821	174264	15354111	15179847	172822	1	0.6	1000	0.12	22.358	22.601	0.5	M4-1
63	89249	90130	11987856	11897726	89298	49	0.6	1000	0.12	22.358	22.601	0.5	M4-1
65	0	0	0	0	0	0	0.6	1000	0.12	22.358	22.601	0.5	M4-1
66	188994	189660	8704878	8515218	188994	0	0.6	1000	0.12	22.358	22.601	0.5	M4-1
67	0	0	0	0	0	0	0.6	1000	0.12	22.358	22.601	0.5	M4-1
69	148640	148774	7634278	7485504	148646	6	0.6	1000	0.12	22.358	22.601	0.5	M4-1
72	1444297	1449473	11493615	10044142	1444302	5	0.6	1000	0.12	22.358	22.601	0.5	M4-1
73	1	1	1	0	1	0	0.6	1000	0.12	22.358	22.601	0.5	M4-1
75	18218	18309	962578	944269	18218	0	0.6	1000	0.12	22.358	22.601	0.5	M4-1
78	12180	12247	451725	439478	12180	0	0.6	1000	0.12	22.358	22.601	0.5	M4-1
81	1988	2002	126756	124754	1988	0	0.6	1000	0.12	22.358	22.601	0.5	M4-1
84	5572	5573	52650	47077	5572	0	0.6	1000	0.12	22.358	22.601	0.5	M4-1
87	620	621	12403	11782	620	0	0.6	1000	0.12	22.358	22.601	0.5	M4-1
90	218	233	4753	4520	218	0	0.6	1000	0.12	22.358	22.601	0.5	M4-1
6	0	0	0	0	0	0	0.6	1000	0.12	22.81	28.654	0.5	M5-1
8	3	6	6	0	3	0	0.6	1000	0.12	22.81	28.654	0.5	M5-1
9	28	28	28	0	28	0	0.6	1000	0.12	22.81	28.654	0.5	M5-1
24	9161	9286	76636	67350	9282	121	0.6	1000	0.12	22.81	28.654	0.5	M5-1
27	9928	11312	53956	42644	9928	0	0.6	1000	0.12	22.81	28.654	0.5	M5-1
30	84740	84807	512578	427771	84741	1	0.6	1000	0.12	22.81	28.654	0.5	M5-1
33	15278	16399	1097421	1081022	15288	10	0.6	1000	0.12	22.81	28.654	0.5	M5-1
35	0	0	0	0	0	0	0.6	1000	0.12	22.81	28.654	0.5	M5-1
36	38392	38513	3324331	3285818	38422	30	0.6	1000	0.12	22.81	28.654	0.5	M5-1
37	0	0	0	0	0	0	0.6	1000	0.12	22.81	28.654	0.5	M5-1
39	75263	78081	8914753	8836672	75265	2	0.6	1000	0.12	22.81	28.654	0.5	M5-1
40	0	0	0	0	0	0	0.6	1000	0.12	22.81	28.654	0.5	M5-1
42	165925	168038	24440536	24272498	166040	115	0.6	1000	0.12	22.81	28.654	0.5	M5-1
45	181392	190901	46527481	46336580	181571	179	0.6	1000	0.12	22.81	28.654	0.5	M5-1
47	0	0	0	0	0	0	0.6	1000	0.12	22.81	28.654	0.5	M5-1
48	424076	430088	84142878	83712790	424571	495	0.6	1000	0.12	22.81	28.654	0.5	M5-1
49	0	0	0	0	0	0	0.6	1000	0.12	22.81	28.654	0.5	M5-1
51	280272	283513	65259600	64976087	282047	1775	0.6	1000	0.12	22.81	28.654	0.5	M5-1
54	392839	394658	62826445	62431787	392946	107	0.6	1000	0.12	22.81	28.654	0.5	M5-1
55	1	1	1	0	1	0	0.6	1000	0.12	22.81	28.654	0.5	M5-1
57	400340	402140	60077241	59675101	400562	222	0.6	1000	0.12	22.81	28.654	0.5	M5-1
58	0	0	0	0	0	0	0.6	1000	0.12	22.81	28.654	0.5	M5-1
59	0	0	0	0	0	0	0.6	1000	0.12	22.81	28.654	0.5	M5-1
60	138715	141584	42878430	42736846	139023	308	0.6	1000	0.12	22.81	28.654	0.5	M5-1
61	0	1	1	0	0	0	0.6	1000	0.12	22.81	28.654	0.5	M5-1
62	3	3	6	3	3	0	0.6	1000	0.12	22.81	28.654	0.5	M5-1
63	282571	283443	33020001	32736558	282634	63	0.6	1000	0.12	22.81	28.654	0.5	M5-1
64	0	0	0	0	0	0	0.6	1000	0.12	22.81	28.654	0.5	M5-1
66	145514	146922	23225520	23078598	145514	0	0.6	1000	0.12	22.81	28.654	0.5	M5-1
69	209870	210783	17877210	17666427	209905	35	0.6	1000	0.12	22.81	28.654	0.5	M5-1
72	197525	198785	11005086	10806301	197707	182	0.6	1000	0.12	22.81	28.654	0.5	M5-1
75	27215	27401	2809635	2782234	27219	4	0.6	1000	0.12	22.81	28.654	0.5	M5-1
76	0	0	0	0	0	0	0.6	1000	0.12	22.81	28.654	0.5	M5-1
78	57367	58159	2273778	2215619	57367	0	0.6	1000	0.12	22.81	28.654	0.5	M5-1
81	14868	14958	644680	629722	14868	0	0.6	1000	0.12	22.81	28.654	0.5	M5-1
84	29235	29526	328455	298929	29235	0	0.6	1000	0.12	22.81	28.654	0.5	M5-1
87	4182	4182	52650	48468	4185	3	0.6	1000	0.12	22.81	28.654	0.5	M5-1
90	2090	2090	18721	16631	2090	0	0.6	1000	0.12	22.81	28.654	0.5	M5-1
3	0	0	0	0	0	0	0.6	1000	0.17	22.856	27.026	0.5	M2-1
12	1	1	1	0	1	0	0.6	1000	0.17	22.856	27.026	0.5	M2-1
15	0	0	0	0	0	0	0.6	1000	0.17	22.856	27.026	0.5	M2-1
24	80	80	17391	17311	331	251	0.6	1000	0.17	22.856	27.026	0.5	M2-1
27	58	58	20706	20648	137	79	0.6	1000	0.17	22.856	27.026	0.5	M2-1
30	317	317	102831	102514	1107	790	0.6	1000	0.17	22.856	27.026	0.5	M2-1
33	781	781	571915	571134	2125	1344	0.6	1000	0.17	22.856	27.026	0.5	M2-1
36	1469	1518	1530375	1528857	2334	865	0.6	1000	0.17	22.856	27.026	0.5	M2-1
39	13345	13402	4501500	4488098	14068	723	0.6	1000	0.17	22.856	27.026	0.5	M2-1
41	0	0	0	0	0	0	0.6	1000	0.17	22.856	27.026	0.5	M2-1
42	28497	28588	10010575	9981987	29828	1331	0.6	1000	0.17	22.856	27.026	0.5	M2-1
43	0	0	1	1	0	0	0.6	1000	0.17	22.856	27.026	0.5	M2-1
45	14888	15621	16522626	16507005	16456	1568	0.6	1000	0.17	22.856	27.026	0.5	M2-1
46	0	0	1	1	0	0	0.6	1000	0.17	22.856	27.026	0.5	M2-1
48	32290	32345	24398605	24366260	35982	3692	0.6	1000	0.17	22.856	27.026	0.5	M2-1
51	14000	14167	23988201	23974034	17517	3517	0.6	1000	0.17	22.856	27.026	0.5	M2-1
52	0	0	0	0	0	0	0.6	1000	0.17	22.856	27.026	0.5	M2-1
54	34188	34863	24217320	24182457	41165	6977	0.6	1000	0.17	22.856	27.026	0.5	M2-1
55	0	0	0	0	0	0	0.6	1000	0.17	22.856	27.026	0.5	M2-1
57	28477	28771	23932821	23904050	32005	3528	0.6	1000	0.17	22.856	27.026	0.5	M2-1
58	0	0	0	0	0	0	0.6	1000	0.17	22.856	27.026	0.5	M2-1
59	0	0	1	1	0	0	0.6	1000	0.17	22.856	27.026	0.5	M2-1
60	13957	14059	16869336	16855277	15327	1370	0.6	1000	0.17	22.856	27.026	0.5	M2-1
61	0	0	0	0	0	0	0.6	1000	0.17	22.856	27.026	0.5	M2-1
62	0	0	0	0	0	0	0.6	1000	0.17	22.856	27.026	0.5	M2-1
63	19861	19873	11608971	11589098	20146	285	0.6	1000	0.17	22.856	27.026	0.5	M2-1
64	0	0	0	0	0	0	0.6	1000	0.17	22.856	27.026	0.5	M2-1
66	42546	42563	7755891	7713328	42965	419	0.6	1000	0.17	22.856	27.026	0.5	M2-1
68	0	0	0	0	0	0	0.6	1000	0.17	22.856	27.026	0.5	M2-1
69	2739	2772	4928230	4925458	2948	209	0.6	1000	0.17	22.856	27.026	0.5	M2-1
72	2709	2716	2248260	2245544	2836	127	0.6	1000	0.17	22.856	27.026	0.5	M2-1
73	0	0	1	1	0	0	0.6	1000	0.17	22.856	27.026	0.5	M2-1
75	166290	166303	2494261	2327958	166364	74	0.6	1000	0.17	22.856	27.026	0.5	M2-1
78	616	617	541320	540703	816	200	0.6	1000	0.17	22.856	27.026	0.5	M2-1
81	18097	18097	402753	384656	18120	23	0.6	1000	0.17	22.856	27.026	0.5	M2-1
84	295	296	95703	95407	296	1	0.6	1000	0.17	22.856	27.026	0.5	M2-1
87	102	102	20100	19998	102	0	0.6	1000	0.17	22.856	27.026	0.5	M2-1
90	2	2	9045	9043	2	0	0.6	1000	0.17	22.856	27.026	0.5	M2-1
6	0	0	0	0	0	0	0.6	1000	0.11	23.094	30.714	0.5	M5-1
8	3	6	6	0	3	0	0.6	1000	0.11	23.094	30.714	0.5	M5-1
9	28	28	28	0	28	0	0.6	1000	0.11	23.094	30.714	0.5	M5-1
24	9161	9286	76636	67350	9282	121	0.6	1000	0.11	23.094	30.714	0.5	M5-1
27	9928	11312	53956	42644	9928	0	0.6	1000	0.11	23.094	30.714	0.5	M5-1
30	84740	84807	512578	427771	84741	1	0.6	1000	0.11	23.094	30.714	0.5	M5-1
33	15278	16399	1097421	1081022	15288	10	0.6	1000	0.11	23.094	30.714	0.5	M5-1
35	0	0	0	0	0	0	0.6	1000	0.11	23.094	30.714	0.5	M5-1
36	38224	38513	3324331	3285818	38246	22	0.6	1000	0.11	23.094	30.714	0.5	M5-1
37	0	0	0	0	0	0	0.6	1000	0.11	23.094	30.714	0.5	M5-1
39	75263	78081	8914753	8836672	75265	2	0.6	1000	0.11	23.094	30.714	0.5	M5-1
40	0	0	0	0	0	0	0.6	1000	0.11	23.094	30.714	0.5	M5-1
42	161951	168038	24440536	24272498	161979	28	0.6	1000	0.11	23.094	30.714	0.5	M5-1
45	178320	190901	46527481	46336580	178451	131	0.6	1000	0.11	23.094	30.714	0.5	M5-1
47	0	0	0	0	0	0	0.6	1000	0.11	23.094	30.714	0.5	M5-1
48	424076	430088	84142878	83712790	424571	495	0.6	1000	0.11	23.094	30.714	0.5	M5-1
49	0	0	0	0	0	0	0.6	1000	0.11	23.094	30.714	0.5	M5-1
51	276815	283513	65259600	64976087	278494	1679	0.6	1000	0.11	23.094	30.714	0.5	M5-1
54	389895	394658	62826445	62431787	389904	9	0.6	1000	0.11	23.094	30.714	0.5	M5-1
55	1	1	1	0	1	0	0.6	1000	0.11	23.094	30.714	0.5	M5-1
57	400340	402140	60077241	59675101	400562	222	0.6	1000	0.11	23.094	30.714	0.5	M5-1
58	0	0	0	0	0	0	0.6	1000	0.11	23.094	30.714	0.5	M5-1
59	0	0	0	0	0	0	0.6	1000	0.11	23.094	30.714	0.5	M5-1
60	138098	141584	42878430	42736846	138399	301	0.6	1000	0.11	23.094	30.714	0.5	M5-1
61	0	1	1	0	0	0	0.6	1000	0.11	23.094	30.714	0.5	M5-1
62	3	3	6	3	3	0	0.6	1000	0.11	23.094	30.714	0.5	M5-1
63	282150	283443	33020001	32736558	282213	63	0.6	1000	0.11	23.094	30.714	0.5	M5-1
64	0	0	0	0	0	0	0.6	1000	0.11	23.094	30.714	0.5	M5-1
66	145514	146922	23225520	23078598	145514	0	0.6	1000	0.11	23.094	30.714	0.5	M5-1
69	209386	210783	17877210	17666427	209421	35	0.6	1000	0.11	23.094	30.714	0.5	M5-1
72	196788	198785	11005086	10806301	196964	176	0.6	1000	0.11	23.094	30.714	0.5	M5-1
75	27104	27401	2809635	2782234	27108	4	0.6	1000	0.11	23.094	30.714	0.5	M5-1
76	0	0	0	0	0	0	0.6	1000	0.11	23.094	30.714	0.5	M5-1
78	57227	58159	2273778	2215619	57227	0	0.6	1000	0.11	23.094	30.714	0.5	M5-1
81	14821	14958	644680	629722	14821	0	0.6	1000	0.11	23.094	30.714	0.5	M5-1
84	29210	29526	328455	298929	29210	0	0.6	1000	0.11	23.094	30.714	0.5	M5-1
87	4182	4182	52650	48468	4185	3	0.6	1000	0.11	23.094	30.714	0.5	M5-1
90	2090	2090	18721	16631	2090	0	0.6	1000	0.11	23.094	30.714	0.5	M5-1
6	0	0	0	0	0	0	0.6	1000	0.13	23.473	36.504	0.5	M5-1
8	6	6	6	0	6	0	0.6	1000	0.13	23.473	36.504	0.5	M5-1
9	28	28	28	0	28	0	0.6	1000	0.13	23.473	36.504	0.5	M5-1
24	9286	9286	76636	67350	9430	144	0.6	1000	0.13	23.473	36.504	0.5	M5-1
27	9928	11312	53956	42644	9928	0	0.6	1000	0.13	23.473	36.504	0.5	M5-1
30	84740	84807	512578	427771	84741	1	0.6	1000	0.13	23.473	36.504	0.5	M5-1
33	16169	16399	1097421	1081022	16381	212	0.6	1000	0.13	23.473	36.504	0.5	M5-1
35	0	0	0	0	0	0	0.6	1000	0.13	23.473	36.504	0.5	M5-1
36	38392	38513	3324331	3285818	38422	30	0.6	1000	0.13	23.473	36.504	0.5	M5-1
37	0	0	0	0	0	0	0.6	1000	0.13	23.473	36.504	0.5	M5-1
39	75943	78081	8914753	8836672	76296	353	0.6	1000	0.13	23.473	36.504	0.5	M5-1
40	0	0	0	0	0	0	0.6	1000	0.13	23.473	36.504	0.5	M5-1
42	165925	168038	24440536	24272498	166040	115	0.6	1000	0.13	23.473	36.504	0.5	M5-1
45	181392	190901	46527481	46336580	181571	179	0.6	1000	0.13	23.473	36.504	0.5	M5-1
47	0	0	0	0	0	0	0.6	1000	0.13	23.473	36.504	0.5	M5-1
48	425262	430088	84142878	83712790	431289	6027	0.6	1000	0.13	23.473	36.504	0.5	M5-1
49	0	0	0	0	0	0	0.6	1000	0.13	23.473	36.504	0.5	M5-1
51	280272	283513	65259600	64976087	282047	1775	0.6	1000	0.13	23.473	36.504	0.5	M5-1
54	393712	394658	62826445	62431787	394063	351	0.6	1000	0.13	23.473	36.504	0.5	M5-1
55	1	1	1	0	1	0	0.6	1000	0.13	23.473	36.504	0.5	M5-1
57	400986	402140	60077241	59675101	401244	258	0.6	1000	0.13	23.473	36.504	0.5	M5-1
58	0	0	0	0	0	0	0.6	1000	0.13	23.473	36.504	0.5	M5-1
59	0	0	0	0	0	0	0.6	1000	0.13	23.473	36.504	0.5	M5-1
60	138715	141584	42878430	42736846	139023	308	0.6	1000	0.13	23.473	36.504	0.5	M5-1
61	0	1	1	0	0	0	0.6	1000	0.13	23.473	36.504	0.5	M5-1
62	3	3	6	3	3	0	0.6	1000	0.13	23.473	36.504	0.5	M5-1
63	283166	283443	33020001	32736558	283231	65	0.6	1000	0.13	23.473	36.504	0.5	M5-1
64	0	0	0	0	0	0	0.6	1000	0.13	23.473	36.504	0.5	M5-1
66	146261	146922	23225520	23078598	146265	4	0.6	1000	0.13	23.473	36.504	0.5	M5-1
69	209870	210783	17877210	17666427	209905	35	0.6	1000	0.13	23.473	36.504	0.5	M5-1
72	198372	198785	11005086	10806301	198557	185	0.6	1000	0.13	23.473	36.504	0.5	M5-1
75	27215	27401	2809635	2782234	27219	4	0.6	1000	0.13	23.473	36.504	0.5	M5-1
76	0	0	0	0	0	0	0.6	1000	0.13	23.473	36.504	0.5	M5-1
78	57953	58159	2273778	2215619	57953	0	0.6	1000	0.13	23.473	36.504	0.5	M5-1
81	14876	14958	644680	629722	14876	0	0.6	1000	0.13	23.473	36.504	0.5	M5-1
84	29235	29526	328455	298929	29235	0	0.6	1000	0.13	23.473	36.504	0.5	M5-1
87	4182	4182	52650	48468	4185	3	0.6	1000	0.13	23.473	36.504	0.5	M5-1
90	2090	2090	18721	16631	2090	0	0.6	1000	0.13	23.473	36.504	0.5	M5-1
6	0	0	0	0	0	0	0.6	1000	0.14	23.731	37.583	0.5	M5-1
8	6	6	6	0	6	0	0.6	1000	0.14	23.731	37.583	0.5	M5-1
9	28	28	28	0	28	0	0.6	1000	0.14	23.731	37.583	0.5	M5-1
24	9286	9286	76636	67350	9430	144	0.6	1000	0.14	23.731	37.583	0.5	M5-1
27	9928	11312	53956	42644	9928	0	0.6	1000	0.14	23.731	37.583	0.5	M5-1
30	84805	84807	512578	427771	84810	5	0.6	1000	0.14	23.731	37.583	0.5	M5-1
33	16169	16399	1097421	1081022	16381	212	0.6	1000	0.14	23.731	37.583	0.5	M5-1
35	0	0	0	0	0	0	0.6	1000	0.14	23.731	37.583	0.5	M5-1
36	38437	38513	3324331	3285818	38605	168	0.6	1000	0.14	23.731	37.583	0.5	M5-1
37	0	0	0	0	0	0	0.6	1000	0.14	23.731	37.583	0.5	M5-1
39	75943	78081	8914753	8836672	76296	353	0.6	1000	0.14	23.731	37.583	0.5	M5-1
40	0	0	0	0	0	0	0.6	1000	0.14	23.731	37.583	0.5	M5-1
42	165925	168038	24440536	24272498	166040	115	0.6	1000	0.14	23.731	37.583	0.5	M5-1
45	181508	190901	46527481	46336580	182065	557	0.6	1000	0.14	23.731	37.583	0.5	M5-1
47	0	0	0	0	0	0	0.6	1000	0.14	23.731	37.583	0.5	M5-1
48	425262	430088	84142878	83712790	431289	6027	0.6	1000	0.14	23.731	37.583	0.5	M5-1
49	0	0	0	0	0	0	0.6	1000	0.14	23.731	37.583	0.5	M5-1
51	280511	283513	65259600	64976087	284301	3790	0.6	1000	0.14	23.731	37.583	0.5	M5-1
54	393712	394658	62826445	62431787	394063	351	0.6	1000	0.14	23.731	37.583	0.5	M5-1
55	1	1	1	0	1	0	0.6	1000	0.14	23.731	37.583	0.5	M5-1
57	400986	402140	60077241	59675101	401244	258	0.6	1000	0.14	23.731	37.583	0.5	M5-1
58	0	0	0	0	0	0	0.6	1000	0.14	23.731	37.583	0.5	M5-1
59	0	0	0	0	0	0	0.6	1000	0.14	23.731	37.583	0.5	M5-1
60	139330	141584	42878430	42736846	139641	311	0.6	1000	0.14	23.731	37.583	0.5	M5-1
61	0	1	1	0	0	0	0.6	1000	0.14	23.731	37.583	0.5	M5-1
62	3	3	6	3	3	0	0.6	1000	0.14	23.731	37.583	0.5	M5-1
63	283166	283443	33020001	32736558	283231	65	0.6	1000	0.14	23.731	37.583	0.5	M5-1
64	0	0	0	0	0	0	0.6	1000	0.14	23.731	37.583	0.5	M5-1
66	146385	146922	23225520	23078598	146442	57	0.6	1000	0.14	23.731	37.583	0.5	M5-1
69	210023	210783	17877210	17666427	210087	64	0.6	1000	0.14	23.731	37.583	0.5	M5-1
72	198385	198785	11005086	10806301	198577	192	0.6	1000	0.14	23.731	37.583	0.5	M5-1
75	27255	27401	2809635	2782234	27272	17	0.6	1000	0.14	23.731	37.583	0.5	M5-1
76	0	0	0	0	0	0	0.6	1000	0.14	23.731	37.583	0.5	M5-1
78	57953	58159	2273778	2215619	57953	0	0.6	1000	0.14	23.731	37.583	0.5	M5-1
81	14908	14958	644680	629722	14908	0	0.6	1000	0.14	23.731	37.583	0.5	M5-1
84	29238	29526	328455	298929	29238	0	0.6	1000	0.14	23.731	37.583	0.5	M5-1
87	4182	4182	52650	48468	4185	3	0.6	1000	0.14	23.731	37.583	0.5	M5-1
90	2090	2090	18721	16631	2090	0	0.6	1000	0.14	23.731	37.583	0.5	M5-1
3	0	0	0	0	0	0	0.6	1000	0.1	24.213	31.337	0.5	M2-1
12	1	1	1	0	1	0	0.6	1000	0.1	24.213	31.337	0.5	M2-1
15	0	0	0	0	0	0	0.6	1000	0.1	24.213	31.337	0.5	M2-1
24	80	80	17391	17311	132	52	0.6	1000	0.1	24.213	31.337	0.5	M2-1
27	58	58	20706	20648	60	2	0.6	1000	0.1	24.213	31.337	0.5	M2-1
30	316	317	102831	102514	326	10	0.6	1000	0.1	24.213	31.337	0.5	M2-1
33	760	781	571915	571134	808	48	0.6	1000	0.1	24.213	31.337	0.5	M2-1
36	1457	1518	1530375	1528857	1489	32	0.6	1000	0.1	24.213	31.337	0.5	M2-1
39	13277	13402	4501500	4488098	13306	29	0.6	1000	0.1	24.213	31.337	0.5	M2-1
41	0	0	0	0	0	0	0.6	1000	0.1	24.213	31.337	0.5	M2-1
42	28450	28588	10010575	9981987	28550	100	0.6	1000	0.1	24.213	31.337	0.5	M2-1
43	0	0	1	1	0	0	0.6	1000	0.1	24.213	31.337	0.5	M2-1
45	14721	15621	16522626	16507005	14822	101	0.6	1000	0.1	24.213	31.337	0.5	M2-1
46	0	0	1	1	0	0	0.6	1000	0.1	24.213	31.337	0.5	M2-1
48	32065	32345	24398605	24366260	32135	70	0.6	1000	0.1	24.213	31.337	0.5	M2-1
51	13883	14167	23988201	23974034	13967	84	0.6	1000	0.1	24.213	31.337	0.5	M2-1
52	0	0	0	0	0	0	0.6	1000	0.1	24.213	31.337	0.5	M2-1
54	33846	34863	24217320	24182457	33911	65	0.6	1000	0.1	24.213	31.337	0.5	M2-1
55	0	0	0	0	0	0	0.6	1000	0.1	24.213	31.337	0.5	M2-1
57	28214	28771	23932821	23904050	28961	747	0.6	1000	0.1	24.213	31.337	0.5	M2-1
58	0	0	0	0	0	0	0.6	1000	0.1	24.213	31.337	0.5	M2-1
59	0	0	1	1	0	0	0.6	1000	0.1	24.213	31.337	0.5	M2-1
60	13802	14059	16869336	16855277	13842	40	0.6	1000	0.1	24.213	31.337	0.5	M2-1
61	0	0	0	0	0	0	0.6	1000	0.1	24.213	31.337	0.5	M2-1
62	0	0	0	0	0	0	0.6	1000	0.1	24.213	31.337	0.5	M2-1
63	19766	19873	11608971	11589098	19817	51	0.6	1000	0.1	24.213	31.337	0.5	M2-1
64	0	0	0	0	0	0	0.6	1000	0.1	24.213	31.337	0.5	M2-1
66	42477	42563	7755891	7713328	42482	5	0.6	1000	0.1	24.213	31.337	0.5	M2-1
68	0	0	0	0	0	0	0.6	1000	0.1	24.213	31.337	0.5	M2-1
69	2637	2772	4928230	4925458	2648	11	0.6	1000	0.1	24.213	31.337	0.5	M2-1
72	2693	2716	2248260	2245544	2700	7	0.6	1000	0.1	24.213	31.337	0.5	M2-1
73	0	0	1	1	0	0	0.6	1000	0.1	24.213	31.337	0.5	M2-1
75	166278	166303	2494261	2327958	166280	2	0.6	1000	0.1	24.213	31.337	0.5	M2-1
78	542	617	541320	540703	543	1	0.6	1000	0.1	24.213	31.337	0.5	M2-1
81	18070	18097	402753	384656	18070	0	0.6	1000	0.1	24.213	31.337	0.5	M2-1
84	295	296	95703	95407	295	0	0.6	1000	0.1	24.213	31.337	0.5	M2-1
87	82	102	20100	19998	82	0	0.6	1000	0.1	24.213	31.337	0.5	M2-1
90	2	2	9045	9043	2	0	0.6	1000	0.1	24.213	31.337	0.5	M2-1
6	0	0	0	0	0	0	0.6	1000	0.16	25.814	33.565	0.5	M5-1
8	6	6	6	0	6	0	0.6	1000	0.16	25.814	33.565	0.5	M5-1
9	28	28	28	0	28	0	0.6	1000	0.16	25.814	33.565	0.5	M5-1
24	9286	9286	76636	67350	9430	144	0.6	1000	0.16	25.814	33.565	0.5	M5-1
27	11312	11312	53956	42644	11312	0	0.6	1000	0.16	25.814	33.565	0.5	M5-1
30	84805	84807	512578	427771	84810	5	0.6	1000	0.16	25.814	33.565	0.5	M5-1
33	16170	16399	1097421	1081022	18661	2491	0.6	1000	0.16	25.814	33.565	0.5	M5-1
35	0	0	0	0	0	0	0.6	1000	0.16	25.814	33.565	0.5	M5-1
36	38437	38513	3324331	3285818	38605	168	0.6	1000	0.16	25.814	33.565	0.5	M5-1
37	0	0	0	0	0	0	0.6	1000	0.16	25.814	33.565	0.5	M5-1
39	76061	78081	8914753	8836672	76650	589	0.6	1000	0.16	25.814	33.565	0.5	M5-1
40	0	0	0	0	0	0	0.6	1000	0.16	25.814	33.565	0.5	M5-1
42	165945	168038	24440536	24272498	166191	246	0.6	1000	0.16	25.814	33.565	0.5	M5-1
45	181528	190901	46527481	46336580	182480	952	0.6	1000	0.16	25.814	33.565	0.5	M5-1
47	0	0	0	0	0	0	0.6	1000	0.16	25.814	33.565	0.5	M5-1
48	425356	430088	84142878	83712790	431700	6344	0.6	1000	0.16	25.814	33.565	0.5	M5-1
49	0	0	0	0	0	0	0.6	1000	0.16	25.814	33.565	0.5	M5-1
51	281691	283513	65259600	64976087	286778	5087	0.6	1000	0.16	25.814	33.565	0.5	M5-1
54	393831	394658	62826445	62431787	397420	3589	0.6	1000	0.16	25.814	33.565	0.5	M5-1
55	1	1	1	0	1	0	0.6	1000	0.16	25.814	33.565	0.5	M5-1
57	401356	402140	60077241	59675101	406085	4729	0.6	1000	0.16	25.814	33.565	0.5	M5-1
58	0	0	0	0	0	0	0.6	1000	0.16	25.814	33.565	0.5	M5-1
59	0	0	0	0	0	0	0.6	1000	0.16	25.814	33.565	0.5	M5-1
60	139886	141584	42878430	42736846	140358	472	0.6	1000	0.16	25.814	33.565	0.5	M5-1
61	0	1	1	0	0	0	0.6	1000	0.16	25.814	33.565	0.5	M5-1
62	3	3	6	3	3	0	0.6	1000	0.16	25.814	33.565	0.5	M5-1
63	283305	283443	33020001	32736558	283611	306	0.6	1000	0.16	25.814	33.565	0.5	M5-1
64	0	0	0	0	0	0	0.6	1000	0.16	25.814	33.565	0.5	M5-1
66	146414	146922	23225520	23078598	146481	67	0.6	1000	0.16	25.814	33.565	0.5	M5-1
69	210081	210783	17877210	17666427	210149	68	0.6	1000	0.16	25.814	33.565	0.5	M5-1
72	198406	198785	11005086	10806301	202152	3746	0.6	1000	0.16	25.814	33.565	0.5	M5-1
75	27371	27401	2809635	2782234	27445	74	0.6	1000	0.16	25.814	33.565	0.5	M5-1
76	0	0	0	0	0	0	0.6	1000	0.16	25.814	33.565	0.5	M5-1
78	58026	58159	2273778	2215619	58041	15	0.6	1000	0.16	25.814	33.565	0.5	M5-1
81	14958	14958	644680	629722	14958	0	0.6	1000	0.16	25.814	33.565	0.5	M5-1
84	29526	29526	328455	298929	29526	0	0.6	1000	0.16	25.814	33.565	0.5	M5-1
87	4182	4182	52650	48468	4185	3	0.6	1000	0.16	25.814	33.565	0.5	M5-1
90	2090	2090	18721	16631	2090	0	0.6	1000	0.16	25.814	33.565	0.5	M5-1
3	0	0	0	0	0	0	0.6	1000	0.19	25.94	30.348	0.5	M2-1
12	1	1	1	0	1	0	0.6	1000	0.19	25.94	30.348	0.5	M2-1
15	0	0	0	0	0	0	0.6	1000	0.19	25.94	30.348	0.5	M2-1
24	80	80	17391	17311	331	251	0.6	1000	0.19	25.94	30.348	0.5	M2-1
27	58	58	20706	20648	299	241	0.6	1000	0.19	25.94	30.348	0.5	M2-1
30	317	317	102831	102514	1107	790	0.6	1000	0.19	25.94	30.348	0.5	M2-1
33	781	781	571915	571134	7481	6700	0.6	1000	0.19	25.94	30.348	0.5	M2-1
36	1469	1518	1530375	1528857	2334	865	0.6	1000	0.19	25.94	30.348	0.5	M2-1
39	13345	13402	4501500	4488098	15155	1810	0.6	1000	0.19	25.94	30.348	0.5	M2-1
41	0	0	0	0	0	0	0.6	1000	0.19	25.94	30.348	0.5	M2-1
42	28497	28588	10010575	9981987	29828	1331	0.6	1000	0.19	25.94	30.348	0.5	M2-1
43	0	0	1	1	0	0	0.6	1000	0.19	25.94	30.348	0.5	M2-1
45	14893	15621	16522626	16507005	17765	2872	0.6	1000	0.19	25.94	30.348	0.5	M2-1
46	0	0	1	1	0	0	0.6	1000	0.19	25.94	30.348	0.5	M2-1
48	32291	32345	24398605	24366260	42790	10499	0.6	1000	0.19	25.94	30.348	0.5	M2-1
51	14071	14167	23988201	23974034	19682	5611	0.6	1000	0.19	25.94	30.348	0.5	M2-1
52	0	0	0	0	0	0	0.6	1000	0.19	25.94	30.348	0.5	M2-1
54	34188	34863	24217320	24182457	44673	10485	0.6	1000	0.19	25.94	30.348	0.5	M2-1
55	0	0	0	0	0	0	0.6	1000	0.19	25.94	30.348	0.5	M2-1
57	28479	28771	23932821	23904050	36267	7788	0.6	1000	0.19	25.94	30.348	0.5	M2-1
58	0	0	0	0	0	0	0.6	1000	0.19	25.94	30.348	0.5	M2-1
59	0	0	1	1	0	0	0.6	1000	0.19	25.94	30.348	0.5	M2-1
60	13985	14059	16869336	16855277	16750	2765	0.6	1000	0.19	25.94	30.348	0.5	M2-1
61	0	0	0	0	0	0	0.6	1000	0.19	25.94	30.348	0.5	M2-1
62	0	0	0	0	0	0	0.6	1000	0.19	25.94	30.348	0.5	M2-1
63	19862	19873	11608971	11589098	20672	810	0.6	1000	0.19	25.94	30.348	0.5	M2-1
64	0	0	0	0	0	0	0.6	1000	0.19	25.94	30.348	0.5	M2-1
66	42546	42563	7755891	7713328	43686	1140	0.6	1000	0.19	25.94	30.348	0.5	M2-1
68	0	0	0	0	0	0	0.6	1000	0.19	25.94	30.348	0.5	M2-1
69	2743	2772	4928230	4925458	3494	751	0.6	1000	0.19	25.94	30.348	0.5	M2-1
72	2709	2716	2248260	2245544	2858	149	0.6	1000	0.19	25.94	30.348	0.5	M2-1
73	0	0	1	1	0	0	0.6	1000	0.19	25.94	30.348	0.5	M2-1
75	166293	166303	2494261	2327958	166414	121	0.6	1000	0.19	25.94	30.348	0.5	M2-1
78	617	617	541320	540703	876	259	0.6	1000	0.19	25.94	30.348	0.5	M2-1
81	18097	18097	402753	384656	18123	26	0.6	1000	0.19	25.94	30.348	0.5	M2-1
84	295	296	95703	95407	297	2	0.6	1000	0.19	25.94	30.348	0.5	M2-1
87	102	102	20100	19998	107	5	0.6	1000	0.19	25.94	30.348	0.5	M2-1
90	2	2	9045	9043	2	0	0.6	1000	0.19	25.94	30.348	0.5	M2-1
6	0	0	0	0	0	0	0.6	1000	0.15	26.879	33.88	0.5	M5-1
8	6	6	6	0	6	0	0.6	1000	0.15	26.879	33.88	0.5	M5-1
9	28	28	28	0	28	0	0.6	1000	0.15	26.879	33.88	0.5	M5-1
24	9286	9286	76636	67350	9430	144	0.6	1000	0.15	26.879	33.88	0.5	M5-1
27	11312	11312	53956	42644	11312	0	0.6	1000	0.15	26.879	33.88	0.5	M5-1
30	84805	84807	512578	427771	84810	5	0.6	1000	0.15	26.879	33.88	0.5	M5-1
33	16169	16399	1097421	1081022	16381	212	0.6	1000	0.15	26.879	33.88	0.5	M5-1
35	0	0	0	0	0	0	0.6	1000	0.15	26.879	33.88	0.5	M5-1
36	38437	38513	3324331	3285818	38605	168	0.6	1000	0.15	26.879	33.88	0.5	M5-1
37	0	0	0	0	0	0	0.6	1000	0.15	26.879	33.88	0.5	M5-1
39	75943	78081	8914753	8836672	76296	353	0.6	1000	0.15	26.879	33.88	0.5	M5-1
40	0	0	0	0	0	0	0.6	1000	0.15	26.879	33.88	0.5	M5-1
42	165945	168038	24440536	24272498	166191	246	0.6	1000	0.15	26.879	33.88	0.5	M5-1
45	181508	190901	46527481	46336580	182065	557	0.6	1000	0.15	26.879	33.88	0.5	M5-1
47	0	0	0	0	0	0	0.6	1000	0.15	26.879	33.88	0.5	M5-1
48	425356	430088	84142878	83712790	431700	6344	0.6	1000	0.15	26.879	33.88	0.5	M5-1
49	0	0	0	0	0	0	0.6	1000	0.15	26.879	33.88	0.5	M5-1
51	280511	283513	65259600	64976087	284301	3790	0.6	1000	0.15	26.879	33.88	0.5	M5-1
54	393831	394658	62826445	62431787	397420	3589	0.6	1000	0.15	26.879	33.88	0.5	M5-1
55	1	1	1	0	1	0	0.6	1000	0.15	26.879	33.88	0.5	M5-1
57	401214	402140	60077241	59675101	401910	696	0.6	1000	0.15	26.879	33.88	0.5	M5-1
58	0	0	0	0	0	0	0.6	1000	0.15	26.879	33.88	0.5	M5-1
59	0	0	0	0	0	0	0.6	1000	0.15	26.879	33.88	0.5	M5-1
60	139886	141584	42878430	42736846	140358	472	0.6	1000	0.15	26.879	33.88	0.5	M5-1
61	0	1	1	0	0	0	0.6	1000	0.15	26.879	33.88	0.5	M5-1
62	3	3	6	3	3	0	0.6	1000	0.15	26.879	33.88	0.5	M5-1
63	283220	283443	33020001	32736558	283336	116	0.6	1000	0.15	26.879	33.88	0.5	M5-1
64	0	0	0	0	0	0	0.6	1000	0.15	26.879	33.88	0.5	M5-1
66	146385	146922	23225520	23078598	146442	57	0.6	1000	0.15	26.879	33.88	0.5	M5-1
69	210081	210783	17877210	17666427	210149	68	0.6	1000	0.15	26.879	33.88	0.5	M5-1
72	198385	198785	11005086	10806301	198577	192	0.6	1000	0.15	26.879	33.88	0.5	M5-1
75	27371	27401	2809635	2782234	27388	17	0.6	1000	0.15	26.879	33.88	0.5	M5-1
76	0	0	0	0	0	0	0.6	1000	0.15	26.879	33.88	0.5	M5-1
78	57968	58159	2273778	2215619	57983	15	0.6	1000	0.15	26.879	33.88	0.5	M5-1
81	14958	14958	644680	629722	14958	0	0.6	1000	0.15	26.879	33.88	0.5	M5-1
84	29454	29526	328455	298929	29454	0	0.6	1000	0.15	26.879	33.88	0.5	M5-1
87	4182	4182	52650	48468	4185	3	0.6	1000	0.15	26.879	33.88	0.5	M5-1
90	2090	2090	18721	16631	2090	0	0.6	1000	0.15	26.879	33.88	0.5	M5-1
6	0	0	0	0	0	0	0.6	1000	0.2	27.346	40.174	0.5	M5-1
8	6	6	6	0	6	0	0.6	1000	0.2	27.346	40.174	0.5	M5-1
9	28	28	28	0	28	0	0.6	1000	0.2	27.346	40.174	0.5	M5-1
24	9286	9286	76636	67350	10135	849	0.6	1000	0.2	27.346	40.174	0.5	M5-1
27	11312	11312	53956	42644	11562	250	0.6	1000	0.2	27.346	40.174	0.5	M5-1
30	84806	84807	512578	427771	86429	1623	0.6	1000	0.2	27.346	40.174	0.5	M5-1
33	16350	16399	1097421	1081022	25649	9299	0.6	1000	0.2	27.346	40.174	0.5	M5-1
35	0	0	0	0	0	0	0.6	1000	0.2	27.346	40.174	0.5	M5-1
36	38440	38513	3324331	3285818	42912	4472	0.6	1000	0.2	27.346	40.174	0.5	M5-1
37	0	0	0	0	0	0	0.6	1000	0.2	27.346	40.174	0.5	M5-1
39	76071	78081	8914753	8836672	77265	1194	0.6	1000	0.2	27.346	40.174	0.5	M5-1
40	0	0	0	0	0	0	0.6	1000	0.2	27.346	40.174	0.5	M5-1
42	165957	168038	24440536	24272498	168012	2055	0.6	1000	0.2	27.346	40.174	0.5	M5-1
45	181651	190901	46527481	46336580	189012	7361	0.6	1000	0.2	27.346	40.174	0.5	M5-1
47	0	0	0	0	0	0	0.6	1000	0.2	27.346	40.174	0.5	M5-1
48	426757	430088	84142878	83712790	441719	14962	0.6	1000	0.2	27.346	40.174	0.5	M5-1
49	0	0	0	0	0	0	0.6	1000	0.2	27.346	40.174	0.5	M5-1
51	282585	283513	65259600	64976087	310226	27641	0.6	1000	0.2	27.346	40.174	0.5	M5-1
54	394025	394658	62826445	62431787	411478	17453	0.6	1000	0.2	27.346	40.174	0.5	M5-1
55	1	1	1	0	1	0	0.6	1000	0.2	27.346	40.174	0.5	M5-1
57	401375	402140	60077241	59675101	427986	26611	0.6	1000	0.2	27.346	40.174	0.5	M5-1
58	0	0	0	0	0	0	0.6	1000	0.2	27.346	40.174	0.5	M5-1
59	0	0	0	0	0	0	0.6	1000	0.2	27.346	40.174	0.5	M5-1
60	140005	141584	42878430	42736846	157579	17574	0.6	1000	0.2	27.346	40.174	0.5	M5-1
61	1	1	1	0	1	0	0.6	1000	0.2	27.346	40.174	0.5	M5-1
62	3	3	6	3	3	0	0.6	1000	0.2	27.346	40.174	0.5	M5-1
63	283339	283443	33020001	32736558	285442	2103	0.6	1000	0.2	27.346	40.174	0.5	M5-1
64	0	0	0	0	0	0	0.6	1000	0.2	27.346	40.174	0.5	M5-1
66	146438	146922	23225520	23078598	147539	1101	0.6	1000	0.2	27.346	40.174	0.5	M5-1
69	210092	210783	17877210	17666427	210293	201	0.6	1000	0.2	27.346	40.174	0.5	M5-1
72	198406	198785	11005086	10806301	202395	3989	0.6	1000	0.2	27.346	40.174	0.5	M5-1
75	27376	27401	2809635	2782234	27623	247	0.6	1000	0.2	27.346	40.174	0.5	M5-1
76	0	0	0	0	0	0	0.6	1000	0.2	27.346	40.174	0.5	M5-1
78	58082	58159	2273778	2215619	58157	75	0.6	1000	0.2	27.346	40.174	0.5	M5-1
81	14958	14958	644680	629722	15016	58	0.6	1000	0.2	27.346	40.174	0.5	M5-1
84	29526	29526	328455	298929	29526	0	0.6	1000	0.2	27.346	40.174	0.5	M5-1
87	4182	4182	52650	48468	4189	7	0.6	1000	0.2	27.346	40.174	0.5	M5-1
90	2090	2090	18721	16631	2090	0	0.6	1000	0.2	27.346	40.174	0.5	M5-1
3	0	0	0	0	0	0	0.6	1000	0.18	27.509	35.815	0.5	M2-1
12	1	1	1	0	1	0	0.6	1000	0.18	27.509	35.815	0.5	M2-1
15	0	0	0	0	0	0	0.6	1000	0.18	27.509	35.815	0.5	M2-1
24	80	80	17391	17311	331	251	0.6	1000	0.18	27.509	35.815	0.5	M2-1
27	58	58	20706	20648	137	79	0.6	1000	0.18	27.509	35.815	0.5	M2-1
30	317	317	102831	102514	1107	790	0.6	1000	0.18	27.509	35.815	0.5	M2-1
33	781	781	571915	571134	2125	1344	0.6	1000	0.18	27.509	35.815	0.5	M2-1
36	1469	1518	1530375	1528857	2334	865	0.6	1000	0.18	27.509	35.815	0.5	M2-1
39	13345	13402	4501500	4488098	15155	1810	0.6	1000	0.18	27.509	35.815	0.5	M2-1
41	0	0	0	0	0	0	0.6	1000	0.18	27.509	35.815	0.5	M2-1
42	28497	28588	10010575	9981987	29828	1331	0.6	1000	0.18	27.509	35.815	0.5	M2-1
43	0	0	1	1	0	0	0.6	1000	0.18	27.509	35.815	0.5	M2-1
45	14893	15621	16522626	16507005	17765	2872	0.6	1000	0.18	27.509	35.815	0.5	M2-1
46	0	0	1	1	0	0	0.6	1000	0.18	27.509	35.815	0.5	M2-1
48	32290	32345	24398605	24366260	35982	3692	0.6	1000	0.18	27.509	35.815	0.5	M2-1
51	14071	14167	23988201	23974034	19682	5611	0.6	1000	0.18	27.509	35.815	0.5	M2-1
52	0	0	0	0	0	0	0.6	1000	0.18	27.509	35.815	0.5	M2-1
54	34188	34863	24217320	24182457	41165	6977	0.6	1000	0.18	27.509	35.815	0.5	M2-1
55	0	0	0	0	0	0	0.6	1000	0.18	27.509	35.815	0.5	M2-1
57	28479	28771	23932821	23904050	36267	7788	0.6	1000	0.18	27.509	35.815	0.5	M2-1
58	0	0	0	0	0	0	0.6	1000	0.18	27.509	35.815	0.5	M2-1
59	0	0	1	1	0	0	0.6	1000	0.18	27.509	35.815	0.5	M2-1
60	13957	14059	16869336	16855277	15327	1370	0.6	1000	0.18	27.509	35.815	0.5	M2-1
61	0	0	0	0	0	0	0.6	1000	0.18	27.509	35.815	0.5	M2-1
62	0	0	0	0	0	0	0.6	1000	0.18	27.509	35.815	0.5	M2-1
63	19862	19873	11608971	11589098	20672	810	0.6	1000	0.18	27.509	35.815	0.5	M2-1
64	0	0	0	0	0	0	0.6	1000	0.18	27.509	35.815	0.5	M2-1
66	42546	42563	7755891	7713328	42965	419	0.6	1000	0.18	27.509	35.815	0.5	M2-1
68	0	0	0	0	0	0	0.6	1000	0.18	27.509	35.815	0.5	M2-1
69	2743	2772	4928230	4925458	3041	298	0.6	1000	0.18	27.509	35.815	0.5	M2-1
72	2709	2716	2248260	2245544	2836	127	0.6	1000	0.18	27.509	35.815	0.5	M2-1
73	0	0	1	1	0	0	0.6	1000	0.18	27.509	35.815	0.5	M2-1
75	166293	166303	2494261	2327958	166396	103	0.6	1000	0.18	27.509	35.815	0.5	M2-1
78	617	617	541320	540703	876	259	0.6	1000	0.18	27.509	35.815	0.5	M2-1
81	18097	18097	402753	384656	18121	24	0.6	1000	0.18	27.509	35.815	0.5	M2-1
84	295	296	95703	95407	297	2	0.6	1000	0.18	27.509	35.815	0.5	M2-1
87	102	102	20100	19998	102	0	0.6	1000	0.18	27.509	35.815	0.5	M2-1
90	2	2	9045	9043	2	0	0.6	1000	0.18	27.509	35.815	0.5	M2-1
6	0	0	0	0	0	0	0.6	1000	0.19	27.75	30.875	0.5	M5-1
8	6	6	6	0	6	0	0.6	1000	0.19	27.75	30.875	0.5	M5-1
9	28	28	28	0	28	0	0.6	1000	0.19	27.75	30.875	0.5	M5-1
24	9286	9286	76636	67350	10135	849	0.6	1000	0.19	27.75	30.875	0.5	M5-1
27	11312	11312	53956	42644	11562	250	0.6	1000	0.19	27.75	30.875	0.5	M5-1
30	84806	84807	512578	427771	84846	40	0.6	1000	0.19	27.75	30.875	0.5	M5-1
33	16350	16399	1097421	1081022	25649	9299	0.6	1000	0.19	27.75	30.875	0.5	M5-1
35	0	0	0	0	0	0	0.6	1000	0.19	27.75	30.875	0.5	M5-1
36	38440	38513	3324331	3285818	39371	931	0.6	1000	0.19	27.75	30.875	0.5	M5-1
37	0	0	0	0	0	0	0.6	1000	0.19	27.75	30.875	0.5	M5-1
39	76071	78081	8914753	8836672	77265	1194	0.6	1000	0.19	27.75	30.875	0.5	M5-1
40	0	0	0	0	0	0	0.6	1000	0.19	27.75	30.875	0.5	M5-1
42	165956	168038	24440536	24272498	166437	481	0.6	1000	0.19	27.75	30.875	0.5	M5-1
45	181647	190901	46527481	46336580	185836	4189	0.6	1000	0.19	27.75	30.875	0.5	M5-1
47	0	0	0	0	0	0	0.6	1000	0.19	27.75	30.875	0.5	M5-1
48	426757	430088	84142878	83712790	441719	14962	0.6	1000	0.19	27.75	30.875	0.5	M5-1
49	0	0	0	0	0	0	0.6	1000	0.19	27.75	30.875	0.5	M5-1
51	282575	283513	65259600	64976087	293812	11237	0.6	1000	0.19	27.75	30.875	0.5	M5-1
54	394025	394658	62826445	62431787	411478	17453	0.6	1000	0.19	27.75	30.875	0.5	M5-1
55	1	1	1	0	1	0	0.6	1000	0.19	27.75	30.875	0.5	M5-1
57	401375	402140	60077241	59675101	417906	16531	0.6	1000	0.19	27.75	30.875	0.5	M5-1
58	0	0	0	0	0	0	0.6	1000	0.19	27.75	30.875	0.5	M5-1
59	0	0	0	0	0	0	0.6	1000	0.19	27.75	30.875	0.5	M5-1
60	140005	141584	42878430	42736846	149631	9626	0.6	1000	0.19	27.75	30.875	0.5	M5-1
61	1	1	1	0	1	0	0.6	1000	0.19	27.75	30.875	0.5	M5-1
62	3	3	6	3	3	0	0.6	1000	0.19	27.75	30.875	0.5	M5-1
63	283327	283443	33020001	32736558	284675	1348	0.6	1000	0.19	27.75	30.875	0.5	M5-1
64	0	0	0	0	0	0	0.6	1000	0.19	27.75	30.875	0.5	M5-1
66	146438	146922	23225520	23078598	146793	355	0.6	1000	0.19	27.75	30.875	0.5	M5-1
69	210092	210783	17877210	17666427	210293	201	0.6	1000	0.19	27.75	30.875	0.5	M5-1
72	198406	198785	11005086	10806301	202316	3910	0.6	1000	0.19	27.75	30.875	0.5	M5-1
75	27376	27401	2809635	2782234	27510	134	0.6	1000	0.19	27.75	30.875	0.5	M5-1
76	0	0	0	0	0	0	0.6	1000	0.19	27.75	30.875	0.5	M5-1
78	58026	58159	2273778	2215619	58081	55	0.6	1000	0.19	27.75	30.875	0.5	M5-1
81	14958	14958	644680	629722	14958	0	0.6	1000	0.19	27.75	30.875	0.5	M5-1
84	29526	29526	328455	298929	29526	0	0.6	1000	0.19	27.75	30.875	0.5	M5-1
87	4182	4182	52650	48468	4189	7	0.6	1000	0.19	27.75	30.875	0.5	M5-1
90	2090	2090	18721	16631	2090	0	0.6	1000	0.19	27.75	30.875	0.5	M5-1
6	0	0	0	0	0	0	0.6	1000	0.18	31.64	42.21	0.5	M5-1
8	6	6	6	0	6	0	0.6	1000	0.18	31.64	42.21	0.5	M5-1
9	28	28	28	0	28	0	0.6	1000	0.18	31.64	42.21	0.5	M5-1
24	9286	9286	76636	67350	10135	849	0.6	1000	0.18	31.64	42.21	0.5	M5-1
27	11312	11312	53956	42644	11312	0	0.6	1000	0.18	31.64	42.21	0.5	M5-1
30	84806	84807	512578	427771	84846	40	0.6	1000	0.18	31.64	42.21	0.5	M5-1
33	16170	16399	1097421	1081022	18661	2491	0.6	1000	0.18	31.64	42.21	0.5	M5-1
35	0	0	0	0	0	0	0.6	1000	0.18	31.64	42.21	0.5	M5-1
36	38440	38513	3324331	3285818	39371	931	0.6	1000	0.18	31.64	42.21	0.5	M5-1
37	0	0	0	0	0	0	0.6	1000	0.18	31.64	42.21	0.5	M5-1
39	76071	78081	8914753	8836672	77265	1194	0.6	1000	0.18	31.64	42.21	0.5	M5-1
40	0	0	0	0	0	0	0.6	1000	0.18	31.64	42.21	0.5	M5-1
42	165956	168038	24440536	24272498	166437	481	0.6	1000	0.18	31.64	42.21	0.5	M5-1
45	181647	190901	46527481	46336580	185836	4189	0.6	1000	0.18	31.64	42.21	0.5	M5-1
47	0	0	0	0	0	0	0.6	1000	0.18	31.64	42.21	0.5	M5-1
48	425402	430088	84142878	83712790	432706	7304	0.6	1000	0.18	31.64	42.21	0.5	M5-1
49	0	0	0	0	0	0	0.6	1000	0.18	31.64	42.21	0.5	M5-1
51	282575	283513	65259600	64976087	293812	11237	0.6	1000	0.18	31.64	42.21	0.5	M5-1
54	394003	394658	62826445	62431787	406079	12076	0.6	1000	0.18	31.64	42.21	0.5	M5-1
55	1	1	1	0	1	0	0.6	1000	0.18	31.64	42.21	0.5	M5-1
57	401375	402140	60077241	59675101	417906	16531	0.6	1000	0.18	31.64	42.21	0.5	M5-1
58	0	0	0	0	0	0	0.6	1000	0.18	31.64	42.21	0.5	M5-1
59	0	0	0	0	0	0	0.6	1000	0.18	31.64	42.21	0.5	M5-1
60	140003	141584	42878430	42736846	142437	2434	0.6	1000	0.18	31.64	42.21	0.5	M5-1
61	1	1	1	0	1	0	0.6	1000	0.18	31.64	42.21	0.5	M5-1
62	3	3	6	3	3	0	0.6	1000	0.18	31.64	42.21	0.5	M5-1
63	283327	283443	33020001	32736558	284675	1348	0.6	1000	0.18	31.64	42.21	0.5	M5-1
64	0	0	0	0	0	0	0.6	1000	0.18	31.64	42.21	0.5	M5-1
66	146431	146922	23225520	23078598	146565	134	0.6	1000	0.18	31.64	42.21	0.5	M5-1
69	210091	210783	17877210	17666427	210179	88	0.6	1000	0.18	31.64	42.21	0.5	M5-1
72	198406	198785	11005086	10806301	202200	3794	0.6	1000	0.18	31.64	42.21	0.5	M5-1
75	27376	27401	2809635	2782234	27464	88	0.6	1000	0.18	31.64	42.21	0.5	M5-1
76	0	0	0	0	0	0	0.6	1000	0.18	31.64	42.21	0.5	M5-1
78	58026	58159	2273778	2215619	58081	55	0.6	1000	0.18	31.64	42.21	0.5	M5-1
81	14958	14958	644680	629722	14958	0	0.6	1000	0.18	31.64	42.21	0.5	M5-1
84	29526	29526	328455	298929	29526	0	0.6	1000	0.18	31.64	42.21	0.5	M5-1
87	4182	4182	52650	48468	4189	7	0.6	1000	0.18	31.64	42.21	0.5	M5-1
90	2090	2090	18721	16631	2090	0	0.6	1000	0.18	31.64	42.21	0.5	M5-1
6	0	0	0	0	0	0	0.6	1000	0.17	33.327	44.156	0.5	M5-1
8	6	6	6	0	6	0	0.6	1000	0.17	33.327	44.156	0.5	M5-1
9	28	28	28	0	28	0	0.6	1000	0.17	33.327	44.156	0.5	M5-1
24	9286	9286	76636	67350	10135	849	0.6	1000	0.17	33.327	44.156	0.5	M5-1
27	11312	11312	53956	42644	11312	0	0.6	1000	0.17	33.327	44.156	0.5	M5-1
30	84806	84807	512578	427771	84846	40	0.6	1000	0.17	33.327	44.156	0.5	M5-1
33	16170	16399	1097421	1081022	18661	2491	0.6	1000	0.17	33.327	44.156	0.5	M5-1
35	0	0	0	0	0	0	0.6	1000	0.17	33.327	44.156	0.5	M5-1
36	38440	38513	3324331	3285818	39371	931	0.6	1000	0.17	33.327	44.156	0.5	M5-1
37	0	0	0	0	0	0	0.6	1000	0.17	33.327	44.156	0.5	M5-1
39	76061	78081	8914753	8836672	76650	589	0.6	1000	0.17	33.327	44.156	0.5	M5-1
40	0	0	0	0	0	0	0.6	1000	0.17	33.327	44.156	0.5	M5-1
42	165956	168038	24440536	24272498	166437	481	0.6	1000	0.17	33.327	44.156	0.5	M5-1
45	181528	190901	46527481	46336580	182480	952	0.6	1000	0.17	33.327	44.156	0.5	M5-1
47	0	0	0	0	0	0	0.6	1000	0.17	33.327	44.156	0.5	M5-1
48	425402	430088	84142878	83712790	432706	7304	0.6	1000	0.17	33.327	44.156	0.5	M5-1
49	0	0	0	0	0	0	0.6	1000	0.17	33.327	44.156	0.5	M5-1
51	281691	283513	65259600	64976087	286778	5087	0.6	1000	0.17	33.327	44.156	0.5	M5-1
54	394003	394658	62826445	62431787	406079	12076	0.6	1000	0.17	33.327	44.156	0.5	M5-1
55	1	1	1	0	1	0	0.6	1000	0.17	33.327	44.156	0.5	M5-1
57	401356	402140	60077241	59675101	406085	4729	0.6	1000	0.17	33.327	44.156	0.5	M5-1
58	0	0	0	0	0	0	0.6	1000	0.17	33.327	44.156	0.5	M5-1
59	0	0	0	0	0	0	0.6	1000	0.17	33.327	44.156	0.5	M5-1
60	140003	141584	42878430	42736846	142437	2434	0.6	1000	0.17	33.327	44.156	0.5	M5-1
61	1	1	1	0	1	0	0.6	1000	0.17	33.327	44.156	0.5	M5-1
62	3	3	6	3	3	0	0.6	1000	0.17	33.327	44.156	0.5	M5-1
63	283305	283443	33020001	32736558	283611	306	0.6	1000	0.17	33.327	44.156	0.5	M5-1
64	0	0	0	0	0	0	0.6	1000	0.17	33.327	44.156	0.5	M5-1
66	146431	146922	23225520	23078598	146565	134	0.6	1000	0.17	33.327	44.156	0.5	M5-1
69	210081	210783	17877210	17666427	210149	68	0.6	1000	0.17	33.327	44.156	0.5	M5-1
72	198406	198785	11005086	10806301	202200	3794	0.6	1000	0.17	33.327	44.156	0.5	M5-1
75	27371	27401	2809635	2782234	27445	74	0.6	1000	0.17	33.327	44.156	0.5	M5-1
76	0	0	0	0	0	0	0.6	1000	0.17	33.327	44.156	0.5	M5-1
78	58026	58159	2273778	2215619	58076	50	0.6	1000	0.17	33.327	44.156	0.5	M5-1
81	14958	14958	644680	629722	14958	0	0.6	1000	0.17	33.327	44.156	0.5	M5-1
84	29526	29526	328455	298929	29526	0	0.6	1000	0.17	33.327	44.156	0.5	M5-1
87	4182	4182	52650	48468	4189	7	0.6	1000	0.17	33.327	44.156	0.5	M5-1
90	2090	2090	18721	16631	2090	0	0.6	1000	0.17	33.327	44.156	0.5	M5-1
12	0	0	0	0	0	0	0.6	1000	0.2	6.21	15.073	0.5	M3-1
24	19	19	528	509	30	11	0.6	1000	0.2	6.21	15.073	0.5	M3-1
27	1012	1012	3403	2391	1012	0	0.6	1000	0.2	6.21	15.073	0.5	M3-1
30	2244	2244	20706	18462	2316	72	0.6	1000	0.2	6.21	15.073	0.5	M3-1
33	14843	14843	188191	173348	14929	86	0.6	1000	0.2	6.21	15.073	0.5	M3-1
36	7242680	7242680	9894576	2651896	7243064	384	0.6	1000	0.2	6.21	15.073	0.5	M3-1
39	263445	263445	2729616	2466171	265509	2064	0.6	1000	0.2	6.21	15.073	0.5	M3-1
42	35787	35878	2158003	2122125	36210	423	0.6	1000	0.2	6.21	15.073	0.5	M3-1
45	53514	56285	3736011	3679726	53628	114	0.6	1000	0.2	6.21	15.073	0.5	M3-1
48	727791	728177	10776403	10048226	727891	100	0.6	1000	0.2	6.21	15.073	0.5	M3-1
51	440008	443478	10131751	9688273	440404	396	0.6	1000	0.2	6.21	15.073	0.5	M3-1
54	102045	102378	5519503	5417125	102249	204	0.6	1000	0.2	6.21	15.073	0.5	M3-1
57	99578	99788	4837605	4737817	102301	2723	0.6	1000	0.2	6.21	15.073	0.5	M3-1
59	0	0	0	0	0	0	0.6	1000	0.2	6.21	15.073	0.5	M3-1
60	221008	221616	3573801	3352185	222624	1616	0.6	1000	0.2	6.21	15.073	0.5	M3-1
62	0	0	0	0	0	0	0.6	1000	0.2	6.21	15.073	0.5	M3-1
63	575589	576491	9748320	9171829	575597	8	0.6	1000	0.2	6.21	15.073	0.5	M3-1
64	0	0	0	0	0	0	0.6	1000	0.2	6.21	15.073	0.5	M3-1
66	293126	293128	2492028	2198900	293195	69	0.6	1000	0.2	6.21	15.073	0.5	M3-1
68	10	10	15	5	10	0	0.6	1000	0.2	6.21	15.073	0.5	M3-1
69	359718	359725	4045590	3685865	359731	13	0.6	1000	0.2	6.21	15.073	0.5	M3-1
72	75013	75317	1553203	1477886	75013	0	0.6	1000	0.2	6.21	15.073	0.5	M3-1
75	18352	18352	328455	310103	18354	2	0.6	1000	0.2	6.21	15.073	0.5	M3-1
76	0	0	0	0	0	0	0.6	1000	0.2	6.21	15.073	0.5	M3-1
78	132572	132572	773146	640574	132586	14	0.6	1000	0.2	6.21	15.073	0.5	M3-1
81	5138	5138	36585	31447	5138	0	0.6	1000	0.2	6.21	15.073	0.5	M3-1
84	623	623	9730	9107	623	0	0.6	1000	0.2	6.21	15.073	0.5	M3-1
87	478	478	6670	6192	478	0	0.6	1000	0.2	6.21	15.073	0.5	M3-1
90	305	305	2278	1973	305	0	0.6	1000	0.2	6.21	15.073	0.5	M3-1
12	0	0	0	0	0	0	0.6	1000	0.12	6.917	15.102	0.5	M3-1
24	19	19	528	509	20	1	0.6	1000	0.12	6.917	15.102	0.5	M3-1
27	1012	1012	3403	2391	1012	0	0.6	1000	0.12	6.917	15.102	0.5	M3-1
30	2244	2244	20706	18462	2266	22	0.6	1000	0.12	6.917	15.102	0.5	M3-1
33	14453	14843	188191	173348	14453	0	0.6	1000	0.12	6.917	15.102	0.5	M3-1
36	7238877	7242680	9894576	2651896	7238881	4	0.6	1000	0.12	6.917	15.102	0.5	M3-1
39	263400	263445	2729616	2466171	263400	0	0.6	1000	0.12	6.917	15.102	0.5	M3-1
42	35711	35878	2158003	2122125	35836	125	0.6	1000	0.12	6.917	15.102	0.5	M3-1
45	53125	56285	3736011	3679726	53126	1	0.6	1000	0.12	6.917	15.102	0.5	M3-1
48	727753	728177	10776403	10048226	727763	10	0.6	1000	0.12	6.917	15.102	0.5	M3-1
51	439964	443478	10131751	9688273	439968	4	0.6	1000	0.12	6.917	15.102	0.5	M3-1
54	101705	102378	5519503	5417125	101709	4	0.6	1000	0.12	6.917	15.102	0.5	M3-1
57	99428	99788	4837605	4737817	99719	291	0.6	1000	0.12	6.917	15.102	0.5	M3-1
59	0	0	0	0	0	0	0.6	1000	0.12	6.917	15.102	0.5	M3-1
60	220906	221616	3573801	3352185	220945	39	0.6	1000	0.12	6.917	15.102	0.5	M3-1
62	0	0	0	0	0	0	0.6	1000	0.12	6.917	15.102	0.5	M3-1
63	575533	576491	9748320	9171829	575533	0	0.6	1000	0.12	6.917	15.102	0.5	M3-1
64	0	0	0	0	0	0	0.6	1000	0.12	6.917	15.102	0.5	M3-1
66	293041	293128	2492028	2198900	293041	0	0.6	1000	0.12	6.917	15.102	0.5	M3-1
68	10	10	15	5	10	0	0.6	1000	0.12	6.917	15.102	0.5	M3-1
69	359715	359725	4045590	3685865	359726	11	0.6	1000	0.12	6.917	15.102	0.5	M3-1
72	72649	75317	1553203	1477886	72649	0	0.6	1000	0.12	6.917	15.102	0.5	M3-1
75	18352	18352	328455	310103	18354	2	0.6	1000	0.12	6.917	15.102	0.5	M3-1
76	0	0	0	0	0	0	0.6	1000	0.12	6.917	15.102	0.5	M3-1
78	132571	132572	773146	640574	132571	0	0.6	1000	0.12	6.917	15.102	0.5	M3-1
81	5138	5138	36585	31447	5138	0	0.6	1000	0.12	6.917	15.102	0.5	M3-1
84	623	623	9730	9107	623	0	0.6	1000	0.12	6.917	15.102	0.5	M3-1
87	478	478	6670	6192	478	0	0.6	1000	0.12	6.917	15.102	0.5	M3-1
90	294	305	2278	1973	294	0	0.6	1000	0.12	6.917	15.102	0.5	M3-1
12	0	0	0	0	0	0	0.6	1000	0.13	6.958	14.475	0.5	M3-1
24	19	19	528	509	20	1	0.6	1000	0.13	6.958	14.475	0.5	M3-1
27	1012	1012	3403	2391	1012	0	0.6	1000	0.13	6.958	14.475	0.5	M3-1
30	2244	2244	20706	18462	2266	22	0.6	1000	0.13	6.958	14.475	0.5	M3-1
33	14843	14843	188191	173348	14847	4	0.6	1000	0.13	6.958	14.475	0.5	M3-1
36	7238877	7242680	9894576	2651896	7238881	4	0.6	1000	0.13	6.958	14.475	0.5	M3-1
39	263403	263445	2729616	2466171	263403	0	0.6	1000	0.13	6.958	14.475	0.5	M3-1
42	35711	35878	2158003	2122125	35836	125	0.6	1000	0.13	6.958	14.475	0.5	M3-1
45	53125	56285	3736011	3679726	53126	1	0.6	1000	0.13	6.958	14.475	0.5	M3-1
48	727773	728177	10776403	10048226	727797	24	0.6	1000	0.13	6.958	14.475	0.5	M3-1
51	439964	443478	10131751	9688273	439968	4	0.6	1000	0.13	6.958	14.475	0.5	M3-1
54	101905	102378	5519503	5417125	101909	4	0.6	1000	0.13	6.958	14.475	0.5	M3-1
57	99446	99788	4837605	4737817	99743	297	0.6	1000	0.13	6.958	14.475	0.5	M3-1
59	0	0	0	0	0	0	0.6	1000	0.13	6.958	14.475	0.5	M3-1
60	220906	221616	3573801	3352185	220945	39	0.6	1000	0.13	6.958	14.475	0.5	M3-1
62	0	0	0	0	0	0	0.6	1000	0.13	6.958	14.475	0.5	M3-1
63	575585	576491	9748320	9171829	575588	3	0.6	1000	0.13	6.958	14.475	0.5	M3-1
64	0	0	0	0	0	0	0.6	1000	0.13	6.958	14.475	0.5	M3-1
66	293085	293128	2492028	2198900	293085	0	0.6	1000	0.13	6.958	14.475	0.5	M3-1
68	10	10	15	5	10	0	0.6	1000	0.13	6.958	14.475	0.5	M3-1
69	359715	359725	4045590	3685865	359726	11	0.6	1000	0.13	6.958	14.475	0.5	M3-1
72	74546	75317	1553203	1477886	74546	0	0.6	1000	0.13	6.958	14.475	0.5	M3-1
75	18352	18352	328455	310103	18354	2	0.6	1000	0.13	6.958	14.475	0.5	M3-1
76	0	0	0	0	0	0	0.6	1000	0.13	6.958	14.475	0.5	M3-1
78	132572	132572	773146	640574	132572	0	0.6	1000	0.13	6.958	14.475	0.5	M3-1
81	5138	5138	36585	31447	5138	0	0.6	1000	0.13	6.958	14.475	0.5	M3-1
84	623	623	9730	9107	623	0	0.6	1000	0.13	6.958	14.475	0.5	M3-1
87	478	478	6670	6192	478	0	0.6	1000	0.13	6.958	14.475	0.5	M3-1
90	294	305	2278	1973	294	0	0.6	1000	0.13	6.958	14.475	0.5	M3-1
12	0	0	0	0	0	0	0.6	1000	0.17	7.102	12.055	0.5	M3-1
24	19	19	528	509	30	11	0.6	1000	0.17	7.102	12.055	0.5	M3-1
27	1012	1012	3403	2391	1012	0	0.6	1000	0.17	7.102	12.055	0.5	M3-1
30	2244	2244	20706	18462	2316	72	0.6	1000	0.17	7.102	12.055	0.5	M3-1
33	14843	14843	188191	173348	14862	19	0.6	1000	0.17	7.102	12.055	0.5	M3-1
36	7242680	7242680	9894576	2651896	7242696	16	0.6	1000	0.17	7.102	12.055	0.5	M3-1
39	263445	263445	2729616	2466171	264574	1129	0.6	1000	0.17	7.102	12.055	0.5	M3-1
42	35786	35878	2158003	2122125	35930	144	0.6	1000	0.17	7.102	12.055	0.5	M3-1
45	53512	56285	3736011	3679726	53515	3	0.6	1000	0.17	7.102	12.055	0.5	M3-1
48	727790	728177	10776403	10048226	727878	88	0.6	1000	0.17	7.102	12.055	0.5	M3-1
51	440008	443478	10131751	9688273	440054	46	0.6	1000	0.17	7.102	12.055	0.5	M3-1
54	101974	102378	5519503	5417125	102100	126	0.6	1000	0.17	7.102	12.055	0.5	M3-1
57	99569	99788	4837605	4737817	99924	355	0.6	1000	0.17	7.102	12.055	0.5	M3-1
59	0	0	0	0	0	0	0.6	1000	0.17	7.102	12.055	0.5	M3-1
60	221007	221616	3573801	3352185	221053	46	0.6	1000	0.17	7.102	12.055	0.5	M3-1
62	0	0	0	0	0	0	0.6	1000	0.17	7.102	12.055	0.5	M3-1
63	575585	576491	9748320	9171829	575588	3	0.6	1000	0.17	7.102	12.055	0.5	M3-1
64	0	0	0	0	0	0	0.6	1000	0.17	7.102	12.055	0.5	M3-1
66	293126	293128	2492028	2198900	293130	4	0.6	1000	0.17	7.102	12.055	0.5	M3-1
68	10	10	15	5	10	0	0.6	1000	0.17	7.102	12.055	0.5	M3-1
69	359718	359725	4045590	3685865	359729	11	0.6	1000	0.17	7.102	12.055	0.5	M3-1
72	75013	75317	1553203	1477886	75013	0	0.6	1000	0.17	7.102	12.055	0.5	M3-1
75	18352	18352	328455	310103	18354	2	0.6	1000	0.17	7.102	12.055	0.5	M3-1
76	0	0	0	0	0	0	0.6	1000	0.17	7.102	12.055	0.5	M3-1
78	132572	132572	773146	640574	132572	0	0.6	1000	0.17	7.102	12.055	0.5	M3-1
81	5138	5138	36585	31447	5138	0	0.6	1000	0.17	7.102	12.055	0.5	M3-1
84	623	623	9730	9107	623	0	0.6	1000	0.17	7.102	12.055	0.5	M3-1
87	478	478	6670	6192	478	0	0.6	1000	0.17	7.102	12.055	0.5	M3-1
90	305	305	2278	1973	305	0	0.6	1000	0.17	7.102	12.055	0.5	M3-1
12	0	0	0	0	0	0	0.6	1000	0.16	7.302	13.141	0.5	M3-1
24	19	19	528	509	20	1	0.6	1000	0.16	7.302	13.141	0.5	M3-1
27	1012	1012	3403	2391	1012	0	0.6	1000	0.16	7.302	13.141	0.5	M3-1
30	2244	2244	20706	18462	2266	22	0.6	1000	0.16	7.302	13.141	0.5	M3-1
33	14843	14843	188191	173348	14862	19	0.6	1000	0.16	7.302	13.141	0.5	M3-1
36	7242680	7242680	9894576	2651896	7242685	5	0.6	1000	0.16	7.302	13.141	0.5	M3-1
39	263445	263445	2729616	2466171	264574	1129	0.6	1000	0.16	7.302	13.141	0.5	M3-1
42	35768	35878	2158003	2122125	35901	133	0.6	1000	0.16	7.302	13.141	0.5	M3-1
45	53512	56285	3736011	3679726	53515	3	0.6	1000	0.16	7.302	13.141	0.5	M3-1
48	727790	728177	10776403	10048226	727828	38	0.6	1000	0.16	7.302	13.141	0.5	M3-1
51	440008	443478	10131751	9688273	440054	46	0.6	1000	0.16	7.302	13.141	0.5	M3-1
54	101971	102378	5519503	5417125	102035	64	0.6	1000	0.16	7.302	13.141	0.5	M3-1
57	99569	99788	4837605	4737817	99924	355	0.6	1000	0.16	7.302	13.141	0.5	M3-1
59	0	0	0	0	0	0	0.6	1000	0.16	7.302	13.141	0.5	M3-1
60	220994	221616	3573801	3352185	221035	41	0.6	1000	0.16	7.302	13.141	0.5	M3-1
62	0	0	0	0	0	0	0.6	1000	0.16	7.302	13.141	0.5	M3-1
63	575585	576491	9748320	9171829	575588	3	0.6	1000	0.16	7.302	13.141	0.5	M3-1
64	0	0	0	0	0	0	0.6	1000	0.16	7.302	13.141	0.5	M3-1
66	293126	293128	2492028	2198900	293130	4	0.6	1000	0.16	7.302	13.141	0.5	M3-1
68	10	10	15	5	10	0	0.6	1000	0.16	7.302	13.141	0.5	M3-1
69	359718	359725	4045590	3685865	359729	11	0.6	1000	0.16	7.302	13.141	0.5	M3-1
72	75013	75317	1553203	1477886	75013	0	0.6	1000	0.16	7.302	13.141	0.5	M3-1
75	18352	18352	328455	310103	18354	2	0.6	1000	0.16	7.302	13.141	0.5	M3-1
76	0	0	0	0	0	0	0.6	1000	0.16	7.302	13.141	0.5	M3-1
78	132572	132572	773146	640574	132572	0	0.6	1000	0.16	7.302	13.141	0.5	M3-1
81	5138	5138	36585	31447	5138	0	0.6	1000	0.16	7.302	13.141	0.5	M3-1
84	623	623	9730	9107	623	0	0.6	1000	0.16	7.302	13.141	0.5	M3-1
87	478	478	6670	6192	478	0	0.6	1000	0.16	7.302	13.141	0.5	M3-1
90	294	305	2278	1973	294	0	0.6	1000	0.16	7.302	13.141	0.5	M3-1
12	0	0	0	0	0	0	0.6	1000	0.14	7.687	16.013	0.5	M3-1
24	19	19	528	509	20	1	0.6	1000	0.14	7.687	16.013	0.5	M3-1
27	1012	1012	3403	2391	1012	0	0.6	1000	0.14	7.687	16.013	0.5	M3-1
30	2244	2244	20706	18462	2266	22	0.6	1000	0.14	7.687	16.013	0.5	M3-1
33	14843	14843	188191	173348	14847	4	0.6	1000	0.14	7.687	16.013	0.5	M3-1
36	7242680	7242680	9894576	2651896	7242685	5	0.6	1000	0.14	7.687	16.013	0.5	M3-1
39	263403	263445	2729616	2466171	263403	0	0.6	1000	0.14	7.687	16.013	0.5	M3-1
42	35711	35878	2158003	2122125	35836	125	0.6	1000	0.14	7.687	16.013	0.5	M3-1
45	53512	56285	3736011	3679726	53513	1	0.6	1000	0.14	7.687	16.013	0.5	M3-1
48	727773	728177	10776403	10048226	727797	24	0.6	1000	0.14	7.687	16.013	0.5	M3-1
51	440008	443478	10131751	9688273	440012	4	0.6	1000	0.14	7.687	16.013	0.5	M3-1
54	101905	102378	5519503	5417125	101909	4	0.6	1000	0.14	7.687	16.013	0.5	M3-1
57	99446	99788	4837605	4737817	99743	297	0.6	1000	0.14	7.687	16.013	0.5	M3-1
59	0	0	0	0	0	0	0.6	1000	0.14	7.687	16.013	0.5	M3-1
60	220942	221616	3573801	3352185	220981	39	0.6	1000	0.14	7.687	16.013	0.5	M3-1
62	0	0	0	0	0	0	0.6	1000	0.14	7.687	16.013	0.5	M3-1
63	575585	576491	9748320	9171829	575588	3	0.6	1000	0.14	7.687	16.013	0.5	M3-1
64	0	0	0	0	0	0	0.6	1000	0.14	7.687	16.013	0.5	M3-1
66	293121	293128	2492028	2198900	293121	0	0.6	1000	0.14	7.687	16.013	0.5	M3-1
68	10	10	15	5	10	0	0.6	1000	0.14	7.687	16.013	0.5	M3-1
69	359717	359725	4045590	3685865	359728	11	0.6	1000	0.14	7.687	16.013	0.5	M3-1
72	74814	75317	1553203	1477886	74814	0	0.6	1000	0.14	7.687	16.013	0.5	M3-1
75	18352	18352	328455	310103	18354	2	0.6	1000	0.14	7.687	16.013	0.5	M3-1
76	0	0	0	0	0	0	0.6	1000	0.14	7.687	16.013	0.5	M3-1
78	132572	132572	773146	640574	132572	0	0.6	1000	0.14	7.687	16.013	0.5	M3-1
81	5138	5138	36585	31447	5138	0	0.6	1000	0.14	7.687	16.013	0.5	M3-1
84	623	623	9730	9107	623	0	0.6	1000	0.14	7.687	16.013	0.5	M3-1
87	478	478	6670	6192	478	0	0.6	1000	0.14	7.687	16.013	0.5	M3-1
90	294	305	2278	1973	294	0	0.6	1000	0.14	7.687	16.013	0.5	M3-1
12	0	0	0	0	0	0	0.6	1000	0.19	7.754	15.669	0.5	M3-1
24	19	19	528	509	30	11	0.6	1000	0.19	7.754	15.669	0.5	M3-1
27	1012	1012	3403	2391	1012	0	0.6	1000	0.19	7.754	15.669	0.5	M3-1
30	2244	2244	20706	18462	2316	72	0.6	1000	0.19	7.754	15.669	0.5	M3-1
33	14843	14843	188191	173348	14929	86	0.6	1000	0.19	7.754	15.669	0.5	M3-1
36	7242680	7242680	9894576	2651896	7242696	16	0.6	1000	0.19	7.754	15.669	0.5	M3-1
39	263445	263445	2729616	2466171	265509	2064	0.6	1000	0.19	7.754	15.669	0.5	M3-1
42	35786	35878	2158003	2122125	35930	144	0.6	1000	0.19	7.754	15.669	0.5	M3-1
45	53512	56285	3736011	3679726	53556	44	0.6	1000	0.19	7.754	15.669	0.5	M3-1
48	727791	728177	10776403	10048226	727891	100	0.6	1000	0.19	7.754	15.669	0.5	M3-1
51	440008	443478	10131751	9688273	440381	373	0.6	1000	0.19	7.754	15.669	0.5	M3-1
54	102045	102378	5519503	5417125	102249	204	0.6	1000	0.19	7.754	15.669	0.5	M3-1
57	99569	99788	4837605	4737817	100202	633	0.6	1000	0.19	7.754	15.669	0.5	M3-1
59	0	0	0	0	0	0	0.6	1000	0.19	7.754	15.669	0.5	M3-1
60	221007	221616	3573801	3352185	221118	111	0.6	1000	0.19	7.754	15.669	0.5	M3-1
62	0	0	0	0	0	0	0.6	1000	0.19	7.754	15.669	0.5	M3-1
63	575585	576491	9748320	9171829	575588	3	0.6	1000	0.19	7.754	15.669	0.5	M3-1
64	0	0	0	0	0	0	0.6	1000	0.19	7.754	15.669	0.5	M3-1
66	293126	293128	2492028	2198900	293143	17	0.6	1000	0.19	7.754	15.669	0.5	M3-1
68	10	10	15	5	10	0	0.6	1000	0.19	7.754	15.669	0.5	M3-1
69	359718	359725	4045590	3685865	359731	13	0.6	1000	0.19	7.754	15.669	0.5	M3-1
72	75013	75317	1553203	1477886	75013	0	0.6	1000	0.19	7.754	15.669	0.5	M3-1
75	18352	18352	328455	310103	18354	2	0.6	1000	0.19	7.754	15.669	0.5	M3-1
76	0	0	0	0	0	0	0.6	1000	0.19	7.754	15.669	0.5	M3-1
78	132572	132572	773146	640574	132574	2	0.6	1000	0.19	7.754	15.669	0.5	M3-1
81	5138	5138	36585	31447	5138	0	0.6	1000	0.19	7.754	15.669	0.5	M3-1
84	623	623	9730	9107	623	0	0.6	1000	0.19	7.754	15.669	0.5	M3-1
87	478	478	6670	6192	478	0	0.6	1000	0.19	7.754	15.669	0.5	M3-1
90	305	305	2278	1973	305	0	0.6	1000	0.19	7.754	15.669	0.5	M3-1
12	0	0	0	0	0	0	0.6	1000	0.15	8.119	13.739	0.5	M3-1
24	19	19	528	509	20	1	0.6	1000	0.15	8.119	13.739	0.5	M3-1
27	1012	1012	3403	2391	1012	0	0.6	1000	0.15	8.119	13.739	0.5	M3-1
30	2244	2244	20706	18462	2266	22	0.6	1000	0.15	8.119	13.739	0.5	M3-1
33	14843	14843	188191	173348	14847	4	0.6	1000	0.15	8.119	13.739	0.5	M3-1
36	7242680	7242680	9894576	2651896	7242685	5	0.6	1000	0.15	8.119	13.739	0.5	M3-1
39	263403	263445	2729616	2466171	263403	0	0.6	1000	0.15	8.119	13.739	0.5	M3-1
42	35768	35878	2158003	2122125	35901	133	0.6	1000	0.15	8.119	13.739	0.5	M3-1
45	53512	56285	3736011	3679726	53513	1	0.6	1000	0.15	8.119	13.739	0.5	M3-1
48	727790	728177	10776403	10048226	727828	38	0.6	1000	0.15	8.119	13.739	0.5	M3-1
51	440008	443478	10131751	9688273	440012	4	0.6	1000	0.15	8.119	13.739	0.5	M3-1
54	101971	102378	5519503	5417125	102035	64	0.6	1000	0.15	8.119	13.739	0.5	M3-1
57	99465	99788	4837605	4737817	99815	350	0.6	1000	0.15	8.119	13.739	0.5	M3-1
59	0	0	0	0	0	0	0.6	1000	0.15	8.119	13.739	0.5	M3-1
60	220994	221616	3573801	3352185	221035	41	0.6	1000	0.15	8.119	13.739	0.5	M3-1
62	0	0	0	0	0	0	0.6	1000	0.15	8.119	13.739	0.5	M3-1
63	575585	576491	9748320	9171829	575588	3	0.6	1000	0.15	8.119	13.739	0.5	M3-1
64	0	0	0	0	0	0	0.6	1000	0.15	8.119	13.739	0.5	M3-1
66	293121	293128	2492028	2198900	293121	0	0.6	1000	0.15	8.119	13.739	0.5	M3-1
68	10	10	15	5	10	0	0.6	1000	0.15	8.119	13.739	0.5	M3-1
69	359718	359725	4045590	3685865	359729	11	0.6	1000	0.15	8.119	13.739	0.5	M3-1
72	74814	75317	1553203	1477886	74814	0	0.6	1000	0.15	8.119	13.739	0.5	M3-1
75	18352	18352	328455	310103	18354	2	0.6	1000	0.15	8.119	13.739	0.5	M3-1
76	0	0	0	0	0	0	0.6	1000	0.15	8.119	13.739	0.5	M3-1
78	132572	132572	773146	640574	132572	0	0.6	1000	0.15	8.119	13.739	0.5	M3-1
81	5138	5138	36585	31447	5138	0	0.6	1000	0.15	8.119	13.739	0.5	M3-1
84	623	623	9730	9107	623	0	0.6	1000	0.15	8.119	13.739	0.5	M3-1
87	478	478	6670	6192	478	0	0.6	1000	0.15	8.119	13.739	0.5	M3-1
90	294	305	2278	1973	294	0	0.6	1000	0.15	8.119	13.739	0.5	M3-1
12	0	0	0	0	0	0	0.6	1000	0.11	9.521	13.391	0.5	M3-1
24	19	19	528	509	20	1	0.6	1000	0.11	9.521	13.391	0.5	M3-1
27	1012	1012	3403	2391	1012	0	0.6	1000	0.11	9.521	13.391	0.5	M3-1
30	2244	2244	20706	18462	2266	22	0.6	1000	0.11	9.521	13.391	0.5	M3-1
33	14453	14843	188191	173348	14453	0	0.6	1000	0.11	9.521	13.391	0.5	M3-1
36	7238867	7242680	9894576	2651896	7238870	3	0.6	1000	0.11	9.521	13.391	0.5	M3-1
39	263400	263445	2729616	2466171	263400	0	0.6	1000	0.11	9.521	13.391	0.5	M3-1
42	35646	35878	2158003	2122125	35646	0	0.6	1000	0.11	9.521	13.391	0.5	M3-1
45	52036	56285	3736011	3679726	52037	1	0.6	1000	0.11	9.521	13.391	0.5	M3-1
48	727753	728177	10776403	10048226	727763	10	0.6	1000	0.11	9.521	13.391	0.5	M3-1
51	439575	443478	10131751	9688273	439575	0	0.6	1000	0.11	9.521	13.391	0.5	M3-1
54	101254	102378	5519503	5417125	101258	4	0.6	1000	0.11	9.521	13.391	0.5	M3-1
57	99428	99788	4837605	4737817	99719	291	0.6	1000	0.11	9.521	13.391	0.5	M3-1
59	0	0	0	0	0	0	0.6	1000	0.11	9.521	13.391	0.5	M3-1
60	220898	221616	3573801	3352185	220937	39	0.6	1000	0.11	9.521	13.391	0.5	M3-1
62	0	0	0	0	0	0	0.6	1000	0.11	9.521	13.391	0.5	M3-1
63	575489	576491	9748320	9171829	575489	0	0.6	1000	0.11	9.521	13.391	0.5	M3-1
64	0	0	0	0	0	0	0.6	1000	0.11	9.521	13.391	0.5	M3-1
66	293041	293128	2492028	2198900	293041	0	0.6	1000	0.11	9.521	13.391	0.5	M3-1
68	10	10	15	5	10	0	0.6	1000	0.11	9.521	13.391	0.5	M3-1
69	359634	359725	4045590	3685865	359634	0	0.6	1000	0.11	9.521	13.391	0.5	M3-1
72	72643	75317	1553203	1477886	72643	0	0.6	1000	0.11	9.521	13.391	0.5	M3-1
75	18352	18352	328455	310103	18352	0	0.6	1000	0.11	9.521	13.391	0.5	M3-1
76	0	0	0	0	0	0	0.6	1000	0.11	9.521	13.391	0.5	M3-1
78	132571	132572	773146	640574	132571	0	0.6	1000	0.11	9.521	13.391	0.5	M3-1
81	5138	5138	36585	31447	5138	0	0.6	1000	0.11	9.521	13.391	0.5	M3-1
84	623	623	9730	9107	623	0	0.6	1000	0.11	9.521	13.391	0.5	M3-1
87	478	478	6670	6192	478	0	0.6	1000	0.11	9.521	13.391	0.5	M3-1
90	294	305	2278	1973	294	0	0.6	1000	0.11	9.521	13.391	0.5	M3-1
12	0	0	0	0	0	0	0.6	1000	0.1	9.542	18.094	0.5	M3-1
24	19	19	528	509	20	1	0.6	1000	0.1	9.542	18.094	0.5	M3-1
27	1012	1012	3403	2391	1012	0	0.6	1000	0.1	9.542	18.094	0.5	M3-1
30	2244	2244	20706	18462	2266	22	0.6	1000	0.1	9.542	18.094	0.5	M3-1
33	14453	14843	188191	173348	14453	0	0.6	1000	0.1	9.542	18.094	0.5	M3-1
36	7238867	7242680	9894576	2651896	7238870	3	0.6	1000	0.1	9.542	18.094	0.5	M3-1
39	262923	263445	2729616	2466171	262923	0	0.6	1000	0.1	9.542	18.094	0.5	M3-1
42	35646	35878	2158003	2122125	35646	0	0.6	1000	0.1	9.542	18.094	0.5	M3-1
45	52036	56285	3736011	3679726	52037	1	0.6	1000	0.1	9.542	18.094	0.5	M3-1
48	726900	728177	10776403	10048226	726908	8	0.6	1000	0.1	9.542	18.094	0.5	M3-1
51	439575	443478	10131751	9688273	439575	0	0.6	1000	0.1	9.542	18.094	0.5	M3-1
54	101254	102378	5519503	5417125	101258	4	0.6	1000	0.1	9.542	18.094	0.5	M3-1
57	99415	99788	4837605	4737817	99706	291	0.6	1000	0.1	9.542	18.094	0.5	M3-1
59	0	0	0	0	0	0	0.6	1000	0.1	9.542	18.094	0.5	M3-1
60	220898	221616	3573801	3352185	220937	39	0.6	1000	0.1	9.542	18.094	0.5	M3-1
62	0	0	0	0	0	0	0.6	1000	0.1	9.542	18.094	0.5	M3-1
63	575489	576491	9748320	9171829	575489	0	0.6	1000	0.1	9.542	18.094	0.5	M3-1
64	0	0	0	0	0	0	0.6	1000	0.1	9.542	18.094	0.5	M3-1
66	293040	293128	2492028	2198900	293040	0	0.6	1000	0.1	9.542	18.094	0.5	M3-1
68	10	10	15	5	10	0	0.6	1000	0.1	9.542	18.094	0.5	M3-1
69	359627	359725	4045590	3685865	359627	0	0.6	1000	0.1	9.542	18.094	0.5	M3-1
72	72643	75317	1553203	1477886	72643	0	0.6	1000	0.1	9.542	18.094	0.5	M3-1
75	18349	18352	328455	310103	18349	0	0.6	1000	0.1	9.542	18.094	0.5	M3-1
76	0	0	0	0	0	0	0.6	1000	0.1	9.542	18.094	0.5	M3-1
78	132571	132572	773146	640574	132571	0	0.6	1000	0.1	9.542	18.094	0.5	M3-1
81	5138	5138	36585	31447	5138	0	0.6	1000	0.1	9.542	18.094	0.5	M3-1
84	590	623	9730	9107	590	0	0.6	1000	0.1	9.542	18.094	0.5	M3-1
87	478	478	6670	6192	478	0	0.6	1000	0.1	9.542	18.094	0.5	M3-1
90	294	305	2278	1973	294	0	0.6	1000	0.1	9.542	18.094	0.5	M3-1
